mun;grupos;num;area;n_af_nao;n_af_sim;area_af_nao;area_af_sim;usa_agrotoxico;nao_usa_agrotoxico;naf_usa_agrotoxico;naf_nao_usa_agrotoxico;af_usa_agrotoxico;af_nao_usa_agrotoxico;naf_organico;naf_n_organico;af_organico;af_n_organico;;
Paraná;Mais de 0 a menos de 0,1 ha;2637;113;917;1720;20;44;326;2311;97;820;229;1491;72;681;141;1226;;
Paraná;De 0,1 a menos de 0,2 ha;2293;287;791;1502;57;109;364;1929;124;667;240;1262;76;514;151;969;;
Paraná;De 0,2 a menos de 0,5 ha;5420;1797;1743;3677;507;976;1385;4035;458;1285;927;2750;96;984;258;1929;;
Paraná;De 0,5 a menos de 1 ha;14588;8617;4814;9774;2721;5295;4276;10312;1339;3475;2937;6837;236;2521;604;4703;;
Paraná;De 1 a menos de 2 ha;13176;17454;3419;9757;4165;11915;5077;8099;1091;2328;3986;5771;131;1799;495;4084;;
Paraná;De 2 a menos de 3 ha;17801;43069;4144;13657;9653;31227;8109;9692;1444;2700;6665;6992;158;2047;547;4935;;
Paraná;De 3 a menos de 4 ha;15192;52628;2931;12261;9522;37453;8025;7167;1207;1724;6818;5443;93;1276;365;3615;;
Paraná;De 4 a menos de 5 ha;18983;89834;3450;15533;15626;66639;10372;8611;1349;2101;9023;6510;116;1606;423;4509;;
Paraná;De 5 a menos de 10 ha;50237;381528;7137;43100;53115;319898;31401;18836;3065;4072;28336;14764;201;3099;899;9909;;
Paraná;De 10 a menos de 20 ha;64194;930281;6706;57488;95080;813519;45039;19155;3102;3604;41937;15551;162;2711;878;10313;;
Paraná;De 20 a menos de 50 ha;54674;1694259;5892;48782;186487;1456644;40460;14214;3137;2755;37323;11459;113;2079;499;7736;;
Paraná;De 50 a menos de 100 ha;20107;1414129;9271;10836;702854;658187;15559;4548;7118;2153;8441;2395;87;1582;91;1614;;
Paraná;De 100 a menos de 200 ha;11660;1638751;11577;83;1513553;5591;8854;2806;8813;2764;41;42;73;1958;2;37;;
Paraná;De 200 a menos de 500 ha;8888;2719141;8855;33;2523329;4000;6718;2170;6702;2153;16;17;59;1527;1;14;;
Paraná;De 500 a menos de 1.000 ha;2794;1710173;2786;8;1624904;0;2126;668;2125;661;1;7;14;456;2;5;;
Paraná;De 1.000 a menos de 2.500 ha;1242;1279844;1232;10;1117016;0;948;294;945;287;3;7;6;198;0;7;;
Paraná;De 2.500 a menos de 10.000 ha;300;232000;299;1;187759;0;223;77;223;76;0;1;2;62;0;1;;
Paraná;De 10.000 ha e mais;35;48016;35;0;48016;0;32;3;32;3;0;0;0;2;0;0;;
Paraná;Produtor sem área;933;0;267;666;0;0;70;194;24;80;46;114;1;72;4;105;;
Abatiá;Mais de 0 a menos de 0,1 ha;13;1;12;1;0;0;0;13;0;12;0;1;0;12;0;1;;
Abatiá;De 0,1 a menos de 0,2 ha;13;1;6;7;0;0;1;12;0;6;1;6;0;6;0;6;;
Abatiá;De 0,2 a menos de 0,5 ha;13;3;4;9;0;0;7;6;0;4;7;2;0;4;0;2;;
Abatiá;De 0,5 a menos de 1 ha;51;27;18;33;10;17;21;30;8;10;13;20;3;7;4;9;;
Abatiá;De 1 a menos de 2 ha;21;29;6;15;8;21;14;7;3;3;11;4;0;3;0;0;;
Abatiá;De 2 a menos de 3 ha;20;48;1;19;0;0;11;9;0;1;11;8;0;1;0;8;;
Abatiá;De 3 a menos de 4 ha;47;166;7;40;24;141;39;8;5;2;34;6;0;2;0;4;;
Abatiá;De 4 a menos de 5 ha;67;317;4;63;18;299;41;26;1;3;40;23;0;2;0;19;;
Abatiá;De 5 a menos de 10 ha;161;1192;19;142;134;1058;113;48;6;13;107;35;0;10;2;22;;
Abatiá;De 10 a menos de 20 ha;108;1509;7;101;99;1410;78;30;3;4;75;26;0;3;0;17;;
Abatiá;De 20 a menos de 50 ha;91;2872;12;79;358;2514;72;19;9;3;63;16;0;1;0;14;;
Abatiá;De 50 a menos de 100 ha;20;1329;7;13;565;764;18;2;7;0;11;2;0;0;1;0;;
Abatiá;De 100 a menos de 200 ha;28;3858;28;0;3858;0;26;2;26;2;0;0;0;2;0;0;;
Abatiá;De 200 a menos de 500 ha;15;4640;15;0;4640;0;8;7;8;7;0;0;0;6;0;0;;
Abatiá;De 500 a menos de 1.000 ha;4;0;4;0;0;0;4;0;4;0;0;0;0;0;0;0;;
Abatiá;De 1.000 a menos de 2.500 ha;1;0;1;0;0;0;1;0;1;0;0;0;0;0;0;0;;
Abatiá;De 2.500 a menos de 10.000 ha;0;0;0;0;0;0;0;0;0;0;0;0;0;0;0;0;;
Abatiá;De 10.000 ha e mais;0;0;0;0;0;0;0;0;0;0;0;0;0;0;0;0;;
Abatiá;Produtor sem área;0;0;0;0;0;0;0;0;0;0;0;0;0;0;0;0;;
Adrianópolis;Mais de 0 a menos de 0,1 ha;30;2;13;17;1;1;1;29;0;13;1;16;0;13;1;15;;
Adrianópolis;De 0,1 a menos de 0,2 ha;13;2;5;8;0;0;0;13;0;5;0;8;0;4;0;8;;
Adrianópolis;De 0,2 a menos de 0,5 ha;28;9;15;13;5;4;1;27;0;15;1;12;0;15;1;11;;
Adrianópolis;De 0,5 a menos de 1 ha;59;39;23;36;16;24;1;58;0;23;1;35;0;22;1;33;;
Adrianópolis;De 1 a menos de 2 ha;67;88;26;41;34;54;8;59;3;23;5;36;0;22;1;33;;
Adrianópolis;De 2 a menos de 3 ha;53;128;23;30;56;72;2;51;1;22;1;29;0;21;2;25;;
Adrianópolis;De 3 a menos de 4 ha;23;79;5;18;18;61;1;22;0;5;1;17;0;5;0;17;;
Adrianópolis;De 4 a menos de 5 ha;29;137;11;18;52;85;0;29;0;11;0;18;0;11;1;17;;
Adrianópolis;De 5 a menos de 10 ha;61;459;14;47;116;343;6;55;0;14;6;41;0;14;2;36;;
Adrianópolis;De 10 a menos de 20 ha;62;898;17;45;241;657;3;59;1;16;2;43;0;14;1;42;;
Adrianópolis;De 20 a menos de 50 ha;95;2957;23;72;668;2289;3;92;0;23;3;69;0;19;4;62;;
Adrianópolis;De 50 a menos de 100 ha;64;4371;18;46;1307;3064;4;60;2;16;2;44;0;16;1;42;;
Adrianópolis;De 100 a menos de 200 ha;26;3909;24;2;0;0;2;24;2;22;0;2;2;20;1;1;;
Adrianópolis;De 200 a menos de 500 ha;26;8235;26;0;8235;0;4;22;4;22;0;0;0;22;0;0;;
Adrianópolis;De 500 a menos de 1.000 ha;14;10779;14;0;10779;0;1;13;1;13;0;0;0;13;0;0;;
Adrianópolis;De 1.000 a menos de 2.500 ha;7;10976;7;0;10976;0;2;5;2;5;0;0;0;5;0;0;;
Adrianópolis;De 2.500 a menos de 10.000 ha;1;0;1;0;0;0;0;1;0;1;0;0;0;1;0;0;;
Adrianópolis;De 10.000 ha e mais;3;48016;3;0;48016;0;3;0;3;0;0;0;0;0;0;0;;
Adrianópolis;Produtor sem área;2;0;2;0;0;0;0;1;0;1;0;0;0;1;0;0;;
Agudos do Sul;Mais de 0 a menos de 0,1 ha;0;0;0;0;0;0;0;0;0;0;0;0;0;0;0;0;;
Agudos do Sul;De 0,1 a menos de 0,2 ha;6;1;1;5;0;0;2;4;1;0;1;4;0;0;1;2;;
Agudos do Sul;De 0,2 a menos de 0,5 ha;16;5;1;15;0;0;7;9;0;1;7;8;0;1;0;5;;
Agudos do Sul;De 0,5 a menos de 1 ha;52;41;13;39;11;31;23;29;8;5;15;24;3;1;3;16;;
Agudos do Sul;De 1 a menos de 2 ha;137;205;36;101;53;152;68;69;23;13;45;56;1;8;0;24;;
Agudos do Sul;De 2 a menos de 3 ha;101;242;21;80;50;192;58;43;11;10;47;33;0;8;0;22;;
Agudos do Sul;De 3 a menos de 4 ha;115;385;11;104;38;348;53;62;6;5;47;57;0;3;1;18;;
Agudos do Sul;De 4 a menos de 5 ha;100;459;9;91;41;418;40;60;5;4;35;56;0;4;4;29;;
Agudos do Sul;De 5 a menos de 10 ha;235;1582;20;215;134;1448;115;120;11;9;104;111;0;8;3;48;;
Agudos do Sul;De 10 a menos de 20 ha;138;1873;10;128;139;1733;108;30;3;7;105;23;0;7;0;11;;
Agudos do Sul;De 20 a menos de 50 ha;88;2570;7;81;191;2379;77;11;4;3;73;8;0;3;0;6;;
Agudos do Sul;De 50 a menos de 100 ha;8;573;4;4;0;0;4;4;2;2;2;2;0;2;0;2;;
Agudos do Sul;De 100 a menos de 200 ha;0;0;0;0;0;0;0;0;0;0;0;0;0;0;0;0;;
Agudos do Sul;De 200 a menos de 500 ha;3;931;3;0;931;0;1;2;1;2;0;0;0;1;0;0;;
Agudos do Sul;De 500 a menos de 1.000 ha;0;0;0;0;0;0;0;0;0;0;0;0;0;0;0;0;;
Agudos do Sul;De 1.000 a menos de 2.500 ha;1;0;1;0;0;0;0;1;0;1;0;0;0;1;0;0;;
Agudos do Sul;De 2.500 a menos de 10.000 ha;0;0;0;0;0;0;0;0;0;0;0;0;0;0;0;0;;
Agudos do Sul;De 10.000 ha e mais;0;0;0;0;0;0;0;0;0;0;0;0;0;0;0;0;;
Agudos do Sul;Produtor sem área;2;0;1;1;0;0;2;0;1;0;1;0;0;0;0;0;;
Almirante Tamandaré;Mais de 0 a menos de 0,1 ha;0;0;0;0;0;0;0;0;0;0;0;0;0;0;0;0;;
Almirante Tamandaré;De 0,1 a menos de 0,2 ha;0;0;0;0;0;0;0;0;0;0;0;0;0;0;0;0;;
Almirante Tamandaré;De 0,2 a menos de 0,5 ha;4;1;1;3;0;0;2;2;0;1;2;1;0;1;0;1;;
Almirante Tamandaré;De 0,5 a menos de 1 ha;5;3;2;3;0;0;1;4;1;1;0;3;0;1;0;2;;
Almirante Tamandaré;De 1 a menos de 2 ha;19;22;4;15;5;18;5;14;0;4;5;10;0;3;0;3;;
Almirante Tamandaré;De 2 a menos de 3 ha;35;82;5;30;12;70;23;12;0;5;23;7;0;3;0;3;;
Almirante Tamandaré;De 3 a menos de 4 ha;20;69;4;16;14;55;11;9;0;4;11;5;0;3;1;1;;
Almirante Tamandaré;De 4 a menos de 5 ha;25;116;5;20;23;93;17;8;2;3;15;5;0;2;0;3;;
Almirante Tamandaré;De 5 a menos de 10 ha;39;300;2;37;0;0;25;14;0;2;25;12;0;1;1;5;;
Almirante Tamandaré;De 10 a menos de 20 ha;27;351;4;23;47;304;15;12;2;2;13;10;0;2;2;6;;
Almirante Tamandaré;De 20 a menos de 50 ha;25;740;3;22;87;653;16;9;1;2;15;7;0;2;0;5;;
Almirante Tamandaré;De 50 a menos de 100 ha;3;196;3;0;196;0;2;1;2;1;0;0;0;1;0;0;;
Almirante Tamandaré;De 100 a menos de 200 ha;2;0;2;0;0;0;0;2;0;2;0;0;0;2;0;0;;
Almirante Tamandaré;De 200 a menos de 500 ha;2;0;2;0;0;0;2;0;2;0;0;0;0;0;0;0;;
Almirante Tamandaré;De 500 a menos de 1.000 ha;0;0;0;0;0;0;0;0;0;0;0;0;0;0;0;0;;
Almirante Tamandaré;De 1.000 a menos de 2.500 ha;0;0;0;0;0;0;0;0;0;0;0;0;0;0;0;0;;
Almirante Tamandaré;De 2.500 a menos de 10.000 ha;0;0;0;0;0;0;0;0;0;0;0;0;0;0;0;0;;
Almirante Tamandaré;De 10.000 ha e mais;0;0;0;0;0;0;0;0;0;0;0;0;0;0;0;0;;
Almirante Tamandaré;Produtor sem área;0;0;0;0;0;0;0;0;0;0;0;0;0;0;0;0;;
Altamira do Paraná;Mais de 0 a menos de 0,1 ha;1;0;0;1;0;0;0;1;0;0;0;1;0;0;0;0;;
Altamira do Paraná;De 0,1 a menos de 0,2 ha;0;0;0;0;0;0;0;0;0;0;0;0;0;0;0;0;;
Altamira do Paraná;De 0,2 a menos de 0,5 ha;2;0;1;1;0;0;0;2;0;1;0;1;0;1;0;1;;
Altamira do Paraná;De 0,5 a menos de 1 ha;2;0;1;1;0;0;1;1;1;0;0;1;0;0;0;1;;
Altamira do Paraná;De 1 a menos de 2 ha;2;0;1;1;0;0;1;1;1;0;0;1;0;0;0;1;;
Altamira do Paraná;De 2 a menos de 3 ha;14;35;3;11;7;28;6;8;1;2;5;6;0;2;0;2;;
Altamira do Paraná;De 3 a menos de 4 ha;14;50;3;11;11;39;3;11;1;2;2;9;0;1;0;8;;
Altamira do Paraná;De 4 a menos de 5 ha;24;114;4;20;19;95;8;16;1;3;7;13;0;3;0;9;;
Altamira do Paraná;De 5 a menos de 10 ha;100;804;15;85;125;679;37;63;6;9;31;54;0;8;1;34;;
Altamira do Paraná;De 10 a menos de 20 ha;115;1648;17;98;245;1403;58;57;8;9;50;48;0;6;0;36;;
Altamira do Paraná;De 20 a menos de 50 ha;146;4472;12;134;359;4113;90;56;6;6;84;50;0;6;1;34;;
Altamira do Paraná;De 50 a menos de 100 ha;48;3329;14;34;1179;2150;33;15;7;7;26;8;0;2;0;6;;
Altamira do Paraná;De 100 a menos de 200 ha;38;5725;38;0;5725;0;31;7;31;7;0;0;0;4;0;0;;
Altamira do Paraná;De 200 a menos de 500 ha;18;6060;18;0;6060;0;14;4;14;4;0;0;0;1;0;0;;
Altamira do Paraná;De 500 a menos de 1.000 ha;11;7844;11;0;7844;0;10;1;10;1;0;0;0;0;0;0;;
Altamira do Paraná;De 1.000 a menos de 2.500 ha;5;6766;5;0;6766;0;2;3;2;3;0;0;0;3;0;0;;
Altamira do Paraná;De 2.500 a menos de 10.000 ha;0;0;0;0;0;0;0;0;0;0;0;0;0;0;0;0;;
Altamira do Paraná;De 10.000 ha e mais;0;0;0;0;0;0;0;0;0;0;0;0;0;0;0;0;;
Altamira do Paraná;Produtor sem área;3;0;1;2;0;0;0;2;0;0;0;2;0;0;0;2;;
Altônia;Mais de 0 a menos de 0,1 ha;61;2;13;48;0;2;4;57;0;13;4;44;0;13;0;43;;
Altônia;De 0,1 a menos de 0,2 ha;24;3;1;23;0;0;0;24;0;1;0;23;0;1;0;21;;
Altônia;De 0,2 a menos de 0,5 ha;35;12;7;28;2;10;2;33;1;6;1;27;1;5;0;26;;
Altônia;De 0,5 a menos de 1 ha;78;46;12;66;8;38;18;60;3;9;15;51;0;6;1;46;;
Altônia;De 1 a menos de 2 ha;84;115;14;70;18;96;18;66;6;8;12;58;0;5;1;44;;
Altônia;De 2 a menos de 3 ha;110;273;15;95;38;235;25;85;4;11;21;74;1;6;0;56;;
Altônia;De 3 a menos de 4 ha;89;315;10;79;37;278;17;72;2;8;15;64;1;3;1;38;;
Altônia;De 4 a menos de 5 ha;107;503;15;92;72;431;22;85;2;13;20;72;0;6;2;41;;
Altônia;De 5 a menos de 10 ha;292;2209;26;266;206;2003;82;210;6;20;76;190;0;12;5;116;;
Altônia;De 10 a menos de 20 ha;283;4076;29;254;439;3637;74;209;8;21;66;188;0;11;3;119;;
Altônia;De 20 a menos de 50 ha;223;7077;18;205;582;6495;71;152;11;7;60;145;0;3;1;74;;
Altônia;De 50 a menos de 100 ha;93;6326;25;68;2094;4232;32;61;11;14;21;47;0;10;0;24;;
Altônia;De 100 a menos de 200 ha;54;7204;54;0;7204;0;29;25;29;25;0;0;0;10;0;0;;
Altônia;De 200 a menos de 500 ha;23;6798;23;0;6798;0;16;7;16;7;0;0;0;3;0;0;;
Altônia;De 500 a menos de 1.000 ha;10;7160;10;0;7160;0;3;7;3;7;0;0;0;4;0;0;;
Altônia;De 1.000 a menos de 2.500 ha;0;0;0;0;0;0;0;0;0;0;0;0;0;0;0;0;;
Altônia;De 2.500 a menos de 10.000 ha;1;0;1;0;0;0;0;1;0;1;0;0;0;0;0;0;;
Altônia;De 10.000 ha e mais;0;0;0;0;0;0;0;0;0;0;0;0;0;0;0;0;;
Altônia;Produtor sem área;4;0;1;3;0;0;0;0;0;0;0;0;0;0;0;0;;
Alto Paraná;Mais de 0 a menos de 0,1 ha;3;0;0;3;0;0;1;2;0;0;1;2;0;0;0;1;;
Alto Paraná;De 0,1 a menos de 0,2 ha;2;0;0;2;0;0;2;0;0;0;2;0;0;0;0;0;;
Alto Paraná;De 0,2 a menos de 0,5 ha;0;0;0;0;0;0;0;0;0;0;0;0;0;0;0;0;;
Alto Paraná;De 0,5 a menos de 1 ha;48;24;16;32;8;16;11;37;3;13;8;24;3;8;3;17;;
Alto Paraná;De 1 a menos de 2 ha;9;11;4;5;0;0;2;7;1;3;1;4;0;3;1;1;;
Alto Paraná;De 2 a menos de 3 ha;19;45;9;10;21;25;12;7;6;3;6;4;0;3;0;2;;
Alto Paraná;De 3 a menos de 4 ha;12;41;2;10;0;0;5;7;1;1;4;6;0;1;0;3;;
Alto Paraná;De 4 a menos de 5 ha;29;138;12;17;57;82;11;18;2;10;9;8;0;9;1;7;;
Alto Paraná;De 5 a menos de 10 ha;85;652;26;59;198;454;49;36;12;14;37;22;1;11;0;16;;
Alto Paraná;De 10 a menos de 20 ha;95;1375;26;69;364;1011;49;46;13;13;36;33;0;9;0;24;;
Alto Paraná;De 20 a menos de 50 ha;127;4203;35;92;1149;3054;63;64;17;18;46;46;0;8;1;28;;
Alto Paraná;De 50 a menos de 100 ha;70;5151;39;31;3111;2040;50;20;31;8;19;12;0;8;0;5;;
Alto Paraná;De 100 a menos de 200 ha;48;6557;48;0;6557;0;29;19;29;19;0;0;0;10;0;0;;
Alto Paraná;De 200 a menos de 500 ha;32;9077;32;0;9077;0;28;4;28;4;0;0;0;2;0;0;;
Alto Paraná;De 500 a menos de 1.000 ha;4;3281;4;0;3281;0;3;1;3;1;0;0;0;0;0;0;;
Alto Paraná;De 1.000 a menos de 2.500 ha;2;0;2;0;0;0;2;0;2;0;0;0;0;0;0;0;;
Alto Paraná;De 2.500 a menos de 10.000 ha;1;0;1;0;0;0;0;1;0;1;0;0;0;0;0;0;;
Alto Paraná;De 10.000 ha e mais;0;0;0;0;0;0;0;0;0;0;0;0;0;0;0;0;;
Alto Paraná;Produtor sem área;6;0;1;5;0;0;0;1;0;0;0;1;0;0;0;1;;
Alto Piquiri;Mais de 0 a menos de 0,1 ha;39;1;12;27;0;1;0;39;0;12;0;27;0;11;0;27;;
Alto Piquiri;De 0,1 a menos de 0,2 ha;17;2;10;7;1;1;1;16;0;10;1;6;0;10;0;6;;
Alto Piquiri;De 0,2 a menos de 0,5 ha;38;12;13;25;5;8;3;35;3;10;0;25;0;10;1;20;;
Alto Piquiri;De 0,5 a menos de 1 ha;182;99;72;110;40;59;51;131;18;54;33;77;4;43;10;52;;
Alto Piquiri;De 1 a menos de 2 ha;15;18;7;8;9;10;2;13;0;7;2;6;0;7;0;6;;
Alto Piquiri;De 2 a menos de 3 ha;34;83;14;20;34;48;7;27;1;13;6;14;0;13;0;13;;
Alto Piquiri;De 3 a menos de 4 ha;29;104;14;15;50;54;3;26;0;14;3;12;0;14;2;8;;
Alto Piquiri;De 4 a menos de 5 ha;29;140;10;19;48;92;5;24;1;9;4;15;0;8;0;13;;
Alto Piquiri;De 5 a menos de 10 ha;74;542;16;58;120;422;13;61;1;15;12;46;0;12;0;40;;
Alto Piquiri;De 10 a menos de 20 ha;76;1030;10;66;137;893;27;49;0;10;27;39;0;10;1;33;;
Alto Piquiri;De 20 a menos de 50 ha;77;2300;8;69;255;2045;47;30;3;5;44;25;0;5;0;20;;
Alto Piquiri;De 50 a menos de 100 ha;39;2793;7;32;665;2127;31;8;6;1;25;7;0;0;0;7;;
Alto Piquiri;De 100 a menos de 200 ha;46;6614;46;0;6614;0;39;7;39;7;0;0;0;5;0;0;;
Alto Piquiri;De 200 a menos de 500 ha;34;9932;34;0;9932;0;31;3;31;3;0;0;0;3;0;0;;
Alto Piquiri;De 500 a menos de 1.000 ha;6;3884;6;0;3884;0;6;0;6;0;0;0;0;0;0;0;;
Alto Piquiri;De 1.000 a menos de 2.500 ha;4;0;4;0;0;0;4;0;4;0;0;0;0;0;0;0;;
Alto Piquiri;De 2.500 a menos de 10.000 ha;1;0;1;0;0;0;1;0;1;0;0;0;0;0;0;0;;
Alto Piquiri;De 10.000 ha e mais;0;0;0;0;0;0;0;0;0;0;0;0;0;0;0;0;;
Alto Piquiri;Produtor sem área;14;0;7;7;0;0;0;0;0;0;0;0;0;0;0;0;;
Alvorada do Sul;Mais de 0 a menos de 0,1 ha;1;0;1;0;0;0;0;1;0;1;0;0;0;1;0;0;;
Alvorada do Sul;De 0,1 a menos de 0,2 ha;2;0;2;0;0;0;0;2;0;2;0;0;0;2;0;0;;
Alvorada do Sul;De 0,2 a menos de 0,5 ha;6;2;3;3;0;0;0;6;0;3;0;3;0;3;0;3;;
Alvorada do Sul;De 0,5 a menos de 1 ha;25;13;12;13;6;7;9;16;8;4;1;12;0;1;0;7;;
Alvorada do Sul;De 1 a menos de 2 ha;8;11;3;5;4;7;5;3;3;0;2;3;0;0;0;3;;
Alvorada do Sul;De 2 a menos de 3 ha;4;9;2;2;0;0;3;1;2;0;1;1;0;0;0;1;;
Alvorada do Sul;De 3 a menos de 4 ha;10;34;3;7;10;24;7;3;2;1;5;2;0;1;0;1;;
Alvorada do Sul;De 4 a menos de 5 ha;9;41;2;7;0;0;5;4;0;2;5;2;0;2;0;1;;
Alvorada do Sul;De 5 a menos de 10 ha;26;197;1;25;0;0;18;8;1;0;17;8;0;0;0;5;;
Alvorada do Sul;De 10 a menos de 20 ha;114;1574;4;110;67;1506;103;11;3;1;100;10;0;0;1;4;;
Alvorada do Sul;De 20 a menos de 50 ha;84;2606;18;66;550;2056;77;7;16;2;61;5;0;1;0;2;;
Alvorada do Sul;De 50 a menos de 100 ha;21;1502;17;4;0;0;20;1;16;1;4;0;0;0;0;0;;
Alvorada do Sul;De 100 a menos de 200 ha;31;4565;31;0;4565;0;29;2;29;2;0;0;0;2;0;0;;
Alvorada do Sul;De 200 a menos de 500 ha;16;5228;16;0;5228;0;15;1;15;1;0;0;0;1;0;0;;
Alvorada do Sul;De 500 a menos de 1.000 ha;11;7999;11;0;7999;0;11;0;11;0;0;0;0;0;0;0;;
Alvorada do Sul;De 1.000 a menos de 2.500 ha;3;3716;3;0;3716;0;3;0;3;0;0;0;0;0;0;0;;
Alvorada do Sul;De 2.500 a menos de 10.000 ha;0;0;0;0;0;0;0;0;0;0;0;0;0;0;0;0;;
Alvorada do Sul;De 10.000 ha e mais;0;0;0;0;0;0;0;0;0;0;0;0;0;0;0;0;;
Alvorada do Sul;Produtor sem área;0;0;0;0;0;0;0;0;0;0;0;0;0;0;0;0;;
Amaporã;Mais de 0 a menos de 0,1 ha;1;0;0;1;0;0;0;1;0;0;0;1;0;0;0;0;;
Amaporã;De 0,1 a menos de 0,2 ha;3;0;1;2;0;0;0;3;0;1;0;2;0;1;0;2;;
Amaporã;De 0,2 a menos de 0,5 ha;5;1;5;0;1;0;0;5;0;5;0;0;0;5;0;0;;
Amaporã;De 0,5 a menos de 1 ha;62;31;49;13;25;7;1;61;1;48;0;13;1;44;0;12;;
Amaporã;De 1 a menos de 2 ha;7;8;2;5;0;0;1;6;0;2;1;4;0;2;0;3;;
Amaporã;De 2 a menos de 3 ha;5;12;3;2;0;0;0;5;0;3;0;2;1;2;1;1;;
Amaporã;De 3 a menos de 4 ha;5;18;3;2;0;0;1;4;0;3;1;1;0;3;0;1;;
Amaporã;De 4 a menos de 5 ha;7;33;2;5;0;0;1;6;0;2;1;4;0;2;0;4;;
Amaporã;De 5 a menos de 10 ha;9;72;2;7;0;0;1;8;0;2;1;6;1;0;1;3;;
Amaporã;De 10 a menos de 20 ha;89;1313;4;85;59;1254;11;78;1;3;10;75;1;1;2;66;;
Amaporã;De 20 a menos de 50 ha;61;1655;12;49;362;1293;8;53;2;10;6;43;0;10;1;30;;
Amaporã;De 50 a menos de 100 ha;13;942;4;9;305;637;3;10;2;2;1;8;0;1;0;4;;
Amaporã;De 100 a menos de 200 ha;24;3710;24;0;3710;0;6;18;6;18;0;0;1;11;0;0;;
Amaporã;De 200 a menos de 500 ha;7;2732;7;0;2732;0;2;5;2;5;0;0;0;2;0;0;;
Amaporã;De 500 a menos de 1.000 ha;9;6532;9;0;6532;0;5;4;5;4;0;0;0;2;0;0;;
Amaporã;De 1.000 a menos de 2.500 ha;6;8026;6;0;8026;0;3;3;3;3;0;0;0;2;0;0;;
Amaporã;De 2.500 a menos de 10.000 ha;3;10371;3;0;10371;0;3;0;3;0;0;0;0;0;0;0;;
Amaporã;De 10.000 ha e mais;0;0;0;0;0;0;0;0;0;0;0;0;0;0;0;0;;
Amaporã;Produtor sem área;3;0;1;2;0;0;0;1;0;1;0;0;0;1;0;0;;
Ampére;Mais de 0 a menos de 0,1 ha;7;0;3;4;0;0;3;4;2;1;1;3;1;0;0;3;;
Ampére;De 0,1 a menos de 0,2 ha;7;1;1;6;0;0;0;7;0;1;0;6;1;0;2;4;;
Ampére;De 0,2 a menos de 0,5 ha;14;4;6;8;2;2;4;10;2;4;2;6;2;2;2;3;;
Ampére;De 0,5 a menos de 1 ha;23;15;7;16;4;11;8;15;3;4;5;11;2;2;3;6;;
Ampére;De 1 a menos de 2 ha;42;55;15;27;20;35;17;25;7;8;10;17;2;5;4;11;;
Ampére;De 2 a menos de 3 ha;43;104;17;26;41;63;23;20;9;8;14;12;1;7;1;11;;
Ampére;De 3 a menos de 4 ha;76;262;21;55;74;189;47;29;16;5;31;24;0;4;1;17;;
Ampére;De 4 a menos de 5 ha;112;534;24;88;113;421;73;39;16;8;57;31;1;5;1;23;;
Ampére;De 5 a menos de 10 ha;263;2011;40;223;306;1705;179;84;26;14;153;70;1;13;7;53;;
Ampére;De 10 a menos de 20 ha;310;4318;34;276;449;3869;245;65;29;5;216;60;1;4;3;45;;
Ampére;De 20 a menos de 50 ha;200;6045;22;178;695;5350;179;21;14;8;165;13;2;4;2;9;;
Ampére;De 50 a menos de 100 ha;47;3469;23;24;1936;1533;40;7;19;4;21;3;1;3;0;2;;
Ampére;De 100 a menos de 200 ha;23;3099;23;0;3099;0;22;1;22;1;0;0;0;1;0;0;;
Ampére;De 200 a menos de 500 ha;14;3976;14;0;3976;0;10;4;10;4;0;0;0;4;0;0;;
Ampére;De 500 a menos de 1.000 ha;3;0;3;0;0;0;1;2;1;2;0;0;0;2;0;0;;
Ampére;De 1.000 a menos de 2.500 ha;1;0;1;0;0;0;1;0;1;0;0;0;0;0;0;0;;
Ampére;De 2.500 a menos de 10.000 ha;0;0;0;0;0;0;0;0;0;0;0;0;0;0;0;0;;
Ampére;De 10.000 ha e mais;0;0;0;0;0;0;0;0;0;0;0;0;0;0;0;0;;
Ampére;Produtor sem área;0;0;0;0;0;0;0;0;0;0;0;0;0;0;0;0;;
Anahy;Mais de 0 a menos de 0,1 ha;2;0;2;0;0;0;1;1;1;1;0;0;0;1;0;0;;
Anahy;De 0,1 a menos de 0,2 ha;0;0;0;0;0;0;0;0;0;0;0;0;0;0;0;0;;
Anahy;De 0,2 a menos de 0,5 ha;3;1;1;2;0;0;3;0;1;0;2;0;0;0;0;0;;
Anahy;De 0,5 a menos de 1 ha;7;4;4;3;2;2;6;1;3;1;3;0;1;0;0;0;;
Anahy;De 1 a menos de 2 ha;5;7;3;2;0;0;3;2;1;2;2;0;0;2;0;0;;
Anahy;De 2 a menos de 3 ha;11;27;4;7;10;17;4;7;2;2;2;5;0;2;0;5;;
Anahy;De 3 a menos de 4 ha;5;18;2;3;0;0;4;1;2;0;2;1;0;0;0;0;;
Anahy;De 4 a menos de 5 ha;8;38;3;5;13;24;4;4;2;1;2;3;0;1;0;2;;
Anahy;De 5 a menos de 10 ha;28;212;3;25;19;193;19;9;1;2;18;7;0;2;1;5;;
Anahy;De 10 a menos de 20 ha;50;696;7;43;91;605;41;9;5;2;36;7;0;2;0;3;;
Anahy;De 20 a menos de 50 ha;35;1104;5;30;169;935;33;2;3;2;30;0;0;2;0;0;;
Anahy;De 50 a menos de 100 ha;30;2061;13;17;1044;1017;29;1;12;1;17;0;0;1;0;0;;
Anahy;De 100 a menos de 200 ha;17;2522;17;0;2522;0;17;0;17;0;0;0;0;0;0;0;;
Anahy;De 200 a menos de 500 ha;6;1697;6;0;1697;0;6;0;6;0;0;0;0;0;0;0;;
Anahy;De 500 a menos de 1.000 ha;1;0;1;0;0;0;1;0;1;0;0;0;0;0;0;0;;
Anahy;De 1.000 a menos de 2.500 ha;0;0;0;0;0;0;0;0;0;0;0;0;0;0;0;0;;
Anahy;De 2.500 a menos de 10.000 ha;0;0;0;0;0;0;0;0;0;0;0;0;0;0;0;0;;
Anahy;De 10.000 ha e mais;0;0;0;0;0;0;0;0;0;0;0;0;0;0;0;0;;
Anahy;Produtor sem área;0;0;0;0;0;0;0;0;0;0;0;0;0;0;0;0;;
Andirá;Mais de 0 a menos de 0,1 ha;1;0;0;1;0;0;1;0;0;0;1;0;0;0;0;0;;
Andirá;De 0,1 a menos de 0,2 ha;0;0;0;0;0;0;0;0;0;0;0;0;0;0;0;0;;
Andirá;De 0,2 a menos de 0,5 ha;1;0;0;1;0;0;0;1;0;0;0;1;0;0;0;1;;
Andirá;De 0,5 a menos de 1 ha;21;11;0;21;0;11;16;5;0;0;16;5;0;0;2;3;;
Andirá;De 1 a menos de 2 ha;3;0;0;3;0;0;1;2;0;0;1;2;0;0;1;0;;
Andirá;De 2 a menos de 3 ha;12;30;0;12;0;30;9;3;0;0;9;3;0;0;0;2;;
Andirá;De 3 a menos de 4 ha;4;15;0;4;0;15;3;1;0;0;3;1;0;0;0;0;;
Andirá;De 4 a menos de 5 ha;17;81;1;16;0;0;13;4;0;1;13;3;0;1;0;2;;
Andirá;De 5 a menos de 10 ha;39;300;5;34;42;258;28;11;3;2;25;9;0;1;1;4;;
Andirá;De 10 a menos de 20 ha;61;868;8;53;115;753;53;8;7;1;46;7;0;1;1;1;;
Andirá;De 20 a menos de 50 ha;59;1944;7;52;250;1694;57;2;7;0;50;2;0;0;0;0;;
Andirá;De 50 a menos de 100 ha;28;2013;15;13;1212;801;25;3;15;0;10;3;0;0;0;2;;
Andirá;De 100 a menos de 200 ha;21;2909;21;0;2909;0;21;0;21;0;0;0;0;0;0;0;;
Andirá;De 200 a menos de 500 ha;17;4914;17;0;4914;0;17;0;17;0;0;0;0;0;0;0;;
Andirá;De 500 a menos de 1.000 ha;5;3385;5;0;3385;0;5;0;5;0;0;0;0;0;0;0;;
Andirá;De 1.000 a menos de 2.500 ha;2;0;2;0;0;0;2;0;2;0;0;0;0;0;0;0;;
Andirá;De 2.500 a menos de 10.000 ha;0;0;0;0;0;0;0;0;0;0;0;0;0;0;0;0;;
Andirá;De 10.000 ha e mais;0;0;0;0;0;0;0;0;0;0;0;0;0;0;0;0;;
Andirá;Produtor sem área;0;0;0;0;0;0;0;0;0;0;0;0;0;0;0;0;;
Ângulo;Mais de 0 a menos de 0,1 ha;2;0;0;2;0;0;0;2;0;0;0;2;0;0;0;1;;
Ângulo;De 0,1 a menos de 0,2 ha;1;0;0;1;0;0;0;1;0;0;0;1;0;0;1;0;;
Ângulo;De 0,2 a menos de 0,5 ha;3;1;1;2;0;0;0;3;0;1;0;2;0;1;0;1;;
Ângulo;De 0,5 a menos de 1 ha;33;17;20;13;10;7;4;29;4;16;0;13;0;11;0;10;;
Ângulo;De 1 a menos de 2 ha;0;0;0;0;0;0;0;0;0;0;0;0;0;0;0;0;;
Ângulo;De 2 a menos de 3 ha;3;7;1;2;0;0;1;2;0;1;1;1;0;1;0;1;;
Ângulo;De 3 a menos de 4 ha;16;59;7;9;25;33;8;8;5;2;3;6;0;2;0;4;;
Ângulo;De 4 a menos de 5 ha;11;53;2;9;0;0;3;8;1;1;2;7;0;0;0;5;;
Ângulo;De 5 a menos de 10 ha;31;248;1;30;0;0;19;12;1;0;18;12;0;0;0;7;;
Ângulo;De 10 a menos de 20 ha;67;929;5;62;74;855;47;20;1;4;46;16;0;3;0;10;;
Ângulo;De 20 a menos de 50 ha;55;1684;6;49;195;1490;49;6;6;0;43;6;0;0;0;0;;
Ângulo;De 50 a menos de 100 ha;18;1393;15;3;0;0;16;2;14;1;2;1;0;1;0;1;;
Ângulo;De 100 a menos de 200 ha;16;2070;16;0;2070;0;13;3;13;3;0;0;0;1;0;0;;
Ângulo;De 200 a menos de 500 ha;7;1631;7;0;1631;0;7;0;7;0;0;0;0;0;0;0;;
Ângulo;De 500 a menos de 1.000 ha;2;0;2;0;0;0;2;0;2;0;0;0;0;0;0;0;;
Ângulo;De 1.000 a menos de 2.500 ha;0;0;0;0;0;0;0;0;0;0;0;0;0;0;0;0;;
Ângulo;De 2.500 a menos de 10.000 ha;0;0;0;0;0;0;0;0;0;0;0;0;0;0;0;0;;
Ângulo;De 10.000 ha e mais;0;0;0;0;0;0;0;0;0;0;0;0;0;0;0;0;;
Ângulo;Produtor sem área;0;0;0;0;0;0;0;0;0;0;0;0;0;0;0;0;;
Antonina;Mais de 0 a menos de 0,1 ha;5;0;1;4;0;0;1;4;0;1;1;3;0;1;0;3;;
Antonina;De 0,1 a menos de 0,2 ha;10;1;7;3;0;0;0;10;0;7;0;3;0;4;1;2;;
Antonina;De 0,2 a menos de 0,5 ha;8;3;1;7;0;0;0;8;0;1;0;7;1;0;2;5;;
Antonina;De 0,5 a menos de 1 ha;23;14;11;12;6;8;4;19;3;8;1;11;0;7;2;8;;
Antonina;De 1 a menos de 2 ha;33;40;9;24;10;30;8;25;1;8;7;17;0;6;3;10;;
Antonina;De 2 a menos de 3 ha;26;61;15;11;34;27;3;23;2;13;1;10;0;12;0;8;;
Antonina;De 3 a menos de 4 ha;13;44;7;6;0;0;1;12;1;6;0;6;0;5;1;2;;
Antonina;De 4 a menos de 5 ha;26;124;9;17;43;81;5;21;2;7;3;14;0;5;3;10;;
Antonina;De 5 a menos de 10 ha;41;312;16;25;126;186;10;31;2;14;8;17;1;11;1;12;;
Antonina;De 10 a menos de 20 ha;29;406;3;26;41;365;12;17;1;2;11;15;0;2;3;11;;
Antonina;De 20 a menos de 50 ha;41;1396;24;17;804;591;11;30;6;18;5;12;0;13;1;8;;
Antonina;De 50 a menos de 100 ha;16;1198;11;5;912;286;2;14;0;11;2;3;0;8;1;1;;
Antonina;De 100 a menos de 200 ha;6;852;6;0;852;0;1;5;1;5;0;0;0;2;0;0;;
Antonina;De 200 a menos de 500 ha;17;6212;17;0;6212;0;2;15;2;15;0;0;0;11;0;0;;
Antonina;De 500 a menos de 1.000 ha;6;4470;6;0;4470;0;1;5;1;5;0;0;0;3;0;0;;
Antonina;De 1.000 a menos de 2.500 ha;2;0;2;0;0;0;1;1;1;1;0;0;0;1;0;0;;
Antonina;De 2.500 a menos de 10.000 ha;0;0;0;0;0;0;0;0;0;0;0;0;0;0;0;0;;
Antonina;De 10.000 ha e mais;0;0;0;0;0;0;0;0;0;0;0;0;0;0;0;0;;
Antonina;Produtor sem área;2;0;2;0;0;0;0;1;0;1;0;0;0;1;0;0;;
Antônio Olinto;Mais de 0 a menos de 0,1 ha;3;0;2;1;0;0;1;2;0;2;1;0;0;2;0;0;;
Antônio Olinto;De 0,1 a menos de 0,2 ha;5;1;4;1;0;0;2;3;2;2;0;1;0;2;0;1;;
Antônio Olinto;De 0,2 a menos de 0,5 ha;30;12;17;13;0;0;8;22;4;13;4;9;0;9;1;2;;
Antônio Olinto;De 0,5 a menos de 1 ha;40;29;15;25;10;19;16;24;4;11;12;13;2;5;2;4;;
Antônio Olinto;De 1 a menos de 2 ha;71;102;29;42;41;61;41;30;13;16;28;14;0;14;0;7;;
Antônio Olinto;De 2 a menos de 3 ha;60;146;12;48;29;118;44;16;7;5;37;11;0;5;1;6;;
Antônio Olinto;De 3 a menos de 4 ha;69;238;16;53;54;184;52;17;10;6;42;11;0;3;1;5;;
Antônio Olinto;De 4 a menos de 5 ha;73;345;13;60;63;282;58;15;7;6;51;9;0;5;2;3;;
Antônio Olinto;De 5 a menos de 10 ha;201;1514;20;181;148;1366;168;33;13;7;155;26;0;7;3;16;;
Antônio Olinto;De 10 a menos de 20 ha;177;2537;13;164;183;2354;156;21;7;6;149;15;0;2;0;12;;
Antônio Olinto;De 20 a menos de 50 ha;166;5281;13;153;432;4849;149;17;6;7;143;10;0;6;1;8;;
Antônio Olinto;De 50 a menos de 100 ha;73;5014;36;37;2888;2126;69;4;34;2;35;2;0;2;0;2;;
Antônio Olinto;De 100 a menos de 200 ha;19;2692;19;0;2692;0;18;1;18;1;0;0;0;0;0;0;;
Antônio Olinto;De 200 a menos de 500 ha;13;3507;13;0;3507;0;11;2;11;2;0;0;0;2;0;0;;
Antônio Olinto;De 500 a menos de 1.000 ha;5;3344;5;0;3344;0;3;2;3;2;0;0;1;1;0;0;;
Antônio Olinto;De 1.000 a menos de 2.500 ha;1;0;1;0;0;0;0;1;0;1;0;0;0;1;0;0;;
Antônio Olinto;De 2.500 a menos de 10.000 ha;1;0;1;0;0;0;1;0;1;0;0;0;0;0;0;0;;
Antônio Olinto;De 10.000 ha e mais;0;0;0;0;0;0;0;0;0;0;0;0;0;0;0;0;;
Antônio Olinto;Produtor sem área;1;0;1;0;0;0;0;1;0;1;0;0;0;1;0;0;;
Apucarana;Mais de 0 a menos de 0,1 ha;4;0;1;3;0;0;0;4;0;1;0;3;0;1;0;2;;
Apucarana;De 0,1 a menos de 0,2 ha;4;1;1;3;0;0;0;4;0;1;0;3;0;1;1;2;;
Apucarana;De 0,2 a menos de 0,5 ha;15;5;5;10;2;3;2;13;2;3;0;10;1;2;0;7;;
Apucarana;De 0,5 a menos de 1 ha;138;76;71;67;39;36;82;56;46;25;36;31;1;13;7;18;;
Apucarana;De 1 a menos de 2 ha;50;64;17;33;22;42;23;27;10;7;13;20;1;2;1;11;;
Apucarana;De 2 a menos de 3 ha;101;246;25;76;61;185;57;44;15;10;42;34;1;7;1;21;;
Apucarana;De 3 a menos de 4 ha;61;212;20;41;72;140;43;18;9;11;34;7;1;7;0;6;;
Apucarana;De 4 a menos de 5 ha;93;435;12;81;57;378;67;26;7;5;60;21;1;2;2;11;;
Apucarana;De 5 a menos de 10 ha;210;1605;35;175;268;1337;151;59;18;17;133;42;1;12;0;31;;
Apucarana;De 10 a menos de 20 ha;275;3788;49;226;703;3084;207;68;32;17;175;51;0;14;3;39;;
Apucarana;De 20 a menos de 50 ha;188;5845;52;136;1608;4237;139;49;32;20;107;29;0;13;2;22;;
Apucarana;De 50 a menos de 100 ha;71;5254;62;9;4777;477;53;18;45;17;8;1;0;12;0;1;;
Apucarana;De 100 a menos de 200 ha;54;7661;54;0;7661;0;43;11;43;11;0;0;0;11;0;0;;
Apucarana;De 200 a menos de 500 ha;29;8366;29;0;8366;0;27;2;27;2;0;0;0;2;0;0;;
Apucarana;De 500 a menos de 1.000 ha;10;7241;10;0;7241;0;9;1;9;1;0;0;0;1;0;0;;
Apucarana;De 1.000 a menos de 2.500 ha;2;0;2;0;0;0;2;0;2;0;0;0;0;0;0;0;;
Apucarana;De 2.500 a menos de 10.000 ha;0;0;0;0;0;0;0;0;0;0;0;0;0;0;0;0;;
Apucarana;De 10.000 ha e mais;0;0;0;0;0;0;0;0;0;0;0;0;0;0;0;0;;
Apucarana;Produtor sem área;3;0;1;2;0;0;0;0;0;0;0;0;0;0;0;0;;
Arapongas;Mais de 0 a menos de 0,1 ha;4;0;0;4;0;0;0;4;0;0;0;4;0;0;3;1;;
Arapongas;De 0,1 a menos de 0,2 ha;6;1;4;2;0;0;1;5;1;3;0;2;3;0;2;0;;
Arapongas;De 0,2 a menos de 0,5 ha;12;3;2;10;0;0;4;8;1;1;3;7;1;0;6;1;;
Arapongas;De 0,5 a menos de 1 ha;21;11;6;15;3;8;2;19;0;6;2;13;2;2;8;1;;
Arapongas;De 1 a menos de 2 ha;8;9;1;7;0;0;3;5;0;1;3;4;0;0;2;2;;
Arapongas;De 2 a menos de 3 ha;25;61;6;19;14;47;4;21;2;4;2;17;1;0;8;6;;
Arapongas;De 3 a menos de 4 ha;31;109;5;26;18;92;16;15;3;2;13;13;1;1;8;5;;
Arapongas;De 4 a menos de 5 ha;27;128;3;24;14;114;12;15;0;3;12;12;2;1;8;0;;
Arapongas;De 5 a menos de 10 ha;163;1132;25;138;177;955;94;69;11;14;83;55;1;8;21;18;;
Arapongas;De 10 a menos de 20 ha;90;1219;20;70;267;952;71;19;13;7;58;12;1;5;5;6;;
Arapongas;De 20 a menos de 50 ha;76;2307;19;57;622;1685;66;10;16;3;50;7;2;1;5;2;;
Arapongas;De 50 a menos de 100 ha;43;3223;43;0;3223;0;40;3;40;3;0;0;2;1;0;0;;
Arapongas;De 100 a menos de 200 ha;31;4099;31;0;4099;0;29;2;29;2;0;0;0;1;0;0;;
Arapongas;De 200 a menos de 500 ha;20;6027;20;0;6027;0;20;0;20;0;0;0;0;0;0;0;;
Arapongas;De 500 a menos de 1.000 ha;7;4245;7;0;4245;0;7;0;7;0;0;0;0;0;0;0;;
Arapongas;De 1.000 a menos de 2.500 ha;4;0;4;0;0;0;4;0;4;0;0;0;0;0;0;0;;
Arapongas;De 2.500 a menos de 10.000 ha;0;0;0;0;0;0;0;0;0;0;0;0;0;0;0;0;;
Arapongas;De 10.000 ha e mais;0;0;0;0;0;0;0;0;0;0;0;0;0;0;0;0;;
Arapongas;Produtor sem área;0;0;0;0;0;0;0;0;0;0;0;0;0;0;0;0;;
Arapoti;Mais de 0 a menos de 0,1 ha;11;0;2;9;0;0;1;10;0;2;1;8;0;2;1;7;;
Arapoti;De 0,1 a menos de 0,2 ha;8;1;3;5;0;0;0;8;0;3;0;5;0;3;2;2;;
Arapoti;De 0,2 a menos de 0,5 ha;48;22;4;44;2;20;19;29;1;3;18;26;1;2;0;22;;
Arapoti;De 0,5 a menos de 1 ha;37;25;11;26;7;18;9;28;2;9;7;19;1;7;0;14;;
Arapoti;De 1 a menos de 2 ha;47;62;18;29;22;40;18;29;5;13;13;16;0;11;0;11;;
Arapoti;De 2 a menos de 3 ha;32;77;10;22;24;53;11;21;4;6;7;15;0;6;0;13;;
Arapoti;De 3 a menos de 4 ha;42;145;11;31;38;107;17;25;7;4;10;21;0;2;0;18;;
Arapoti;De 4 a menos de 5 ha;42;195;17;25;78;117;15;27;7;10;8;17;1;8;3;13;;
Arapoti;De 5 a menos de 10 ha;112;823;27;85;197;626;51;61;6;21;45;40;0;16;0;35;;
Arapoti;De 10 a menos de 20 ha;100;1419;28;72;394;1026;51;49;11;17;40;32;0;13;1;24;;
Arapoti;De 20 a menos de 50 ha;133;4317;30;103;955;3362;76;57;14;16;62;41;0;13;2;32;;
Arapoti;De 50 a menos de 100 ha;57;4160;37;20;2865;1295;34;23;23;14;11;9;0;9;0;6;;
Arapoti;De 100 a menos de 200 ha;57;7791;57;0;7791;0;48;9;48;9;0;0;0;7;0;0;;
Arapoti;De 200 a menos de 500 ha;63;19513;63;0;19513;0;48;15;48;15;0;0;0;11;0;0;;
Arapoti;De 500 a menos de 1.000 ha;20;14482;20;0;14482;0;17;3;17;3;0;0;0;1;0;0;;
Arapoti;De 1.000 a menos de 2.500 ha;7;10918;7;0;10918;0;6;1;6;1;0;0;0;1;0;0;;
Arapoti;De 2.500 a menos de 10.000 ha;7;0;7;0;0;0;5;2;5;2;0;0;0;2;0;0;;
Arapoti;De 10.000 ha e mais;1;0;1;0;0;0;1;0;1;0;0;0;0;0;0;0;;
Arapoti;Produtor sem área;34;0;8;26;0;0;0;1;0;1;0;0;0;1;0;0;;
Arapuã;Mais de 0 a menos de 0,1 ha;0;0;0;0;0;0;0;0;0;0;0;0;0;0;0;0;;
Arapuã;De 0,1 a menos de 0,2 ha;2;0;1;1;0;0;0;2;0;1;0;1;0;1;0;1;;
Arapuã;De 0,2 a menos de 0,5 ha;4;0;1;3;0;0;2;2;0;1;2;1;0;1;0;1;;
Arapuã;De 0,5 a menos de 1 ha;26;14;5;21;3;11;4;22;0;5;4;17;0;3;0;12;;
Arapuã;De 1 a menos de 2 ha;14;18;3;11;4;14;5;9;2;1;3;8;0;1;0;6;;
Arapuã;De 2 a menos de 3 ha;18;44;4;14;10;34;8;10;0;4;8;6;0;4;0;5;;
Arapuã;De 3 a menos de 4 ha;18;65;2;16;0;0;8;10;0;2;8;8;0;2;0;7;;
Arapuã;De 4 a menos de 5 ha;18;87;2;16;0;0;7;11;1;1;6;10;0;1;0;9;;
Arapuã;De 5 a menos de 10 ha;62;477;3;59;24;453;39;23;1;2;38;21;0;2;0;17;;
Arapuã;De 10 a menos de 20 ha;98;1411;8;90;120;1291;65;33;5;3;60;30;0;3;0;20;;
Arapuã;De 20 a menos de 50 ha;130;4060;8;122;221;3839;101;29;5;3;96;26;0;3;0;18;;
Arapuã;De 50 a menos de 100 ha;48;3391;23;25;1893;1498;41;7;21;2;20;5;0;2;0;4;;
Arapuã;De 100 a menos de 200 ha;21;3272;21;0;3272;0;19;2;19;2;0;0;0;1;0;0;;
Arapuã;De 200 a menos de 500 ha;12;3288;12;0;3288;0;11;1;11;1;0;0;0;1;0;0;;
Arapuã;De 500 a menos de 1.000 ha;5;3372;5;0;3372;0;5;0;5;0;0;0;0;0;0;0;;
Arapuã;De 1.000 a menos de 2.500 ha;0;0;0;0;0;0;0;0;0;0;0;0;0;0;0;0;;
Arapuã;De 2.500 a menos de 10.000 ha;0;0;0;0;0;0;0;0;0;0;0;0;0;0;0;0;;
Arapuã;De 10.000 ha e mais;0;0;0;0;0;0;0;0;0;0;0;0;0;0;0;0;;
Arapuã;Produtor sem área;0;0;0;0;0;0;0;0;0;0;0;0;0;0;0;0;;
Araruna;Mais de 0 a menos de 0,1 ha;0;0;0;0;0;0;0;0;0;0;0;0;0;0;0;0;;
Araruna;De 0,1 a menos de 0,2 ha;1;0;0;1;0;0;0;1;0;0;0;1;0;0;0;1;;
Araruna;De 0,2 a menos de 0,5 ha;0;0;0;0;0;0;0;0;0;0;0;0;0;0;0;0;;
Araruna;De 0,5 a menos de 1 ha;2;0;0;2;0;0;0;2;0;0;0;2;0;0;0;1;;
Araruna;De 1 a menos de 2 ha;5;8;1;4;0;0;3;2;1;0;2;2;0;0;0;2;;
Araruna;De 2 a menos de 3 ha;12;29;3;9;0;0;5;7;0;3;5;4;0;3;0;3;;
Araruna;De 3 a menos de 4 ha;18;62;6;12;21;40;6;12;2;4;4;8;0;2;0;4;;
Araruna;De 4 a menos de 5 ha;39;186;20;19;96;90;12;27;4;16;8;11;0;10;0;8;;
Araruna;De 5 a menos de 10 ha;111;843;27;84;191;652;55;56;4;23;51;33;1;18;0;16;;
Araruna;De 10 a menos de 20 ha;115;1636;21;94;313;1324;56;59;3;18;53;41;0;13;0;25;;
Araruna;De 20 a menos de 50 ha;127;3952;15;112;437;3516;89;38;5;10;84;28;0;8;0;20;;
Araruna;De 50 a menos de 100 ha;77;5660;34;43;2909;2751;66;11;26;8;40;3;0;6;0;1;;
Araruna;De 100 a menos de 200 ha;48;7169;48;0;7169;0;40;8;40;8;0;0;0;5;0;0;;
Araruna;De 200 a menos de 500 ha;40;11692;40;0;11692;0;38;2;38;2;0;0;0;1;0;0;;
Araruna;De 500 a menos de 1.000 ha;11;7179;11;0;7179;0;11;0;11;0;0;0;0;0;0;0;;
Araruna;De 1.000 a menos de 2.500 ha;4;5063;4;0;5063;0;4;0;4;0;0;0;0;0;0;0;;
Araruna;De 2.500 a menos de 10.000 ha;0;0;0;0;0;0;0;0;0;0;0;0;0;0;0;0;;
Araruna;De 10.000 ha e mais;0;0;0;0;0;0;0;0;0;0;0;0;0;0;0;0;;
Araruna;Produtor sem área;1;0;0;1;0;0;1;0;0;0;1;0;0;0;0;0;;
Araucária;Mais de 0 a menos de 0,1 ha;4;0;0;4;0;0;1;3;0;0;1;3;0;0;0;2;;
Araucária;De 0,1 a menos de 0,2 ha;3;0;2;1;0;0;1;2;0;2;1;0;2;0;0;0;;
Araucária;De 0,2 a menos de 0,5 ha;26;10;0;26;0;10;0;26;0;0;0;26;0;0;3;21;;
Araucária;De 0,5 a menos de 1 ha;42;31;3;39;2;29;10;32;2;1;8;31;0;1;6;17;;
Araucária;De 1 a menos de 2 ha;99;131;14;85;19;112;34;65;7;7;27;58;0;3;10;35;;
Araucária;De 2 a menos de 3 ha;143;344;16;127;39;304;80;63;11;5;69;58;1;3;7;33;;
Araucária;De 3 a menos de 4 ha;85;301;10;75;36;265;58;27;9;1;49;26;1;0;5;11;;
Araucária;De 4 a menos de 5 ha;77;365;12;65;57;308;58;19;5;7;53;12;0;5;0;8;;
Araucária;De 5 a menos de 10 ha;272;2021;28;244;210;1812;222;50;17;11;205;39;1;7;3;16;;
Araucária;De 10 a menos de 20 ha;279;4019;16;263;222;3797;242;37;11;5;231;32;0;5;2;16;;
Araucária;De 20 a menos de 50 ha;258;7790;32;226;1112;6678;228;30;20;12;208;18;2;6;2;8;;
Araucária;De 50 a menos de 100 ha;65;4362;65;0;4362;0;55;10;55;10;0;0;1;7;0;0;;
Araucária;De 100 a menos de 200 ha;20;2741;20;0;2741;0;20;0;20;0;0;0;0;0;0;0;;
Araucária;De 200 a menos de 500 ha;12;2980;12;0;2980;0;10;2;10;2;0;0;1;1;0;0;;
Araucária;De 500 a menos de 1.000 ha;1;0;1;0;0;0;1;0;1;0;0;0;0;0;0;0;;
Araucária;De 1.000 a menos de 2.500 ha;1;0;1;0;0;0;1;0;1;0;0;0;0;0;0;0;;
Araucária;De 2.500 a menos de 10.000 ha;0;0;0;0;0;0;0;0;0;0;0;0;0;0;0;0;;
Araucária;De 10.000 ha e mais;0;0;0;0;0;0;0;0;0;0;0;0;0;0;0;0;;
Araucária;Produtor sem área;0;0;0;0;0;0;0;0;0;0;0;0;0;0;0;0;;
Ariranha do Ivaí;Mais de 0 a menos de 0,1 ha;1;0;0;1;0;0;0;1;0;0;0;1;0;0;0;1;;
Ariranha do Ivaí;De 0,1 a menos de 0,2 ha;1;0;1;0;0;0;0;1;0;1;0;0;0;1;0;0;;
Ariranha do Ivaí;De 0,2 a menos de 0,5 ha;3;1;1;2;0;0;1;2;0;1;1;1;0;1;0;1;;
Ariranha do Ivaí;De 0,5 a menos de 1 ha;4;3;2;2;0;0;1;3;1;1;0;2;0;1;0;1;;
Ariranha do Ivaí;De 1 a menos de 2 ha;24;31;8;16;11;20;10;14;5;3;5;11;0;2;0;8;;
Ariranha do Ivaí;De 2 a menos de 3 ha;28;68;5;23;12;56;10;18;3;2;7;16;0;0;0;13;;
Ariranha do Ivaí;De 3 a menos de 4 ha;18;64;9;9;32;32;10;8;6;3;4;5;0;2;0;3;;
Ariranha do Ivaí;De 4 a menos de 5 ha;41;196;11;30;52;143;28;13;6;5;22;8;0;4;0;8;;
Ariranha do Ivaí;De 5 a menos de 10 ha;124;938;16;108;121;817;69;55;5;11;64;44;0;11;0;36;;
Ariranha do Ivaí;De 10 a menos de 20 ha;113;1647;8;105;113;1535;85;28;5;3;80;25;0;3;0;19;;
Ariranha do Ivaí;De 20 a menos de 50 ha;86;2515;9;77;230;2285;69;17;6;3;63;14;0;3;0;12;;
Ariranha do Ivaí;De 50 a menos de 100 ha;34;2593;22;12;1839;754;30;4;19;3;11;1;0;1;0;1;;
Ariranha do Ivaí;De 100 a menos de 200 ha;25;3515;25;0;3515;0;18;7;18;7;0;0;0;6;0;0;;
Ariranha do Ivaí;De 200 a menos de 500 ha;16;4511;16;0;4511;0;11;5;11;5;0;0;0;4;0;0;;
Ariranha do Ivaí;De 500 a menos de 1.000 ha;4;3141;4;0;3141;0;3;1;3;1;0;0;0;0;0;0;;
Ariranha do Ivaí;De 1.000 a menos de 2.500 ha;1;0;1;0;0;0;1;0;1;0;0;0;0;0;0;0;;
Ariranha do Ivaí;De 2.500 a menos de 10.000 ha;0;0;0;0;0;0;0;0;0;0;0;0;0;0;0;0;;
Ariranha do Ivaí;De 10.000 ha e mais;0;0;0;0;0;0;0;0;0;0;0;0;0;0;0;0;;
Ariranha do Ivaí;Produtor sem área;1;0;0;1;0;0;1;0;0;0;1;0;0;0;0;0;;
Assaí;Mais de 0 a menos de 0,1 ha;4;0;0;4;0;0;1;3;0;0;1;3;0;0;0;2;;
Assaí;De 0,1 a menos de 0,2 ha;1;0;0;1;0;0;1;0;0;0;1;0;0;0;0;0;;
Assaí;De 0,2 a menos de 0,5 ha;1;0;1;0;0;0;0;1;0;1;0;0;0;0;0;0;;
Assaí;De 0,5 a menos de 1 ha;47;25;25;22;13;11;21;26;9;16;12;10;3;7;0;8;;
Assaí;De 1 a menos de 2 ha;16;21;0;16;0;21;13;3;0;0;13;3;0;0;0;2;;
Assaí;De 2 a menos de 3 ha;20;48;5;15;11;37;12;8;2;3;10;5;0;2;3;2;;
Assaí;De 3 a menos de 4 ha;20;69;4;16;0;0;11;9;3;1;8;8;0;0;1;5;;
Assaí;De 4 a menos de 5 ha;26;123;1;25;0;0;17;9;0;1;17;8;0;0;1;2;;
Assaí;De 5 a menos de 10 ha;90;656;7;83;54;603;65;25;3;4;62;21;0;4;1;16;;
Assaí;De 10 a menos de 20 ha;92;1307;10;82;163;1144;77;15;5;5;72;10;0;5;1;9;;
Assaí;De 20 a menos de 50 ha;132;4220;10;122;322;3898;117;15;6;4;111;11;1;2;1;8;;
Assaí;De 50 a menos de 100 ha;75;5442;45;30;3673;1769;66;9;39;6;27;3;0;5;0;3;;
Assaí;De 100 a menos de 200 ha;39;5160;39;0;5160;0;35;4;35;4;0;0;0;2;0;0;;
Assaí;De 200 a menos de 500 ha;30;9892;30;0;9892;0;26;4;26;4;0;0;0;2;0;0;;
Assaí;De 500 a menos de 1.000 ha;5;2916;5;0;2916;0;5;0;5;0;0;0;0;0;0;0;;
Assaí;De 1.000 a menos de 2.500 ha;0;0;0;0;0;0;0;0;0;0;0;0;0;0;0;0;;
Assaí;De 2.500 a menos de 10.000 ha;0;0;0;0;0;0;0;0;0;0;0;0;0;0;0;0;;
Assaí;De 10.000 ha e mais;0;0;0;0;0;0;0;0;0;0;0;0;0;0;0;0;;
Assaí;Produtor sem área;0;0;0;0;0;0;0;0;0;0;0;0;0;0;0;0;;
Assis Chateaubriand;Mais de 0 a menos de 0,1 ha;20;1;5;15;0;1;1;19;0;5;1;14;0;5;1;11;;
Assis Chateaubriand;De 0,1 a menos de 0,2 ha;14;2;1;13;0;0;1;13;0;1;1;12;0;0;1;10;;
Assis Chateaubriand;De 0,2 a menos de 0,5 ha;20;7;4;16;2;5;1;19;1;3;0;16;1;2;3;12;;
Assis Chateaubriand;De 0,5 a menos de 1 ha;22;13;1;21;0;0;1;21;0;1;1;20;1;0;1;15;;
Assis Chateaubriand;De 1 a menos de 2 ha;24;32;5;19;6;25;7;17;2;3;5;14;0;2;0;9;;
Assis Chateaubriand;De 2 a menos de 3 ha;58;143;5;53;12;131;31;27;1;4;30;23;0;2;2;17;;
Assis Chateaubriand;De 3 a menos de 4 ha;35;126;4;31;15;111;23;12;2;2;21;10;1;0;1;7;;
Assis Chateaubriand;De 4 a menos de 5 ha;65;313;8;57;38;275;49;16;2;6;47;10;0;4;0;8;;
Assis Chateaubriand;De 5 a menos de 10 ha;180;1429;7;173;49;1380;165;15;3;4;162;11;2;1;3;5;;
Assis Chateaubriand;De 10 a menos de 20 ha;297;4346;10;287;152;4193;287;10;6;4;281;6;1;2;0;6;;
Assis Chateaubriand;De 20 a menos de 50 ha;370;11826;14;356;413;11414;359;11;11;3;348;8;0;3;0;5;;
Assis Chateaubriand;De 50 a menos de 100 ha;178;12754;93;85;7686;5068;178;0;93;0;85;0;0;0;0;0;;
Assis Chateaubriand;De 100 a menos de 200 ha;99;13635;99;0;13635;0;99;0;99;0;0;0;0;0;0;0;;
Assis Chateaubriand;De 200 a menos de 500 ha;69;20102;69;0;20102;0;68;1;68;1;0;0;0;1;0;0;;
Assis Chateaubriand;De 500 a menos de 1.000 ha;16;10466;16;0;10466;0;16;0;16;0;0;0;0;0;0;0;;
Assis Chateaubriand;De 1.000 a menos de 2.500 ha;3;0;3;0;0;0;2;1;2;1;0;0;0;1;0;0;;
Assis Chateaubriand;De 2.500 a menos de 10.000 ha;0;0;0;0;0;0;0;0;0;0;0;0;0;0;0;0;;
Assis Chateaubriand;De 10.000 ha e mais;0;0;0;0;0;0;0;0;0;0;0;0;0;0;0;0;;
Assis Chateaubriand;Produtor sem área;2;0;0;2;0;0;0;0;0;0;0;0;0;0;0;0;;
Astorga;Mais de 0 a menos de 0,1 ha;3;0;0;3;0;0;0;3;0;0;0;3;0;0;0;3;;
Astorga;De 0,1 a menos de 0,2 ha;7;1;5;2;0;0;1;6;1;4;0;2;2;2;2;0;;
Astorga;De 0,2 a menos de 0,5 ha;24;8;7;17;3;5;2;22;1;6;1;16;0;5;3;10;;
Astorga;De 0,5 a menos de 1 ha;91;52;38;53;21;31;16;75;6;32;10;43;2;22;7;20;;
Astorga;De 1 a menos de 2 ha;25;33;4;21;5;28;8;17;1;3;7;14;0;2;2;10;;
Astorga;De 2 a menos de 3 ha;50;118;16;34;37;81;10;40;1;15;9;25;2;12;3;12;;
Astorga;De 3 a menos de 4 ha;78;259;15;63;50;209;17;61;0;15;17;46;1;11;2;36;;
Astorga;De 4 a menos de 5 ha;30;141;9;21;43;98;9;21;0;9;9;12;0;6;0;12;;
Astorga;De 5 a menos de 10 ha;99;739;22;77;164;575;44;55;6;16;38;39;1;9;1;20;;
Astorga;De 10 a menos de 20 ha;85;1219;12;73;178;1041;52;33;4;8;48;25;1;7;0;14;;
Astorga;De 20 a menos de 50 ha;76;2479;7;69;250;2229;63;13;3;4;60;9;0;2;0;6;;
Astorga;De 50 a menos de 100 ha;59;4115;40;19;3058;1057;49;10;33;7;16;3;0;4;1;1;;
Astorga;De 100 a menos de 200 ha;29;4035;29;0;4035;0;27;2;27;2;0;0;0;0;0;0;;
Astorga;De 200 a menos de 500 ha;34;10330;34;0;10330;0;32;2;32;2;0;0;0;1;0;0;;
Astorga;De 500 a menos de 1.000 ha;10;6500;10;0;6500;0;10;0;10;0;0;0;0;0;0;0;;
Astorga;De 1.000 a menos de 2.500 ha;2;0;2;0;0;0;2;0;2;0;0;0;0;0;0;0;;
Astorga;De 2.500 a menos de 10.000 ha;2;0;2;0;0;0;2;0;2;0;0;0;0;0;0;0;;
Astorga;De 10.000 ha e mais;0;0;0;0;0;0;0;0;0;0;0;0;0;0;0;0;;
Astorga;Produtor sem área;1;0;0;1;0;0;0;0;0;0;0;0;0;0;0;0;;
Atalaia;Mais de 0 a menos de 0,1 ha;2;0;1;1;0;0;0;2;0;1;0;1;0;1;0;0;;
Atalaia;De 0,1 a menos de 0,2 ha;1;0;1;0;0;0;0;1;0;1;0;0;0;1;0;0;;
Atalaia;De 0,2 a menos de 0,5 ha;2;0;0;2;0;0;2;0;0;0;2;0;0;0;0;0;;
Atalaia;De 0,5 a menos de 1 ha;65;33;21;44;11;23;4;61;1;20;3;41;0;20;0;33;;
Atalaia;De 1 a menos de 2 ha;13;19;4;9;5;14;1;12;0;4;1;8;0;4;0;6;;
Atalaia;De 2 a menos de 3 ha;10;24;4;6;9;15;3;7;1;3;2;4;0;2;0;3;;
Atalaia;De 3 a menos de 4 ha;10;35;3;7;10;24;4;6;2;1;2;5;0;1;0;2;;
Atalaia;De 4 a menos de 5 ha;11;53;3;8;15;39;2;9;0;3;2;6;0;3;0;4;;
Atalaia;De 5 a menos de 10 ha;41;317;4;37;27;289;17;24;2;2;15;22;0;2;0;14;;
Atalaia;De 10 a menos de 20 ha;29;424;5;24;63;361;14;15;1;4;13;11;0;3;0;7;;
Atalaia;De 20 a menos de 50 ha;46;1581;5;41;144;1437;38;8;4;1;34;7;0;1;0;4;;
Atalaia;De 50 a menos de 100 ha;19;1372;11;8;912;460;17;2;11;0;6;2;0;0;0;2;;
Atalaia;De 100 a menos de 200 ha;18;2293;18;0;2293;0;16;2;16;2;0;0;0;1;0;0;;
Atalaia;De 200 a menos de 500 ha;9;2570;9;0;2570;0;9;0;9;0;0;0;0;0;0;0;;
Atalaia;De 500 a menos de 1.000 ha;2;0;2;0;0;0;2;0;2;0;0;0;0;0;0;0;;
Atalaia;De 1.000 a menos de 2.500 ha;1;0;1;0;0;0;1;0;1;0;0;0;0;0;0;0;;
Atalaia;De 2.500 a menos de 10.000 ha;0;0;0;0;0;0;0;0;0;0;0;0;0;0;0;0;;
Atalaia;De 10.000 ha e mais;0;0;0;0;0;0;0;0;0;0;0;0;0;0;0;0;;
Atalaia;Produtor sem área;0;0;0;0;0;0;0;0;0;0;0;0;0;0;0;0;;
Balsa Nova;Mais de 0 a menos de 0,1 ha;0;0;0;0;0;0;0;0;0;0;0;0;0;0;0;0;;
Balsa Nova;De 0,1 a menos de 0,2 ha;3;0;0;3;0;0;1;2;0;0;1;2;0;0;0;1;;
Balsa Nova;De 0,2 a menos de 0,5 ha;13;6;5;8;2;4;0;13;0;5;0;8;0;5;0;6;;
Balsa Nova;De 0,5 a menos de 1 ha;9;7;1;8;0;0;1;8;0;1;1;7;0;1;0;3;;
Balsa Nova;De 1 a menos de 2 ha;23;32;8;15;11;21;8;15;2;6;6;9;0;5;1;8;;
Balsa Nova;De 2 a menos de 3 ha;28;69;3;25;8;61;14;14;1;2;13;12;0;2;0;8;;
Balsa Nova;De 3 a menos de 4 ha;11;38;3;8;11;27;2;9;0;3;2;6;0;2;0;2;;
Balsa Nova;De 4 a menos de 5 ha;13;62;2;11;0;0;7;6;0;2;7;4;0;2;0;2;;
Balsa Nova;De 5 a menos de 10 ha;35;269;11;24;80;189;18;17;3;8;15;9;0;6;0;3;;
Balsa Nova;De 10 a menos de 20 ha;40;606;7;33;98;508;26;14;3;4;23;10;0;4;0;6;;
Balsa Nova;De 20 a menos de 50 ha;50;1720;16;34;636;1084;41;9;12;4;29;5;0;4;0;3;;
Balsa Nova;De 50 a menos de 100 ha;28;1981;28;0;1981;0;25;3;25;3;0;0;0;1;0;0;;
Balsa Nova;De 100 a menos de 200 ha;20;2998;20;0;2998;0;16;4;16;4;0;0;0;3;0;0;;
Balsa Nova;De 200 a menos de 500 ha;14;4189;14;0;4189;0;9;5;9;5;0;0;0;4;0;0;;
Balsa Nova;De 500 a menos de 1.000 ha;5;3065;5;0;3065;0;5;0;5;0;0;0;0;0;0;0;;
Balsa Nova;De 1.000 a menos de 2.500 ha;0;0;0;0;0;0;0;0;0;0;0;0;0;0;0;0;;
Balsa Nova;De 2.500 a menos de 10.000 ha;2;0;2;0;0;0;2;0;2;0;0;0;0;0;0;0;;
Balsa Nova;De 10.000 ha e mais;0;0;0;0;0;0;0;0;0;0;0;0;0;0;0;0;;
Balsa Nova;Produtor sem área;1;0;1;0;0;0;0;1;0;1;0;0;0;1;0;0;;
Bandeirantes;Mais de 0 a menos de 0,1 ha;2;0;0;2;0;0;1;1;0;0;1;1;0;0;0;1;;
Bandeirantes;De 0,1 a menos de 0,2 ha;3;0;0;3;0;0;2;1;0;0;2;1;0;0;0;1;;
Bandeirantes;De 0,2 a menos de 0,5 ha;28;8;5;23;2;7;18;10;1;4;17;6;1;3;1;4;;
Bandeirantes;De 0,5 a menos de 1 ha;62;35;16;46;9;26;36;26;6;10;30;16;1;9;1;12;;
Bandeirantes;De 1 a menos de 2 ha;50;59;6;44;6;53;36;14;2;4;34;10;0;4;0;8;;
Bandeirantes;De 2 a menos de 3 ha;56;134;9;47;21;112;35;21;5;4;30;17;0;3;1;13;;
Bandeirantes;De 3 a menos de 4 ha;32;112;3;29;10;102;25;7;1;2;24;5;0;1;0;1;;
Bandeirantes;De 4 a menos de 5 ha;47;221;2;45;0;0;32;15;0;2;32;13;0;2;0;8;;
Bandeirantes;De 5 a menos de 10 ha;148;1144;12;136;103;1041;115;33;7;5;108;28;0;5;1;12;;
Bandeirantes;De 10 a menos de 20 ha;150;2142;4;146;57;2085;131;19;3;1;128;18;0;0;0;11;;
Bandeirantes;De 20 a menos de 50 ha;106;3354;5;101;156;3198;92;14;4;1;88;13;0;1;0;4;;
Bandeirantes;De 50 a menos de 100 ha;39;2632;16;23;1306;1326;33;6;13;3;20;3;0;2;0;2;;
Bandeirantes;De 100 a menos de 200 ha;32;4558;32;0;4558;0;27;5;27;5;0;0;0;2;0;0;;
Bandeirantes;De 200 a menos de 500 ha;17;5070;17;0;5070;0;15;2;15;2;0;0;0;2;0;0;;
Bandeirantes;De 500 a menos de 1.000 ha;1;0;1;0;0;0;1;0;1;0;0;0;0;0;0;0;;
Bandeirantes;De 1.000 a menos de 2.500 ha;0;0;0;0;0;0;0;0;0;0;0;0;0;0;0;0;;
Bandeirantes;De 2.500 a menos de 10.000 ha;1;0;1;0;0;0;1;0;1;0;0;0;0;0;0;0;;
Bandeirantes;De 10.000 ha e mais;0;0;0;0;0;0;0;0;0;0;0;0;0;0;0;0;;
Bandeirantes;Produtor sem área;0;0;0;0;0;0;0;0;0;0;0;0;0;0;0;0;;
Barbosa Ferraz;Mais de 0 a menos de 0,1 ha;2;0;0;2;0;0;0;2;0;0;0;2;0;0;0;2;;
Barbosa Ferraz;De 0,1 a menos de 0,2 ha;0;0;0;0;0;0;0;0;0;0;0;0;0;0;0;0;;
Barbosa Ferraz;De 0,2 a menos de 0,5 ha;3;0;0;3;0;0;2;1;0;0;2;1;0;0;0;1;;
Barbosa Ferraz;De 0,5 a menos de 1 ha;70;35;24;46;12;23;21;49;9;15;12;34;2;10;3;7;;
Barbosa Ferraz;De 1 a menos de 2 ha;26;33;8;18;11;22;8;18;2;6;6;12;3;2;3;5;;
Barbosa Ferraz;De 2 a menos de 3 ha;39;95;13;26;31;63;12;27;2;11;10;16;2;8;0;11;;
Barbosa Ferraz;De 3 a menos de 4 ha;47;166;9;38;32;134;13;34;2;7;11;27;2;5;3;21;;
Barbosa Ferraz;De 4 a menos de 5 ha;38;180;7;31;33;147;12;26;2;5;10;21;0;4;2;15;;
Barbosa Ferraz;De 5 a menos de 10 ha;146;1145;28;118;216;929;70;76;12;16;58;60;1;12;6;48;;
Barbosa Ferraz;De 10 a menos de 20 ha;187;2641;25;162;366;2275;95;92;8;17;87;75;1;15;7;54;;
Barbosa Ferraz;De 20 a menos de 50 ha;148;4656;18;130;488;4168;94;54;4;14;90;40;1;11;2;33;;
Barbosa Ferraz;De 50 a menos de 100 ha;79;5545;21;58;1765;3780;61;18;15;6;46;12;1;5;1;7;;
Barbosa Ferraz;De 100 a menos de 200 ha;67;9459;67;0;9459;0;50;17;50;17;0;0;1;12;0;0;;
Barbosa Ferraz;De 200 a menos de 500 ha;45;14159;45;0;14159;0;34;11;34;11;0;0;0;9;0;0;;
Barbosa Ferraz;De 500 a menos de 1.000 ha;7;4737;7;0;4737;0;6;1;6;1;0;0;0;1;0;0;;
Barbosa Ferraz;De 1.000 a menos de 2.500 ha;4;0;4;0;0;0;4;0;4;0;0;0;0;0;0;0;;
Barbosa Ferraz;De 2.500 a menos de 10.000 ha;1;0;1;0;0;0;1;0;1;0;0;0;0;0;0;0;;
Barbosa Ferraz;De 10.000 ha e mais;0;0;0;0;0;0;0;0;0;0;0;0;0;0;0;0;;
Barbosa Ferraz;Produtor sem área;0;0;0;0;0;0;0;0;0;0;0;0;0;0;0;0;;
Barracão;Mais de 0 a menos de 0,1 ha;31;1;6;25;0;1;0;31;0;6;0;25;0;6;0;25;;
Barracão;De 0,1 a menos de 0,2 ha;12;2;3;9;0;0;0;12;0;3;0;9;0;3;0;9;;
Barracão;De 0,2 a menos de 0,5 ha;15;5;8;7;0;0;0;15;0;8;0;7;0;7;0;7;;
Barracão;De 0,5 a menos de 1 ha;45;25;13;32;7;18;1;44;0;13;1;31;0;8;0;25;;
Barracão;De 1 a menos de 2 ha;35;39;9;26;10;30;4;31;1;8;3;23;0;7;0;15;;
Barracão;De 2 a menos de 3 ha;48;114;8;40;19;95;12;36;0;8;12;28;0;7;0;18;;
Barracão;De 3 a menos de 4 ha;36;121;6;30;21;100;7;29;0;6;7;23;0;3;0;13;;
Barracão;De 4 a menos de 5 ha;48;217;11;37;51;167;10;38;1;10;9;28;0;8;0;12;;
Barracão;De 5 a menos de 10 ha;194;1402;21;173;147;1255;45;149;1;20;44;129;0;12;0;66;;
Barracão;De 10 a menos de 20 ha;179;2500;17;162;223;2278;45;134;4;13;41;121;2;8;3;51;;
Barracão;De 20 a menos de 50 ha;103;2919;11;92;350;2569;48;55;3;8;45;47;0;6;0;19;;
Barracão;De 50 a menos de 100 ha;21;1509;6;15;472;1037;13;8;5;1;8;7;0;0;0;4;;
Barracão;De 100 a menos de 200 ha;19;2529;19;0;2529;0;8;11;8;11;0;0;0;6;0;0;;
Barracão;De 200 a menos de 500 ha;6;0;6;0;0;0;2;4;2;4;0;0;0;2;0;0;;
Barracão;De 500 a menos de 1.000 ha;1;0;1;0;0;0;1;0;1;0;0;0;0;0;0;0;;
Barracão;De 1.000 a menos de 2.500 ha;1;0;1;0;0;0;1;0;1;0;0;0;0;0;0;0;;
Barracão;De 2.500 a menos de 10.000 ha;0;0;0;0;0;0;0;0;0;0;0;0;0;0;0;0;;
Barracão;De 10.000 ha e mais;0;0;0;0;0;0;0;0;0;0;0;0;0;0;0;0;;
Barracão;Produtor sem área;0;0;0;0;0;0;0;0;0;0;0;0;0;0;0;0;;
Barra do Jacaré;Mais de 0 a menos de 0,1 ha;2;0;1;1;0;0;0;2;0;1;0;1;0;1;0;1;;
Barra do Jacaré;De 0,1 a menos de 0,2 ha;2;0;2;0;0;0;0;2;0;2;0;0;0;2;0;0;;
Barra do Jacaré;De 0,2 a menos de 0,5 ha;4;1;2;2;0;0;0;4;0;2;0;2;0;2;0;2;;
Barra do Jacaré;De 0,5 a menos de 1 ha;34;19;13;21;7;12;12;22;6;7;6;15;0;4;1;12;;
Barra do Jacaré;De 1 a menos de 2 ha;3;4;0;3;0;4;3;0;0;0;3;0;0;0;0;0;;
Barra do Jacaré;De 2 a menos de 3 ha;9;22;1;8;0;0;6;3;1;0;5;3;0;0;0;2;;
Barra do Jacaré;De 3 a menos de 4 ha;9;32;0;9;0;32;6;3;0;0;6;3;0;0;0;1;;
Barra do Jacaré;De 4 a menos de 5 ha;15;71;1;14;0;0;7;8;0;1;7;7;0;1;0;5;;
Barra do Jacaré;De 5 a menos de 10 ha;58;467;3;55;25;442;40;18;0;3;40;15;0;2;0;10;;
Barra do Jacaré;De 10 a menos de 20 ha;71;987;6;65;102;885;55;16;3;3;52;13;0;3;0;6;;
Barra do Jacaré;De 20 a menos de 50 ha;46;1482;4;42;126;1356;40;6;3;1;37;5;0;1;0;3;;
Barra do Jacaré;De 50 a menos de 100 ha;13;903;5;8;438;465;13;0;5;0;8;0;0;0;0;0;;
Barra do Jacaré;De 100 a menos de 200 ha;7;1007;7;0;1007;0;6;1;6;1;0;0;0;0;0;0;;
Barra do Jacaré;De 200 a menos de 500 ha;7;1987;7;0;1987;0;5;2;5;2;0;0;0;1;0;0;;
Barra do Jacaré;De 500 a menos de 1.000 ha;2;0;2;0;0;0;2;0;2;0;0;0;0;0;0;0;;
Barra do Jacaré;De 1.000 a menos de 2.500 ha;0;0;0;0;0;0;0;0;0;0;0;0;0;0;0;0;;
Barra do Jacaré;De 2.500 a menos de 10.000 ha;0;0;0;0;0;0;0;0;0;0;0;0;0;0;0;0;;
Barra do Jacaré;De 10.000 ha e mais;0;0;0;0;0;0;0;0;0;0;0;0;0;0;0;0;;
Barra do Jacaré;Produtor sem área;0;0;0;0;0;0;0;0;0;0;0;0;0;0;0;0;;
Bela Vista da Caroba;Mais de 0 a menos de 0,1 ha;18;1;11;7;1;0;5;13;4;7;1;6;1;3;0;5;;
Bela Vista da Caroba;De 0,1 a menos de 0,2 ha;22;3;8;14;1;2;8;14;3;5;5;9;0;2;0;5;;
Bela Vista da Caroba;De 0,2 a menos de 0,5 ha;13;4;5;8;1;2;1;12;0;5;1;7;0;3;0;7;;
Bela Vista da Caroba;De 0,5 a menos de 1 ha;27;17;10;17;6;11;10;17;3;7;7;10;1;4;1;9;;
Bela Vista da Caroba;De 1 a menos de 2 ha;42;51;9;33;11;40;31;11;5;4;26;7;0;2;0;3;;
Bela Vista da Caroba;De 2 a menos de 3 ha;50;118;13;37;31;87;38;12;11;2;27;10;0;2;0;6;;
Bela Vista da Caroba;De 3 a menos de 4 ha;53;183;12;41;42;141;47;6;10;2;37;4;0;2;0;2;;
Bela Vista da Caroba;De 4 a menos de 5 ha;84;398;6;78;29;369;76;8;6;0;70;8;0;0;2;5;;
Bela Vista da Caroba;De 5 a menos de 10 ha;215;1576;26;189;195;1382;201;14;21;5;180;9;0;4;0;5;;
Bela Vista da Caroba;De 10 a menos de 20 ha;161;2329;9;152;125;2205;153;8;7;2;146;6;0;2;0;4;;
Bela Vista da Caroba;De 20 a menos de 50 ha;100;3110;10;90;312;2798;98;2;10;0;88;2;0;0;0;1;;
Bela Vista da Caroba;De 50 a menos de 100 ha;37;2677;17;20;1467;1210;34;3;15;2;19;1;0;2;0;1;;
Bela Vista da Caroba;De 100 a menos de 200 ha;9;1129;9;0;1129;0;9;0;9;0;0;0;0;0;0;0;;
Bela Vista da Caroba;De 200 a menos de 500 ha;7;1796;7;0;1796;0;7;0;7;0;0;0;0;0;0;0;;
Bela Vista da Caroba;De 500 a menos de 1.000 ha;0;0;0;0;0;0;0;0;0;0;0;0;0;0;0;0;;
Bela Vista da Caroba;De 1.000 a menos de 2.500 ha;0;0;0;0;0;0;0;0;0;0;0;0;0;0;0;0;;
Bela Vista da Caroba;De 2.500 a menos de 10.000 ha;0;0;0;0;0;0;0;0;0;0;0;0;0;0;0;0;;
Bela Vista da Caroba;De 10.000 ha e mais;0;0;0;0;0;0;0;0;0;0;0;0;0;0;0;0;;
Bela Vista da Caroba;Produtor sem área;0;0;0;0;0;0;0;0;0;0;0;0;0;0;0;0;;
Bela Vista do Paraíso;Mais de 0 a menos de 0,1 ha;0;0;0;0;0;0;0;0;0;0;0;0;0;0;0;0;;
Bela Vista do Paraíso;De 0,1 a menos de 0,2 ha;4;1;1;3;0;0;0;4;0;1;0;3;0;1;0;3;;
Bela Vista do Paraíso;De 0,2 a menos de 0,5 ha;25;8;3;22;1;7;0;25;0;3;0;22;0;3;2;20;;
Bela Vista do Paraíso;De 0,5 a menos de 1 ha;60;30;27;33;14;17;1;59;0;27;1;32;2;25;2;29;;
Bela Vista do Paraíso;De 1 a menos de 2 ha;7;9;1;6;0;0;2;5;0;1;2;4;0;1;0;4;;
Bela Vista do Paraíso;De 2 a menos de 3 ha;4;9;0;4;0;9;3;1;0;0;3;1;0;0;0;0;;
Bela Vista do Paraíso;De 3 a menos de 4 ha;7;24;1;6;0;0;3;4;1;0;2;4;0;0;1;1;;
Bela Vista do Paraíso;De 4 a menos de 5 ha;5;24;0;5;0;24;2;3;0;0;2;3;0;0;1;2;;
Bela Vista do Paraíso;De 5 a menos de 10 ha;27;201;3;24;23;178;16;11;1;2;15;9;0;2;0;9;;
Bela Vista do Paraíso;De 10 a menos de 20 ha;58;869;10;48;171;698;46;12;10;0;36;12;0;0;0;5;;
Bela Vista do Paraíso;De 20 a menos de 50 ha;79;2410;18;61;566;1844;61;18;14;4;47;14;0;1;0;5;;
Bela Vista do Paraíso;De 50 a menos de 100 ha;23;1688;19;4;1461;227;19;4;16;3;3;1;0;1;0;0;;
Bela Vista do Paraíso;De 100 a menos de 200 ha;26;3532;26;0;3532;0;21;5;21;5;0;0;0;1;0;0;;
Bela Vista do Paraíso;De 200 a menos de 500 ha;12;3877;12;0;3877;0;12;0;12;0;0;0;0;0;0;0;;
Bela Vista do Paraíso;De 500 a menos de 1.000 ha;2;0;2;0;0;0;2;0;2;0;0;0;0;0;0;0;;
Bela Vista do Paraíso;De 1.000 a menos de 2.500 ha;2;0;2;0;0;0;2;0;2;0;0;0;0;0;0;0;;
Bela Vista do Paraíso;De 2.500 a menos de 10.000 ha;1;0;1;0;0;0;1;0;1;0;0;0;0;0;0;0;;
Bela Vista do Paraíso;De 10.000 ha e mais;0;0;0;0;0;0;0;0;0;0;0;0;0;0;0;0;;
Bela Vista do Paraíso;Produtor sem área;0;0;0;0;0;0;0;0;0;0;0;0;0;0;0;0;;
Bituruna;Mais de 0 a menos de 0,1 ha;0;0;0;0;0;0;0;0;0;0;0;0;0;0;0;0;;
Bituruna;De 0,1 a menos de 0,2 ha;3;1;2;1;0;0;0;3;0;2;0;1;0;2;0;1;;
Bituruna;De 0,2 a menos de 0,5 ha;7;2;1;6;0;0;0;7;0;1;0;6;0;1;0;4;;
Bituruna;De 0,5 a menos de 1 ha;28;19;10;18;7;12;4;24;0;10;4;14;0;8;1;8;;
Bituruna;De 1 a menos de 2 ha;44;56;25;19;31;25;9;35;4;21;5;14;1;20;0;11;;
Bituruna;De 2 a menos de 3 ha;42;101;22;20;53;48;7;35;4;18;3;17;0;17;1;12;;
Bituruna;De 3 a menos de 4 ha;34;118;10;24;36;82;16;18;4;6;12;12;0;5;0;9;;
Bituruna;De 4 a menos de 5 ha;42;198;14;28;67;131;18;24;5;9;13;15;0;7;0;12;;
Bituruna;De 5 a menos de 10 ha;148;1103;37;111;268;835;81;67;18;19;63;48;1;17;3;34;;
Bituruna;De 10 a menos de 20 ha;270;4170;46;224;706;3464;163;107;16;30;147;77;1;22;2;46;;
Bituruna;De 20 a menos de 50 ha;632;19468;81;551;2629;16839;417;215;45;36;372;179;2;24;9;105;;
Bituruna;De 50 a menos de 100 ha;191;12897;32;159;2422;10475;153;38;22;10;131;28;0;9;2;16;;
Bituruna;De 100 a menos de 200 ha;59;8342;56;3;0;0;37;22;35;21;2;1;0;18;0;1;;
Bituruna;De 200 a menos de 500 ha;40;11829;37;3;11096;733;19;21;17;20;2;1;0;19;0;1;;
Bituruna;De 500 a menos de 1.000 ha;9;6308;7;2;0;0;3;6;2;5;1;1;0;4;0;1;;
Bituruna;De 1.000 a menos de 2.500 ha;7;11722;7;0;11722;0;4;3;4;3;0;0;0;3;0;0;;
Bituruna;De 2.500 a menos de 10.000 ha;5;24095;5;0;24095;0;2;3;2;3;0;0;0;3;0;0;;
Bituruna;De 10.000 ha e mais;0;0;0;0;0;0;0;0;0;0;0;0;0;0;0;0;;
Bituruna;Produtor sem área;0;0;0;0;0;0;0;0;0;0;0;0;0;0;0;0;;
Boa Esperança;Mais de 0 a menos de 0,1 ha;2;0;0;2;0;0;1;1;0;0;1;1;0;0;0;0;;
Boa Esperança;De 0,1 a menos de 0,2 ha;1;0;0;1;0;0;0;1;0;0;0;1;0;0;0;1;;
Boa Esperança;De 0,2 a menos de 0,5 ha;2;0;0;2;0;0;2;0;0;0;2;0;0;0;0;0;;
Boa Esperança;De 0,5 a menos de 1 ha;40;22;10;30;6;16;17;23;5;5;12;18;2;2;8;7;;
Boa Esperança;De 1 a menos de 2 ha;15;20;4;11;5;14;7;8;3;1;4;7;0;0;0;3;;
Boa Esperança;De 2 a menos de 3 ha;9;22;1;8;0;0;3;6;0;1;3;5;0;1;1;1;;
Boa Esperança;De 3 a menos de 4 ha;11;40;2;9;0;0;8;3;2;0;6;3;0;0;0;1;;
Boa Esperança;De 4 a menos de 5 ha;17;81;4;13;18;63;11;6;2;2;9;4;2;0;0;3;;
Boa Esperança;De 5 a menos de 10 ha;33;260;1;32;0;0;27;6;0;1;27;5;0;0;1;1;;
Boa Esperança;De 10 a menos de 20 ha;46;695;2;44;0;0;44;2;2;0;42;2;0;0;0;1;;
Boa Esperança;De 20 a menos de 50 ha;93;2962;6;87;0;0;90;3;6;0;84;3;0;0;2;0;;
Boa Esperança;De 50 a menos de 100 ha;47;3324;16;31;1335;1989;47;0;16;0;31;0;0;0;0;0;;
Boa Esperança;De 100 a menos de 200 ha;33;4425;33;0;4425;0;31;2;31;2;0;0;0;2;0;0;;
Boa Esperança;De 200 a menos de 500 ha;18;5677;18;0;5677;0;18;0;18;0;0;0;0;0;0;0;;
Boa Esperança;De 500 a menos de 1.000 ha;6;4349;6;0;4349;0;6;0;6;0;0;0;0;0;0;0;;
Boa Esperança;De 1.000 a menos de 2.500 ha;5;6892;5;0;6892;0;5;0;5;0;0;0;0;0;0;0;;
Boa Esperança;De 2.500 a menos de 10.000 ha;0;0;0;0;0;0;0;0;0;0;0;0;0;0;0;0;;
Boa Esperança;De 10.000 ha e mais;0;0;0;0;0;0;0;0;0;0;0;0;0;0;0;0;;
Boa Esperança;Produtor sem área;0;0;0;0;0;0;0;0;0;0;0;0;0;0;0;0;;
Boa Esperança do Iguaçu;Mais de 0 a menos de 0,1 ha;5;0;5;0;0;0;0;5;0;5;0;0;0;4;0;0;;
Boa Esperança do Iguaçu;De 0,1 a menos de 0,2 ha;9;1;4;5;1;1;2;7;0;4;2;3;0;2;2;1;;
Boa Esperança do Iguaçu;De 0,2 a menos de 0,5 ha;5;1;2;3;0;0;2;3;1;1;1;2;0;1;2;0;;
Boa Esperança do Iguaçu;De 0,5 a menos de 1 ha;12;8;3;9;2;6;6;6;2;1;4;5;0;1;0;4;;
Boa Esperança do Iguaçu;De 1 a menos de 2 ha;7;10;1;6;0;0;6;1;1;0;5;1;0;0;0;0;;
Boa Esperança do Iguaçu;De 2 a menos de 3 ha;13;33;5;8;13;20;9;4;4;1;5;3;0;1;1;1;;
Boa Esperança do Iguaçu;De 3 a menos de 4 ha;11;37;3;8;9;28;5;6;2;1;3;5;0;1;2;2;;
Boa Esperança do Iguaçu;De 4 a menos de 5 ha;23;109;2;21;0;0;14;9;1;1;13;8;0;1;0;1;;
Boa Esperança do Iguaçu;De 5 a menos de 10 ha;74;550;6;68;40;509;63;11;6;0;57;11;0;0;4;6;;
Boa Esperança do Iguaçu;De 10 a menos de 20 ha;116;1689;8;108;113;1576;102;14;5;3;97;11;0;2;4;3;;
Boa Esperança do Iguaçu;De 20 a menos de 50 ha;97;2972;1;96;0;0;89;8;1;0;88;8;0;0;0;5;;
Boa Esperança do Iguaçu;De 50 a menos de 100 ha;36;2463;9;27;756;1706;33;3;9;0;24;3;0;0;0;3;;
Boa Esperança do Iguaçu;De 100 a menos de 200 ha;13;1755;13;0;1755;0;12;1;12;1;0;0;0;1;0;0;;
Boa Esperança do Iguaçu;De 200 a menos de 500 ha;7;1936;7;0;1936;0;6;1;6;1;0;0;0;1;0;0;;
Boa Esperança do Iguaçu;De 500 a menos de 1.000 ha;3;1600;3;0;1600;0;2;1;2;1;0;0;0;0;0;0;;
Boa Esperança do Iguaçu;De 1.000 a menos de 2.500 ha;0;0;0;0;0;0;0;0;0;0;0;0;0;0;0;0;;
Boa Esperança do Iguaçu;De 2.500 a menos de 10.000 ha;0;0;0;0;0;0;0;0;0;0;0;0;0;0;0;0;;
Boa Esperança do Iguaçu;De 10.000 ha e mais;0;0;0;0;0;0;0;0;0;0;0;0;0;0;0;0;;
Boa Esperança do Iguaçu;Produtor sem área;0;0;0;0;0;0;0;0;0;0;0;0;0;0;0;0;;
Boa Ventura de São Roque;Mais de 0 a menos de 0,1 ha;29;2;21;8;0;0;3;26;1;20;2;6;0;20;0;6;;
Boa Ventura de São Roque;De 0,1 a menos de 0,2 ha;22;3;7;15;1;2;1;21;0;7;1;14;0;7;0;14;;
Boa Ventura de São Roque;De 0,2 a menos de 0,5 ha;46;18;22;24;9;10;17;29;8;14;9;15;0;12;0;15;;
Boa Ventura de São Roque;De 0,5 a menos de 1 ha;76;48;29;47;18;29;36;40;11;18;25;22;2;14;1;19;;
Boa Ventura de São Roque;De 1 a menos de 2 ha;51;72;16;35;23;49;22;29;7;9;15;20;0;7;0;18;;
Boa Ventura de São Roque;De 2 a menos de 3 ha;76;188;36;40;88;100;27;49;11;25;16;24;0;24;0;21;;
Boa Ventura de São Roque;De 3 a menos de 4 ha;55;196;19;36;68;128;26;29;7;12;19;17;0;12;2;13;;
Boa Ventura de São Roque;De 4 a menos de 5 ha;73;348;22;51;105;242;40;33;9;13;31;20;0;11;0;16;;
Boa Ventura de São Roque;De 5 a menos de 10 ha;184;1430;31;153;242;1189;121;63;11;20;110;43;0;19;0;36;;
Boa Ventura de São Roque;De 10 a menos de 20 ha;336;5012;39;297;568;4444;274;62;14;25;260;37;0;23;1;30;;
Boa Ventura de São Roque;De 20 a menos de 50 ha;183;5427;14;169;407;5020;146;37;3;11;143;26;0;10;0;24;;
Boa Ventura de São Roque;De 50 a menos de 100 ha;77;5369;20;57;1690;3679;67;10;13;7;54;3;0;6;0;1;;
Boa Ventura de São Roque;De 100 a menos de 200 ha;41;5555;40;1;0;0;38;3;37;3;1;0;0;3;0;0;;
Boa Ventura de São Roque;De 200 a menos de 500 ha;21;6937;21;0;6937;0;20;1;20;1;0;0;0;1;0;0;;
Boa Ventura de São Roque;De 500 a menos de 1.000 ha;14;9678;14;0;9678;0;12;2;12;2;0;0;0;2;0;0;;
Boa Ventura de São Roque;De 1.000 a menos de 2.500 ha;8;12238;8;0;12238;0;7;1;7;1;0;0;0;1;0;0;;
Boa Ventura de São Roque;De 2.500 a menos de 10.000 ha;0;0;0;0;0;0;0;0;0;0;0;0;0;0;0;0;;
Boa Ventura de São Roque;De 10.000 ha e mais;0;0;0;0;0;0;0;0;0;0;0;0;0;0;0;0;;
Boa Ventura de São Roque;Produtor sem área;0;0;0;0;0;0;0;0;0;0;0;0;0;0;0;0;;
Boa Vista da Aparecida;Mais de 0 a menos de 0,1 ha;1;0;0;1;0;0;0;1;0;0;0;1;0;0;0;0;;
Boa Vista da Aparecida;De 0,1 a menos de 0,2 ha;0;0;0;0;0;0;0;0;0;0;0;0;0;0;0;0;;
Boa Vista da Aparecida;De 0,2 a menos de 0,5 ha;4;1;1;3;0;0;1;3;0;1;1;2;0;1;0;2;;
Boa Vista da Aparecida;De 0,5 a menos de 1 ha;16;11;2;14;0;0;2;14;1;1;1;13;0;1;1;10;;
Boa Vista da Aparecida;De 1 a menos de 2 ha;25;35;3;22;5;30;9;16;0;3;9;13;0;3;1;10;;
Boa Vista da Aparecida;De 2 a menos de 3 ha;30;73;1;29;0;0;15;15;0;1;15;14;0;1;1;10;;
Boa Vista da Aparecida;De 3 a menos de 4 ha;51;177;1;50;0;0;29;22;0;1;29;21;0;0;0;15;;
Boa Vista da Aparecida;De 4 a menos de 5 ha;73;348;5;68;24;324;48;25;4;1;44;24;0;1;0;20;;
Boa Vista da Aparecida;De 5 a menos de 10 ha;217;1685;10;207;77;1608;162;55;5;5;157;50;0;3;0;45;;
Boa Vista da Aparecida;De 10 a menos de 20 ha;203;2862;5;198;68;2794;158;45;4;1;154;44;0;1;0;36;;
Boa Vista da Aparecida;De 20 a menos de 50 ha;154;4763;8;146;263;4499;133;21;5;3;128;18;0;1;0;15;;
Boa Vista da Aparecida;De 50 a menos de 100 ha;47;3200;11;36;880;2319;40;7;9;2;31;5;0;1;0;3;;
Boa Vista da Aparecida;De 100 a menos de 200 ha;18;2490;18;0;2490;0;16;2;16;2;0;0;0;1;0;0;;
Boa Vista da Aparecida;De 200 a menos de 500 ha;14;3888;14;0;3888;0;13;1;13;1;0;0;0;1;0;0;;
Boa Vista da Aparecida;De 500 a menos de 1.000 ha;4;0;4;0;0;0;4;0;4;0;0;0;0;0;0;0;;
Boa Vista da Aparecida;De 1.000 a menos de 2.500 ha;0;0;0;0;0;0;0;0;0;0;0;0;0;0;0;0;;
Boa Vista da Aparecida;De 2.500 a menos de 10.000 ha;0;0;0;0;0;0;0;0;0;0;0;0;0;0;0;0;;
Boa Vista da Aparecida;De 10.000 ha e mais;0;0;0;0;0;0;0;0;0;0;0;0;0;0;0;0;;
Boa Vista da Aparecida;Produtor sem área;0;0;0;0;0;0;0;0;0;0;0;0;0;0;0;0;;
Bocaiúva do Sul;Mais de 0 a menos de 0,1 ha;1;0;0;1;0;0;0;1;0;0;0;1;0;0;0;1;;
Bocaiúva do Sul;De 0,1 a menos de 0,2 ha;0;0;0;0;0;0;0;0;0;0;0;0;0;0;0;0;;
Bocaiúva do Sul;De 0,2 a menos de 0,5 ha;6;2;1;5;0;0;0;6;0;1;0;5;0;1;1;2;;
Bocaiúva do Sul;De 0,5 a menos de 1 ha;8;5;3;5;0;0;0;8;0;3;0;5;0;2;0;4;;
Bocaiúva do Sul;De 1 a menos de 2 ha;16;23;7;9;10;13;2;14;0;7;2;7;0;5;0;7;;
Bocaiúva do Sul;De 2 a menos de 3 ha;27;65;9;18;22;43;3;24;0;9;3;15;0;7;1;11;;
Bocaiúva do Sul;De 3 a menos de 4 ha;14;49;3;11;0;0;1;13;1;2;0;11;0;2;1;8;;
Bocaiúva do Sul;De 4 a menos de 5 ha;25;116;11;14;53;63;5;20;0;11;5;9;1;9;0;7;;
Bocaiúva do Sul;De 5 a menos de 10 ha;63;486;19;44;153;333;13;50;1;18;12;32;2;10;0;26;;
Bocaiúva do Sul;De 10 a menos de 20 ha;60;845;17;43;245;600;7;53;1;16;6;37;0;13;2;29;;
Bocaiúva do Sul;De 20 a menos de 50 ha;75;2380;22;53;664;1715;23;52;2;20;21;32;0;18;1;22;;
Bocaiúva do Sul;De 50 a menos de 100 ha;23;1507;14;9;943;564;4;19;4;10;0;9;1;9;1;6;;
Bocaiúva do Sul;De 100 a menos de 200 ha;25;3562;25;0;3562;0;4;21;4;21;0;0;0;19;0;0;;
Bocaiúva do Sul;De 200 a menos de 500 ha;18;5502;18;0;5502;0;3;15;3;15;0;0;0;14;0;0;;
Bocaiúva do Sul;De 500 a menos de 1.000 ha;7;4370;7;0;4370;0;1;6;1;6;0;0;0;6;0;0;;
Bocaiúva do Sul;De 1.000 a menos de 2.500 ha;4;0;4;0;0;0;0;4;0;4;0;0;0;3;0;0;;
Bocaiúva do Sul;De 2.500 a menos de 10.000 ha;1;0;1;0;0;0;0;1;0;1;0;0;0;1;0;0;;
Bocaiúva do Sul;De 10.000 ha e mais;0;0;0;0;0;0;0;0;0;0;0;0;0;0;0;0;;
Bocaiúva do Sul;Produtor sem área;5;0;1;4;0;0;0;0;0;0;0;0;0;0;0;0;;
Bom Jesus do Sul;Mais de 0 a menos de 0,1 ha;28;2;12;16;1;1;0;28;0;12;0;16;0;12;0;15;;
Bom Jesus do Sul;De 0,1 a menos de 0,2 ha;11;2;3;8;0;0;0;11;0;3;0;8;0;3;0;8;;
Bom Jesus do Sul;De 0,2 a menos de 0,5 ha;25;7;15;10;5;3;2;23;1;14;1;9;0;13;0;8;;
Bom Jesus do Sul;De 0,5 a menos de 1 ha;35;22;14;21;9;13;5;30;2;12;3;18;0;9;0;16;;
Bom Jesus do Sul;De 1 a menos de 2 ha;41;54;13;28;17;37;13;28;4;9;9;19;0;8;0;17;;
Bom Jesus do Sul;De 2 a menos de 3 ha;42;96;13;29;30;66;13;29;4;9;9;20;0;6;0;14;;
Bom Jesus do Sul;De 3 a menos de 4 ha;50;171;7;43;24;147;21;29;2;5;19;24;0;3;0;14;;
Bom Jesus do Sul;De 4 a menos de 5 ha;61;279;11;50;50;229;36;25;4;7;32;18;0;6;0;14;;
Bom Jesus do Sul;De 5 a menos de 10 ha;199;1455;33;166;239;1215;94;105;12;21;82;84;0;14;0;53;;
Bom Jesus do Sul;De 10 a menos de 20 ha;166;2295;18;148;262;2032;81;85;6;12;75;73;0;11;0;35;;
Bom Jesus do Sul;De 20 a menos de 50 ha;111;3308;12;99;366;2942;69;42;5;7;64;35;0;4;0;16;;
Bom Jesus do Sul;De 50 a menos de 100 ha;39;2827;16;23;1325;1503;23;16;9;7;14;9;0;4;0;8;;
Bom Jesus do Sul;De 100 a menos de 200 ha;14;1902;14;0;1902;0;11;3;11;3;0;0;0;3;0;0;;
Bom Jesus do Sul;De 200 a menos de 500 ha;6;1926;6;0;1926;0;5;1;5;1;0;0;0;1;0;0;;
Bom Jesus do Sul;De 500 a menos de 1.000 ha;2;0;2;0;0;0;1;1;1;1;0;0;0;1;0;0;;
Bom Jesus do Sul;De 1.000 a menos de 2.500 ha;1;0;1;0;0;0;1;0;1;0;0;0;0;0;0;0;;
Bom Jesus do Sul;De 2.500 a menos de 10.000 ha;0;0;0;0;0;0;0;0;0;0;0;0;0;0;0;0;;
Bom Jesus do Sul;De 10.000 ha e mais;0;0;0;0;0;0;0;0;0;0;0;0;0;0;0;0;;
Bom Jesus do Sul;Produtor sem área;1;0;0;1;0;0;0;1;0;0;0;1;0;0;0;1;;
Bom Sucesso;Mais de 0 a menos de 0,1 ha;36;1;29;7;1;0;2;34;2;27;0;7;1;25;1;6;;
Bom Sucesso;De 0,1 a menos de 0,2 ha;16;2;9;7;1;1;3;13;2;7;1;6;0;7;0;3;;
Bom Sucesso;De 0,2 a menos de 0,5 ha;23;7;12;11;3;3;7;16;2;10;5;6;0;8;0;4;;
Bom Sucesso;De 0,5 a menos de 1 ha;35;19;23;12;12;7;9;26;7;16;2;10;0;13;0;6;;
Bom Sucesso;De 1 a menos de 2 ha;15;18;8;7;10;8;4;11;2;6;2;5;0;5;0;2;;
Bom Sucesso;De 2 a menos de 3 ha;12;29;3;9;0;0;3;9;1;2;2;7;0;2;0;5;;
Bom Sucesso;De 3 a menos de 4 ha;21;76;9;12;33;43;14;7;4;5;10;2;0;3;0;2;;
Bom Sucesso;De 4 a menos de 5 ha;21;96;13;8;60;37;8;13;6;7;2;6;0;4;0;3;;
Bom Sucesso;De 5 a menos de 10 ha;23;175;15;8;105;69;14;9;8;7;6;2;0;5;0;2;;
Bom Sucesso;De 10 a menos de 20 ha;33;460;9;24;121;339;23;10;5;4;18;6;0;3;0;4;;
Bom Sucesso;De 20 a menos de 50 ha;52;1818;13;39;455;1363;38;14;10;3;28;11;0;3;0;8;;
Bom Sucesso;De 50 a menos de 100 ha;27;2086;22;5;0;0;22;5;17;5;5;0;0;5;0;0;;
Bom Sucesso;De 100 a menos de 200 ha;24;3377;24;0;3377;0;16;8;16;8;0;0;0;5;0;0;;
Bom Sucesso;De 200 a menos de 500 ha;11;3299;11;0;3299;0;9;2;9;2;0;0;0;2;0;0;;
Bom Sucesso;De 500 a menos de 1.000 ha;9;5570;9;0;5570;0;9;0;9;0;0;0;0;0;0;0;;
Bom Sucesso;De 1.000 a menos de 2.500 ha;4;0;4;0;0;0;4;0;4;0;0;0;0;0;0;0;;
Bom Sucesso;De 2.500 a menos de 10.000 ha;1;0;1;0;0;0;1;0;1;0;0;0;0;0;0;0;;
Bom Sucesso;De 10.000 ha e mais;0;0;0;0;0;0;0;0;0;0;0;0;0;0;0;0;;
Bom Sucesso;Produtor sem área;0;0;0;0;0;0;0;0;0;0;0;0;0;0;0;0;;
Bom Sucesso do Sul;Mais de 0 a menos de 0,1 ha;2;0;2;0;0;0;0;2;0;2;0;0;0;0;0;0;;
Bom Sucesso do Sul;De 0,1 a menos de 0,2 ha;2;0;1;1;0;0;1;1;1;0;0;1;0;0;0;0;;
Bom Sucesso do Sul;De 0,2 a menos de 0,5 ha;5;1;2;3;0;0;5;0;2;0;3;0;0;0;0;0;;
Bom Sucesso do Sul;De 0,5 a menos de 1 ha;3;0;0;3;0;0;2;1;0;0;2;1;0;0;0;1;;
Bom Sucesso do Sul;De 1 a menos de 2 ha;11;14;1;10;0;0;6;5;0;1;6;4;1;0;2;0;;
Bom Sucesso do Sul;De 2 a menos de 3 ha;11;27;5;6;12;15;5;6;2;3;3;3;1;1;0;1;;
Bom Sucesso do Sul;De 3 a menos de 4 ha;20;70;7;13;25;45;15;5;5;2;10;3;1;0;1;0;;
Bom Sucesso do Sul;De 4 a menos de 5 ha;16;76;4;12;19;57;11;5;3;1;8;4;0;0;0;1;;
Bom Sucesso do Sul;De 5 a menos de 10 ha;42;343;4;38;34;309;36;6;2;2;34;4;1;0;1;3;;
Bom Sucesso do Sul;De 10 a menos de 20 ha;75;1124;2;73;0;0;73;2;2;0;71;2;0;0;0;0;;
Bom Sucesso do Sul;De 20 a menos de 50 ha;78;2469;2;76;0;0;77;1;2;0;75;1;0;0;0;0;;
Bom Sucesso do Sul;De 50 a menos de 100 ha;29;1921;12;17;953;968;29;0;12;0;17;0;0;0;0;0;;
Bom Sucesso do Sul;De 100 a menos de 200 ha;20;2874;20;0;2874;0;20;0;20;0;0;0;0;0;0;0;;
Bom Sucesso do Sul;De 200 a menos de 500 ha;17;5974;17;0;5974;0;17;0;17;0;0;0;0;0;0;0;;
Bom Sucesso do Sul;De 500 a menos de 1.000 ha;2;0;2;0;0;0;2;0;2;0;0;0;0;0;0;0;;
Bom Sucesso do Sul;De 1.000 a menos de 2.500 ha;0;0;0;0;0;0;0;0;0;0;0;0;0;0;0;0;;
Bom Sucesso do Sul;De 2.500 a menos de 10.000 ha;0;0;0;0;0;0;0;0;0;0;0;0;0;0;0;0;;
Bom Sucesso do Sul;De 10.000 ha e mais;0;0;0;0;0;0;0;0;0;0;0;0;0;0;0;0;;
Bom Sucesso do Sul;Produtor sem área;0;0;0;0;0;0;0;0;0;0;0;0;0;0;0;0;;
Borrazópolis;Mais de 0 a menos de 0,1 ha;11;0;3;8;0;0;5;6;1;2;4;4;1;1;1;3;;
Borrazópolis;De 0,1 a menos de 0,2 ha;6;1;3;3;0;0;1;5;0;3;1;2;1;1;0;2;;
Borrazópolis;De 0,2 a menos de 0,5 ha;7;2;1;6;0;0;5;2;1;0;4;2;0;0;0;2;;
Borrazópolis;De 0,5 a menos de 1 ha;14;9;3;11;2;7;4;10;0;3;4;7;0;3;0;6;;
Borrazópolis;De 1 a menos de 2 ha;43;56;12;31;15;42;22;21;5;7;17;14;1;6;1;12;;
Borrazópolis;De 2 a menos de 3 ha;37;89;10;27;24;65;22;15;7;3;15;12;1;2;1;9;;
Borrazópolis;De 3 a menos de 4 ha;37;126;13;24;45;81;20;17;5;8;15;9;0;8;0;9;;
Borrazópolis;De 4 a menos de 5 ha;45;214;9;36;42;172;26;19;2;7;24;12;1;5;1;10;;
Borrazópolis;De 5 a menos de 10 ha;99;743;19;80;131;611;76;23;12;7;64;16;0;6;0;14;;
Borrazópolis;De 10 a menos de 20 ha;123;1750;11;112;161;1589;104;19;6;5;98;14;0;4;0;12;;
Borrazópolis;De 20 a menos de 50 ha;125;4059;9;116;264;3795;115;10;6;3;109;7;1;0;1;5;;
Borrazópolis;De 50 a menos de 100 ha;56;3896;28;28;2213;1683;53;3;26;2;27;1;0;1;0;1;;
Borrazópolis;De 100 a menos de 200 ha;36;5117;36;0;5117;0;33;3;33;3;0;0;0;3;0;0;;
Borrazópolis;De 200 a menos de 500 ha;24;7230;24;0;7230;0;19;5;19;5;0;0;1;1;0;0;;
Borrazópolis;De 500 a menos de 1.000 ha;5;0;5;0;0;0;3;2;3;2;0;0;1;1;0;0;;
Borrazópolis;De 1.000 a menos de 2.500 ha;2;0;2;0;0;0;2;0;2;0;0;0;0;0;0;0;;
Borrazópolis;De 2.500 a menos de 10.000 ha;0;0;0;0;0;0;0;0;0;0;0;0;0;0;0;0;;
Borrazópolis;De 10.000 ha e mais;0;0;0;0;0;0;0;0;0;0;0;0;0;0;0;0;;
Borrazópolis;Produtor sem área;0;0;0;0;0;0;0;0;0;0;0;0;0;0;0;0;;
Braganey;Mais de 0 a menos de 0,1 ha;2;0;0;2;0;0;2;0;0;0;2;0;0;0;0;0;;
Braganey;De 0,1 a menos de 0,2 ha;0;0;0;0;0;0;0;0;0;0;0;0;0;0;0;0;;
Braganey;De 0,2 a menos de 0,5 ha;6;2;2;4;0;0;3;3;2;0;1;3;0;0;0;3;;
Braganey;De 0,5 a menos de 1 ha;29;16;3;26;0;0;15;14;0;3;15;11;0;2;0;9;;
Braganey;De 1 a menos de 2 ha;29;37;4;25;5;33;18;11;3;1;15;10;0;1;2;3;;
Braganey;De 2 a menos de 3 ha;33;81;7;26;18;63;23;10;4;3;19;7;0;3;0;5;;
Braganey;De 3 a menos de 4 ha;20;70;3;17;10;60;12;8;2;1;10;7;0;1;0;5;;
Braganey;De 4 a menos de 5 ha;24;114;5;19;24;90;15;9;3;2;12;7;0;2;0;6;;
Braganey;De 5 a menos de 10 ha;69;519;7;62;54;465;44;25;1;6;43;19;1;5;1;12;;
Braganey;De 10 a menos de 20 ha;72;1084;5;67;77;1006;56;16;2;3;54;13;0;3;0;6;;
Braganey;De 20 a menos de 50 ha;105;3455;9;96;304;3151;93;12;6;3;87;9;0;2;0;7;;
Braganey;De 50 a menos de 100 ha;54;3964;30;24;2530;1434;49;5;26;4;23;1;0;4;0;1;;
Braganey;De 100 a menos de 200 ha;24;3319;24;0;3319;0;21;3;21;3;0;0;0;2;0;0;;
Braganey;De 200 a menos de 500 ha;31;9185;31;0;9185;0;27;4;27;4;0;0;0;3;0;0;;
Braganey;De 500 a menos de 1.000 ha;9;5970;9;0;5970;0;7;2;7;2;0;0;0;1;0;0;;
Braganey;De 1.000 a menos de 2.500 ha;2;0;2;0;0;0;2;0;2;0;0;0;0;0;0;0;;
Braganey;De 2.500 a menos de 10.000 ha;0;0;0;0;0;0;0;0;0;0;0;0;0;0;0;0;;
Braganey;De 10.000 ha e mais;0;0;0;0;0;0;0;0;0;0;0;0;0;0;0;0;;
Braganey;Produtor sem área;2;0;1;1;0;0;1;1;1;0;0;1;0;0;0;1;;
Brasilândia do Sul;Mais de 0 a menos de 0,1 ha;1;0;0;1;0;0;0;1;0;0;0;1;0;0;0;1;;
Brasilândia do Sul;De 0,1 a menos de 0,2 ha;0;0;0;0;0;0;0;0;0;0;0;0;0;0;0;0;;
Brasilândia do Sul;De 0,2 a menos de 0,5 ha;0;0;0;0;0;0;0;0;0;0;0;0;0;0;0;0;;
Brasilândia do Sul;De 0,5 a menos de 1 ha;15;8;0;15;0;8;2;13;0;0;2;13;0;0;1;1;;
Brasilândia do Sul;De 1 a menos de 2 ha;2;0;0;2;0;0;0;2;0;0;0;2;0;0;0;1;;
Brasilândia do Sul;De 2 a menos de 3 ha;10;25;0;10;0;25;2;8;0;0;2;8;0;0;3;4;;
Brasilândia do Sul;De 3 a menos de 4 ha;4;15;0;4;0;15;0;4;0;0;0;4;0;0;0;3;;
Brasilândia do Sul;De 4 a menos de 5 ha;6;28;0;6;0;28;3;3;0;0;3;3;0;0;0;2;;
Brasilândia do Sul;De 5 a menos de 10 ha;20;145;1;19;0;0;15;5;1;0;14;5;0;0;2;2;;
Brasilândia do Sul;De 10 a menos de 20 ha;23;341;3;20;51;291;18;5;1;2;17;3;1;0;0;2;;
Brasilândia do Sul;De 20 a menos de 50 ha;35;1118;2;33;0;0;30;5;1;1;29;4;0;1;0;4;;
Brasilândia do Sul;De 50 a menos de 100 ha;33;2328;17;16;1271;1058;31;2;16;1;15;1;0;0;0;1;;
Brasilândia do Sul;De 100 a menos de 200 ha;15;1970;15;0;1970;0;13;2;13;2;0;0;0;0;0;0;;
Brasilândia do Sul;De 200 a menos de 500 ha;28;8710;28;0;8710;0;27;1;27;1;0;0;0;1;0;0;;
Brasilândia do Sul;De 500 a menos de 1.000 ha;9;6682;9;0;6682;0;9;0;9;0;0;0;0;0;0;0;;
Brasilândia do Sul;De 1.000 a menos de 2.500 ha;2;0;2;0;0;0;2;0;2;0;0;0;0;0;0;0;;
Brasilândia do Sul;De 2.500 a menos de 10.000 ha;0;0;0;0;0;0;0;0;0;0;0;0;0;0;0;0;;
Brasilândia do Sul;De 10.000 ha e mais;0;0;0;0;0;0;0;0;0;0;0;0;0;0;0;0;;
Brasilândia do Sul;Produtor sem área;0;0;0;0;0;0;0;0;0;0;0;0;0;0;0;0;;
Cafeara;Mais de 0 a menos de 0,1 ha;0;0;0;0;0;0;0;0;0;0;0;0;0;0;0;0;;
Cafeara;De 0,1 a menos de 0,2 ha;0;0;0;0;0;0;0;0;0;0;0;0;0;0;0;0;;
Cafeara;De 0,2 a menos de 0,5 ha;3;1;2;1;0;0;0;3;0;2;0;1;0;2;0;1;;
Cafeara;De 0,5 a menos de 1 ha;15;8;10;5;5;3;1;14;1;9;0;5;1;5;0;4;;
Cafeara;De 1 a menos de 2 ha;3;3;3;0;3;0;1;2;1;2;0;0;0;1;0;0;;
Cafeara;De 2 a menos de 3 ha;1;0;0;1;0;0;0;1;0;0;0;1;0;0;0;0;;
Cafeara;De 3 a menos de 4 ha;4;13;1;3;0;0;3;1;1;0;2;1;0;0;0;1;;
Cafeara;De 4 a menos de 5 ha;4;19;0;4;0;19;2;2;0;0;2;2;0;0;0;1;;
Cafeara;De 5 a menos de 10 ha;11;83;3;8;23;60;5;6;2;1;3;5;0;1;0;3;;
Cafeara;De 10 a menos de 20 ha;47;742;5;42;74;668;31;16;0;5;31;11;0;3;0;8;;
Cafeara;De 20 a menos de 50 ha;35;1167;7;28;243;924;22;13;6;1;16;12;1;0;0;9;;
Cafeara;De 50 a menos de 100 ha;11;764;4;7;346;418;6;5;1;3;5;2;0;2;0;1;;
Cafeara;De 100 a menos de 200 ha;10;1293;10;0;1293;0;8;2;8;2;0;0;0;0;0;0;;
Cafeara;De 200 a menos de 500 ha;10;3488;10;0;3488;0;8;2;8;2;0;0;0;1;0;0;;
Cafeara;De 500 a menos de 1.000 ha;1;0;1;0;0;0;1;0;1;0;0;0;0;0;0;0;;
Cafeara;De 1.000 a menos de 2.500 ha;2;0;2;0;0;0;2;0;2;0;0;0;0;0;0;0;;
Cafeara;De 2.500 a menos de 10.000 ha;1;0;1;0;0;0;1;0;1;0;0;0;0;0;0;0;;
Cafeara;De 10.000 ha e mais;0;0;0;0;0;0;0;0;0;0;0;0;0;0;0;0;;
Cafeara;Produtor sem área;0;0;0;0;0;0;0;0;0;0;0;0;0;0;0;0;;
Cafelândia;Mais de 0 a menos de 0,1 ha;3;0;0;3;0;0;0;3;0;0;0;3;0;0;0;3;;
Cafelândia;De 0,1 a menos de 0,2 ha;0;0;0;0;0;0;0;0;0;0;0;0;0;0;0;0;;
Cafelândia;De 0,2 a menos de 0,5 ha;2;0;1;1;0;0;2;0;1;0;1;0;0;0;0;0;;
Cafelândia;De 0,5 a menos de 1 ha;10;6;1;9;0;0;2;8;0;1;2;7;0;1;3;3;;
Cafelândia;De 1 a menos de 2 ha;20;26;2;18;0;0;3;17;0;2;3;15;0;1;2;13;;
Cafelândia;De 2 a menos de 3 ha;31;76;6;25;15;62;8;23;0;6;8;17;0;6;1;15;;
Cafelândia;De 3 a menos de 4 ha;11;38;2;9;0;0;4;7;0;2;4;5;0;2;0;4;;
Cafelândia;De 4 a menos de 5 ha;32;151;5;27;23;128;15;17;2;3;13;14;0;0;0;13;;
Cafelândia;De 5 a menos de 10 ha;53;413;13;40;99;315;37;16;6;7;31;9;0;7;0;8;;
Cafelândia;De 10 a menos de 20 ha;81;1193;11;70;165;1028;69;12;7;4;62;8;0;3;0;7;;
Cafelândia;De 20 a menos de 50 ha;103;3224;9;94;313;2911;97;6;7;2;90;4;0;1;0;4;;
Cafelândia;De 50 a menos de 100 ha;43;3007;25;18;1938;1068;43;0;25;0;18;0;0;0;0;0;;
Cafelândia;De 100 a menos de 200 ha;23;3413;23;0;3413;0;23;0;23;0;0;0;0;0;0;0;;
Cafelândia;De 200 a menos de 500 ha;26;8540;26;0;8540;0;26;0;26;0;0;0;0;0;0;0;;
Cafelândia;De 500 a menos de 1.000 ha;6;4115;6;0;4115;0;6;0;6;0;0;0;0;0;0;0;;
Cafelândia;De 1.000 a menos de 2.500 ha;0;0;0;0;0;0;0;0;0;0;0;0;0;0;0;0;;
Cafelândia;De 2.500 a menos de 10.000 ha;0;0;0;0;0;0;0;0;0;0;0;0;0;0;0;0;;
Cafelândia;De 10.000 ha e mais;0;0;0;0;0;0;0;0;0;0;0;0;0;0;0;0;;
Cafelândia;Produtor sem área;0;0;0;0;0;0;0;0;0;0;0;0;0;0;0;0;;
Cafezal do Sul;Mais de 0 a menos de 0,1 ha;16;1;4;12;0;1;0;16;0;4;0;12;0;4;0;12;;
Cafezal do Sul;De 0,1 a menos de 0,2 ha;6;1;3;3;0;0;0;6;0;3;0;3;0;3;0;3;;
Cafezal do Sul;De 0,2 a menos de 0,5 ha;11;4;3;8;1;3;2;9;1;2;1;7;0;2;1;4;;
Cafezal do Sul;De 0,5 a menos de 1 ha;26;14;12;14;6;7;10;16;4;8;6;8;0;7;0;7;;
Cafezal do Sul;De 1 a menos de 2 ha;7;9;0;7;0;9;2;5;0;0;2;5;0;0;0;5;;
Cafezal do Sul;De 2 a menos de 3 ha;23;56;13;10;31;24;3;20;0;13;3;7;0;10;0;5;;
Cafezal do Sul;De 3 a menos de 4 ha;8;28;3;5;0;0;1;7;0;3;1;4;0;2;0;3;;
Cafezal do Sul;De 4 a menos de 5 ha;38;180;16;22;75;105;3;35;1;15;2;20;0;11;4;14;;
Cafezal do Sul;De 5 a menos de 10 ha;68;518;25;43;198;320;13;55;5;20;8;35;0;18;1;27;;
Cafezal do Sul;De 10 a menos de 20 ha;120;1689;42;78;600;1089;19;101;3;39;16;62;0;31;0;43;;
Cafezal do Sul;De 20 a menos de 50 ha;109;3376;26;83;763;2613;23;86;5;21;18;65;0;19;0;50;;
Cafezal do Sul;De 50 a menos de 100 ha;36;2598;18;18;1439;1159;12;24;5;13;7;11;0;10;1;7;;
Cafezal do Sul;De 100 a menos de 200 ha;24;3417;24;0;3417;0;8;16;8;16;0;0;0;11;0;0;;
Cafezal do Sul;De 200 a menos de 500 ha;31;9336;31;0;9336;0;21;10;21;10;0;0;0;6;0;0;;
Cafezal do Sul;De 500 a menos de 1.000 ha;9;6340;9;0;6340;0;4;5;4;5;0;0;1;3;0;0;;
Cafezal do Sul;De 1.000 a menos de 2.500 ha;1;0;1;0;0;0;0;1;0;1;0;0;0;1;0;0;;
Cafezal do Sul;De 2.500 a menos de 10.000 ha;0;0;0;0;0;0;0;0;0;0;0;0;0;0;0;0;;
Cafezal do Sul;De 10.000 ha e mais;0;0;0;0;0;0;0;0;0;0;0;0;0;0;0;0;;
Cafezal do Sul;Produtor sem área;5;0;2;3;0;0;0;4;0;1;0;3;0;1;0;3;;
Califórnia;Mais de 0 a menos de 0,1 ha;1;0;0;1;0;0;1;0;0;0;1;0;0;0;0;0;;
Califórnia;De 0,1 a menos de 0,2 ha;3;0;3;0;0;0;0;3;0;3;0;0;0;3;0;0;;
Califórnia;De 0,2 a menos de 0,5 ha;5;2;2;3;0;0;0;5;0;2;0;3;1;1;0;2;;
Califórnia;De 0,5 a menos de 1 ha;27;16;11;16;6;10;17;10;8;3;9;7;0;2;2;4;;
Califórnia;De 1 a menos de 2 ha;20;28;1;19;0;0;5;15;0;1;5;14;0;0;0;13;;
Califórnia;De 2 a menos de 3 ha;19;46;3;16;7;39;5;14;0;3;5;11;0;3;0;10;;
Califórnia;De 3 a menos de 4 ha;33;113;7;26;24;90;16;17;3;4;13;13;0;2;0;12;;
Califórnia;De 4 a menos de 5 ha;35;168;5;30;24;145;13;22;1;4;12;18;0;4;0;15;;
Califórnia;De 5 a menos de 10 ha;86;671;9;77;73;598;50;36;6;3;44;33;0;2;0;30;;
Califórnia;De 10 a menos de 20 ha;69;987;7;62;92;895;39;30;3;4;36;26;0;3;1;20;;
Califórnia;De 20 a menos de 50 ha;80;2526;8;72;218;2308;57;23;4;4;53;19;0;4;0;17;;
Califórnia;De 50 a menos de 100 ha;33;2225;20;13;1474;751;29;4;16;4;13;0;0;4;0;0;;
Califórnia;De 100 a menos de 200 ha;19;2744;19;0;2744;0;15;4;15;4;0;0;0;3;0;0;;
Califórnia;De 200 a menos de 500 ha;6;1474;6;0;1474;0;4;2;4;2;0;0;0;2;0;0;;
Califórnia;De 500 a menos de 1.000 ha;1;0;1;0;0;0;1;0;1;0;0;0;0;0;0;0;;
Califórnia;De 1.000 a menos de 2.500 ha;1;0;1;0;0;0;1;0;1;0;0;0;0;0;0;0;;
Califórnia;De 2.500 a menos de 10.000 ha;0;0;0;0;0;0;0;0;0;0;0;0;0;0;0;0;;
Califórnia;De 10.000 ha e mais;0;0;0;0;0;0;0;0;0;0;0;0;0;0;0;0;;
Califórnia;Produtor sem área;0;0;0;0;0;0;0;0;0;0;0;0;0;0;0;0;;
Cambará;Mais de 0 a menos de 0,1 ha;0;0;0;0;0;0;0;0;0;0;0;0;0;0;0;0;;
Cambará;De 0,1 a menos de 0,2 ha;0;0;0;0;0;0;0;0;0;0;0;0;0;0;0;0;;
Cambará;De 0,2 a menos de 0,5 ha;0;0;0;0;0;0;0;0;0;0;0;0;0;0;0;0;;
Cambará;De 0,5 a menos de 1 ha;3;2;1;2;0;0;1;2;0;1;1;1;0;1;0;1;;
Cambará;De 1 a menos de 2 ha;18;26;2;16;0;0;11;7;1;1;10;6;0;1;1;5;;
Cambará;De 2 a menos de 3 ha;9;22;3;6;7;15;7;2;1;2;6;0;0;2;0;0;;
Cambará;De 3 a menos de 4 ha;20;71;5;15;17;54;9;11;1;4;8;7;0;4;0;5;;
Cambará;De 4 a menos de 5 ha;16;76;3;13;15;61;10;6;1;2;9;4;0;2;1;3;;
Cambará;De 5 a menos de 10 ha;83;629;8;75;60;569;60;23;3;5;57;18;0;4;0;8;;
Cambará;De 10 a menos de 20 ha;65;953;5;60;74;878;55;10;3;2;52;8;0;2;0;3;;
Cambará;De 20 a menos de 50 ha;86;2647;7;79;179;2468;82;4;7;0;75;4;0;0;0;2;;
Cambará;De 50 a menos de 100 ha;42;2936;22;20;1758;1179;42;0;22;0;20;0;0;0;0;0;;
Cambará;De 100 a menos de 200 ha;28;3711;28;0;3711;0;27;1;27;1;0;0;0;1;0;0;;
Cambará;De 200 a menos de 500 ha;20;7111;20;0;7111;0;18;2;18;2;0;0;0;0;0;0;;
Cambará;De 500 a menos de 1.000 ha;4;2837;4;0;2837;0;4;0;4;0;0;0;0;0;0;0;;
Cambará;De 1.000 a menos de 2.500 ha;1;0;1;0;0;0;1;0;1;0;0;0;0;0;0;0;;
Cambará;De 2.500 a menos de 10.000 ha;2;0;2;0;0;0;2;0;2;0;0;0;0;0;0;0;;
Cambará;De 10.000 ha e mais;0;0;0;0;0;0;0;0;0;0;0;0;0;0;0;0;;
Cambará;Produtor sem área;1;0;0;1;0;0;0;0;0;0;0;0;0;0;0;0;;
Cambé;Mais de 0 a menos de 0,1 ha;17;0;2;15;0;0;0;17;0;2;0;15;1;1;10;4;;
Cambé;De 0,1 a menos de 0,2 ha;12;1;2;10;0;0;0;12;0;2;0;10;0;2;5;5;;
Cambé;De 0,2 a menos de 0,5 ha;26;7;2;24;0;0;0;26;0;2;0;24;0;2;8;13;;
Cambé;De 0,5 a menos de 1 ha;45;24;8;37;4;20;7;38;1;7;6;31;0;5;3;23;;
Cambé;De 1 a menos de 2 ha;14;16;0;14;0;16;3;11;0;0;3;11;0;0;0;8;;
Cambé;De 2 a menos de 3 ha;21;49;1;20;0;0;7;14;0;1;7;13;0;1;0;11;;
Cambé;De 3 a menos de 4 ha;23;79;3;20;10;69;11;12;0;3;11;9;0;2;0;5;;
Cambé;De 4 a menos de 5 ha;29;138;2;27;0;0;13;16;0;2;13;14;0;2;0;11;;
Cambé;De 5 a menos de 10 ha;63;476;9;54;69;407;45;18;8;1;37;17;0;0;1;9;;
Cambé;De 10 a menos de 20 ha;74;1033;10;64;136;897;54;20;8;2;46;18;0;0;1;7;;
Cambé;De 20 a menos de 50 ha;98;3360;26;72;1063;2297;86;12;21;5;65;7;0;3;0;4;;
Cambé;De 50 a menos de 100 ha;49;3514;49;0;3514;0;46;3;46;3;0;0;0;1;0;0;;
Cambé;De 100 a menos de 200 ha;45;6428;45;0;6428;0;42;3;42;3;0;0;0;1;0;0;;
Cambé;De 200 a menos de 500 ha;32;9527;32;0;9527;0;30;2;30;2;0;0;0;0;0;0;;
Cambé;De 500 a menos de 1.000 ha;10;6725;10;0;6725;0;10;0;10;0;0;0;0;0;0;0;;
Cambé;De 1.000 a menos de 2.500 ha;5;7376;5;0;7376;0;5;0;5;0;0;0;0;0;0;0;;
Cambé;De 2.500 a menos de 10.000 ha;0;0;0;0;0;0;0;0;0;0;0;0;0;0;0;0;;
Cambé;De 10.000 ha e mais;0;0;0;0;0;0;0;0;0;0;0;0;0;0;0;0;;
Cambé;Produtor sem área;0;0;0;0;0;0;0;0;0;0;0;0;0;0;0;0;;
Cambira;Mais de 0 a menos de 0,1 ha;0;0;0;0;0;0;0;0;0;0;0;0;0;0;0;0;;
Cambira;De 0,1 a menos de 0,2 ha;2;0;0;2;0;0;1;1;0;0;1;1;0;0;0;1;;
Cambira;De 0,2 a menos de 0,5 ha;10;3;2;8;0;0;3;7;1;1;2;6;0;1;0;6;;
Cambira;De 0,5 a menos de 1 ha;24;13;2;22;0;0;6;18;2;0;4;18;0;0;0;18;;
Cambira;De 1 a menos de 2 ha;4;5;1;3;0;0;2;2;1;0;1;2;0;0;0;2;;
Cambira;De 2 a menos de 3 ha;19;46;4;15;10;35;6;13;0;4;6;9;0;4;0;9;;
Cambira;De 3 a menos de 4 ha;19;67;3;16;10;57;11;8;1;2;10;6;0;1;0;5;;
Cambira;De 4 a menos de 5 ha;51;244;3;48;15;230;29;22;2;1;27;21;0;1;0;17;;
Cambira;De 5 a menos de 10 ha;87;693;7;80;52;641;58;29;4;3;54;26;0;2;0;23;;
Cambira;De 10 a menos de 20 ha;156;2230;25;131;365;1866;128;28;18;7;110;21;0;4;0;17;;
Cambira;De 20 a menos de 50 ha;136;4219;11;125;365;3854;127;9;10;1;117;8;0;1;0;5;;
Cambira;De 50 a menos de 100 ha;28;1827;18;10;1267;560;27;1;17;1;10;0;0;0;0;0;;
Cambira;De 100 a menos de 200 ha;9;1207;9;0;1207;0;6;3;6;3;0;0;0;3;0;0;;
Cambira;De 200 a menos de 500 ha;7;1947;7;0;1947;0;7;0;7;0;0;0;0;0;0;0;;
Cambira;De 500 a menos de 1.000 ha;2;0;2;0;0;0;2;0;2;0;0;0;0;0;0;0;;
Cambira;De 1.000 a menos de 2.500 ha;0;0;0;0;0;0;0;0;0;0;0;0;0;0;0;0;;
Cambira;De 2.500 a menos de 10.000 ha;0;0;0;0;0;0;0;0;0;0;0;0;0;0;0;0;;
Cambira;De 10.000 ha e mais;0;0;0;0;0;0;0;0;0;0;0;0;0;0;0;0;;
Cambira;Produtor sem área;0;0;0;0;0;0;0;0;0;0;0;0;0;0;0;0;;
Campina da Lagoa;Mais de 0 a menos de 0,1 ha;1;0;0;1;0;0;1;0;0;0;1;0;0;0;0;0;;
Campina da Lagoa;De 0,1 a menos de 0,2 ha;1;0;0;1;0;0;0;1;0;0;0;1;0;0;0;0;;
Campina da Lagoa;De 0,2 a menos de 0,5 ha;0;0;0;0;0;0;0;0;0;0;0;0;0;0;0;0;;
Campina da Lagoa;De 0,5 a menos de 1 ha;7;0;0;7;0;0;3;4;0;0;3;4;0;0;0;1;;
Campina da Lagoa;De 1 a menos de 2 ha;8;10;3;5;0;0;4;4;1;2;3;2;0;2;1;1;;
Campina da Lagoa;De 2 a menos de 3 ha;16;40;3;13;8;32;8;8;2;1;6;7;0;1;0;2;;
Campina da Lagoa;De 3 a menos de 4 ha;20;70;3;17;0;0;10;10;3;0;7;10;0;0;0;5;;
Campina da Lagoa;De 4 a menos de 5 ha;29;140;5;24;24;115;12;17;3;2;9;15;0;2;0;6;;
Campina da Lagoa;De 5 a menos de 10 ha;123;962;17;106;138;825;72;51;8;9;64;42;0;6;1;27;;
Campina da Lagoa;De 10 a menos de 20 ha;133;1917;12;121;145;1772;78;55;1;11;77;44;0;9;1;31;;
Campina da Lagoa;De 20 a menos de 50 ha;160;5171;19;141;676;4495;118;42;9;10;109;32;0;9;0;24;;
Campina da Lagoa;De 50 a menos de 100 ha;84;6088;26;58;2274;3814;63;21;19;7;44;14;0;3;1;9;;
Campina da Lagoa;De 100 a menos de 200 ha;64;9377;64;0;9377;0;53;11;53;11;0;0;0;7;0;0;;
Campina da Lagoa;De 200 a menos de 500 ha;56;17961;56;0;17961;0;50;6;50;6;0;0;0;5;0;0;;
Campina da Lagoa;De 500 a menos de 1.000 ha;17;11647;17;0;11647;0;16;1;16;1;0;0;0;0;0;0;;
Campina da Lagoa;De 1.000 a menos de 2.500 ha;10;14878;10;0;14878;0;10;0;10;0;0;0;0;0;0;0;;
Campina da Lagoa;De 2.500 a menos de 10.000 ha;0;0;0;0;0;0;0;0;0;0;0;0;0;0;0;0;;
Campina da Lagoa;De 10.000 ha e mais;0;0;0;0;0;0;0;0;0;0;0;0;0;0;0;0;;
Campina da Lagoa;Produtor sem área;0;0;0;0;0;0;0;0;0;0;0;0;0;0;0;0;;
Campina do Simão;Mais de 0 a menos de 0,1 ha;0;0;0;0;0;0;0;0;0;0;0;0;0;0;0;0;;
Campina do Simão;De 0,1 a menos de 0,2 ha;0;0;0;0;0;0;0;0;0;0;0;0;0;0;0;0;;
Campina do Simão;De 0,2 a menos de 0,5 ha;2;0;1;1;0;0;1;1;0;1;1;0;0;0;0;0;;
Campina do Simão;De 0,5 a menos de 1 ha;5;4;2;3;0;0;3;2;2;0;1;2;0;0;0;0;;
Campina do Simão;De 1 a menos de 2 ha;9;12;1;8;0;0;5;4;1;0;4;4;0;0;0;4;;
Campina do Simão;De 2 a menos de 3 ha;22;54;5;17;12;42;15;7;3;2;12;5;0;2;0;3;;
Campina do Simão;De 3 a menos de 4 ha;26;89;7;19;24;65;17;9;5;2;12;7;0;2;0;4;;
Campina do Simão;De 4 a menos de 5 ha;40;188;6;34;28;161;21;19;2;4;19;15;0;2;0;11;;
Campina do Simão;De 5 a menos de 10 ha;81;611;9;72;64;547;43;38;4;5;39;33;0;4;0;25;;
Campina do Simão;De 10 a menos de 20 ha;114;1633;6;108;92;1541;68;46;2;4;66;42;0;3;0;31;;
Campina do Simão;De 20 a menos de 50 ha;79;2449;6;73;242;2207;56;23;0;6;56;17;0;6;0;14;;
Campina do Simão;De 50 a menos de 100 ha;31;2087;13;18;1006;1081;17;14;5;8;12;6;0;5;0;5;;
Campina do Simão;De 100 a menos de 200 ha;19;2656;19;0;2656;0;17;2;17;2;0;0;0;1;0;0;;
Campina do Simão;De 200 a menos de 500 ha;19;6183;19;0;6183;0;14;5;14;5;0;0;0;4;0;0;;
Campina do Simão;De 500 a menos de 1.000 ha;7;4665;7;0;4665;0;6;1;6;1;0;0;0;0;0;0;;
Campina do Simão;De 1.000 a menos de 2.500 ha;5;6186;5;0;6186;0;4;1;4;1;0;0;0;1;0;0;;
Campina do Simão;De 2.500 a menos de 10.000 ha;1;0;1;0;0;0;0;1;0;1;0;0;0;1;0;0;;
Campina do Simão;De 10.000 ha e mais;0;0;0;0;0;0;0;0;0;0;0;0;0;0;0;0;;
Campina do Simão;Produtor sem área;0;0;0;0;0;0;0;0;0;0;0;0;0;0;0;0;;
Campina Grande do Sul;Mais de 0 a menos de 0,1 ha;6;0;3;3;0;0;0;6;0;3;0;3;0;3;0;3;;
Campina Grande do Sul;De 0,1 a menos de 0,2 ha;4;0;2;2;0;0;0;4;0;2;0;2;0;2;0;2;;
Campina Grande do Sul;De 0,2 a menos de 0,5 ha;24;7;12;12;4;4;1;23;0;12;1;11;0;12;0;10;;
Campina Grande do Sul;De 0,5 a menos de 1 ha;21;15;7;14;5;11;0;21;0;7;0;14;1;6;0;12;;
Campina Grande do Sul;De 1 a menos de 2 ha;44;57;16;28;22;35;2;42;0;16;2;26;0;13;0;21;;
Campina Grande do Sul;De 2 a menos de 3 ha;50;119;25;25;60;59;1;49;0;25;1;24;0;21;0;19;;
Campina Grande do Sul;De 3 a menos de 4 ha;27;94;12;15;43;50;2;25;0;12;2;13;0;11;0;8;;
Campina Grande do Sul;De 4 a menos de 5 ha;19;91;9;10;44;47;0;19;0;9;0;10;0;8;0;9;;
Campina Grande do Sul;De 5 a menos de 10 ha;83;604;46;37;331;273;8;75;7;39;1;36;0;31;0;32;;
Campina Grande do Sul;De 10 a menos de 20 ha;64;887;33;31;468;419;7;57;1;32;6;25;0;22;0;16;;
Campina Grande do Sul;De 20 a menos de 50 ha;52;1594;26;26;809;785;5;47;2;24;3;23;1;21;1;16;;
Campina Grande do Sul;De 50 a menos de 100 ha;21;1628;19;2;0;0;1;20;0;19;1;1;0;15;0;0;;
Campina Grande do Sul;De 100 a menos de 200 ha;13;2058;13;0;2058;0;0;13;0;13;0;0;0;10;0;0;;
Campina Grande do Sul;De 200 a menos de 500 ha;7;2142;7;0;2142;0;0;7;0;7;0;0;0;6;0;0;;
Campina Grande do Sul;De 500 a menos de 1.000 ha;5;3240;5;0;3240;0;0;5;0;5;0;0;0;5;0;0;;
Campina Grande do Sul;De 1.000 a menos de 2.500 ha;5;6399;5;0;6399;0;0;5;0;5;0;0;0;4;0;0;;
Campina Grande do Sul;De 2.500 a menos de 10.000 ha;1;0;1;0;0;0;0;1;0;1;0;0;0;1;0;0;;
Campina Grande do Sul;De 10.000 ha e mais;0;0;0;0;0;0;0;0;0;0;0;0;0;0;0;0;;
Campina Grande do Sul;Produtor sem área;1;0;1;0;0;0;0;0;0;0;0;0;0;0;0;0;;
Campo Bonito;Mais de 0 a menos de 0,1 ha;9;1;5;4;0;0;0;9;0;5;0;4;0;4;0;4;;
Campo Bonito;De 0,1 a menos de 0,2 ha;5;0;4;1;0;0;1;4;1;3;0;1;0;3;0;1;;
Campo Bonito;De 0,2 a menos de 0,5 ha;8;2;5;3;2;1;1;7;0;5;1;2;0;3;0;2;;
Campo Bonito;De 0,5 a menos de 1 ha;46;24;20;26;10;14;12;34;3;17;9;17;1;11;1;10;;
Campo Bonito;De 1 a menos de 2 ha;14;18;11;3;0;0;7;7;5;6;2;1;1;4;1;0;;
Campo Bonito;De 2 a menos de 3 ha;34;81;13;21;31;50;10;24;2;11;8;13;0;9;0;7;;
Campo Bonito;De 3 a menos de 4 ha;27;95;9;18;31;64;13;14;3;6;10;8;1;4;0;5;;
Campo Bonito;De 4 a menos de 5 ha;24;112;6;18;29;84;13;11;1;5;12;6;0;3;0;3;;
Campo Bonito;De 5 a menos de 10 ha;77;611;8;69;68;544;52;25;5;3;47;22;1;1;1;11;;
Campo Bonito;De 10 a menos de 20 ha;106;1661;9;97;130;1531;90;16;5;4;85;12;0;3;0;10;;
Campo Bonito;De 20 a menos de 50 ha;114;3544;8;106;225;3318;97;17;4;4;93;13;0;3;0;8;;
Campo Bonito;De 50 a menos de 100 ha;36;2647;12;24;1080;1566;33;3;10;2;23;1;0;1;0;1;;
Campo Bonito;De 100 a menos de 200 ha;12;1863;12;0;1863;0;12;0;12;0;0;0;0;0;0;0;;
Campo Bonito;De 200 a menos de 500 ha;21;7097;21;0;7097;0;20;1;20;1;0;0;0;1;0;0;;
Campo Bonito;De 500 a menos de 1.000 ha;10;6701;10;0;6701;0;8;2;8;2;0;0;0;2;0;0;;
Campo Bonito;De 1.000 a menos de 2.500 ha;8;11158;8;0;11158;0;7;1;7;1;0;0;0;1;0;0;;
Campo Bonito;De 2.500 a menos de 10.000 ha;1;0;1;0;0;0;1;0;1;0;0;0;0;0;0;0;;
Campo Bonito;De 10.000 ha e mais;0;0;0;0;0;0;0;0;0;0;0;0;0;0;0;0;;
Campo Bonito;Produtor sem área;0;0;0;0;0;0;0;0;0;0;0;0;0;0;0;0;;
Campo do Tenente;Mais de 0 a menos de 0,1 ha;2;0;0;2;0;0;0;2;0;0;0;2;0;0;0;2;;
Campo do Tenente;De 0,1 a menos de 0,2 ha;2;0;1;1;0;0;0;2;0;1;0;1;0;0;0;1;;
Campo do Tenente;De 0,2 a menos de 0,5 ha;1;0;0;1;0;0;1;0;0;0;1;0;0;0;0;0;;
Campo do Tenente;De 0,5 a menos de 1 ha;37;22;29;8;17;5;34;3;28;1;6;2;0;1;0;1;;
Campo do Tenente;De 1 a menos de 2 ha;12;16;6;6;9;8;10;2;4;2;6;0;0;2;0;0;;
Campo do Tenente;De 2 a menos de 3 ha;24;55;3;21;7;48;12;12;1;2;11;10;0;2;1;8;;
Campo do Tenente;De 3 a menos de 4 ha;22;72;1;21;0;0;17;5;1;0;16;5;0;0;0;5;;
Campo do Tenente;De 4 a menos de 5 ha;15;64;0;15;0;64;12;3;0;0;12;3;0;0;1;2;;
Campo do Tenente;De 5 a menos de 10 ha;74;514;6;68;47;466;65;9;5;1;60;8;0;1;2;6;;
Campo do Tenente;De 10 a menos de 20 ha;57;820;3;54;42;778;46;11;1;2;45;9;0;2;0;7;;
Campo do Tenente;De 20 a menos de 50 ha;33;966;0;33;0;966;30;3;0;0;30;3;0;0;0;2;;
Campo do Tenente;De 50 a menos de 100 ha;14;999;6;8;472;527;13;1;6;0;7;1;0;0;0;1;;
Campo do Tenente;De 100 a menos de 200 ha;11;1659;11;0;1659;0;9;2;9;2;0;0;0;1;0;0;;
Campo do Tenente;De 200 a menos de 500 ha;10;3391;10;0;3391;0;7;3;7;3;0;0;0;3;0;0;;
Campo do Tenente;De 500 a menos de 1.000 ha;4;2910;4;0;2910;0;4;0;4;0;0;0;0;0;0;0;;
Campo do Tenente;De 1.000 a menos de 2.500 ha;2;0;2;0;0;0;2;0;2;0;0;0;0;0;0;0;;
Campo do Tenente;De 2.500 a menos de 10.000 ha;2;0;2;0;0;0;2;0;2;0;0;0;0;0;0;0;;
Campo do Tenente;De 10.000 ha e mais;0;0;0;0;0;0;0;0;0;0;0;0;0;0;0;0;;
Campo do Tenente;Produtor sem área;0;0;0;0;0;0;0;0;0;0;0;0;0;0;0;0;;
Campo Largo;Mais de 0 a menos de 0,1 ha;68;3;21;47;1;2;7;61;1;20;6;41;0;17;2;35;;
Campo Largo;De 0,1 a menos de 0,2 ha;59;8;25;34;4;4;2;57;0;25;2;32;0;20;2;26;;
Campo Largo;De 0,2 a menos de 0,5 ha;89;31;29;60;10;21;10;79;2;27;8;52;2;24;3;41;;
Campo Largo;De 0,5 a menos de 1 ha;103;73;46;57;33;40;15;88;6;40;9;48;4;32;6;30;;
Campo Largo;De 1 a menos de 2 ha;191;246;64;127;86;160;39;152;9;55;30;97;2;47;3;77;;
Campo Largo;De 2 a menos de 3 ha;246;588;83;163;197;390;75;171;32;51;43;120;1;47;4;89;;
Campo Largo;De 3 a menos de 4 ha;136;479;43;93;153;326;36;100;9;34;27;66;3;29;5;55;;
Campo Largo;De 4 a menos de 5 ha;182;872;63;119;304;568;62;120;17;46;45;74;6;33;4;52;;
Campo Largo;De 5 a menos de 10 ha;336;2552;80;256;610;1942;137;199;23;57;114;142;0;45;3;106;;
Campo Largo;De 10 a menos de 20 ha;347;5070;69;278;963;4107;168;179;25;44;143;135;2;31;5;96;;
Campo Largo;De 20 a menos de 50 ha;282;8826;59;223;2105;6721;153;129;25;34;128;95;1;29;2;74;;
Campo Largo;De 50 a menos de 100 ha;85;6211;85;0;6211;0;39;46;39;46;0;0;3;33;0;0;;
Campo Largo;De 100 a menos de 200 ha;33;4556;33;0;4556;0;13;20;13;20;0;0;0;19;0;0;;
Campo Largo;De 200 a menos de 500 ha;30;9205;30;0;9205;0;5;25;5;25;0;0;1;20;0;0;;
Campo Largo;De 500 a menos de 1.000 ha;11;7048;11;0;7048;0;1;10;1;10;0;0;0;8;0;0;;
Campo Largo;De 1.000 a menos de 2.500 ha;6;0;6;0;0;0;4;2;4;2;0;0;0;2;0;0;;
Campo Largo;De 2.500 a menos de 10.000 ha;2;0;2;0;0;0;0;2;0;2;0;0;0;0;0;0;;
Campo Largo;De 10.000 ha e mais;0;0;0;0;0;0;0;0;0;0;0;0;0;0;0;0;;
Campo Largo;Produtor sem área;27;0;13;14;0;0;0;21;0;11;0;10;0;8;1;9;;
Campo Magro;Mais de 0 a menos de 0,1 ha;35;2;23;12;1;0;3;32;0;23;3;9;0;19;0;9;;
Campo Magro;De 0,1 a menos de 0,2 ha;10;1;3;7;0;1;2;8;0;3;2;5;0;3;0;4;;
Campo Magro;De 0,2 a menos de 0,5 ha;25;8;13;12;4;4;3;22;2;11;1;11;0;9;0;9;;
Campo Magro;De 0,5 a menos de 1 ha;81;49;29;52;16;32;21;60;6;23;15;37;1;21;0;29;;
Campo Magro;De 1 a menos de 2 ha;135;168;39;96;48;119;47;88;5;34;42;54;0;28;1;43;;
Campo Magro;De 2 a menos de 3 ha;91;216;30;61;71;145;40;51;8;22;32;29;0;19;1;20;;
Campo Magro;De 3 a menos de 4 ha;54;190;15;39;52;138;32;22;3;12;29;10;0;10;0;7;;
Campo Magro;De 4 a menos de 5 ha;62;290;14;48;65;225;32;30;3;11;29;19;0;11;2;14;;
Campo Magro;De 5 a menos de 10 ha;133;1043;29;104;211;832;78;55;8;21;70;34;0;17;0;24;;
Campo Magro;De 10 a menos de 20 ha;115;1656;19;96;276;1380;78;37;8;11;70;26;0;8;2;19;;
Campo Magro;De 20 a menos de 50 ha;82;2512;10;72;343;2169;66;16;5;5;61;11;0;4;0;6;;
Campo Magro;De 50 a menos de 100 ha;15;972;15;0;972;0;11;4;11;4;0;0;0;4;0;0;;
Campo Magro;De 100 a menos de 200 ha;11;1752;11;0;1752;0;4;7;4;7;0;0;0;6;0;0;;
Campo Magro;De 200 a menos de 500 ha;5;1607;5;0;1607;0;2;3;2;3;0;0;0;2;0;0;;
Campo Magro;De 500 a menos de 1.000 ha;2;0;2;0;0;0;1;1;1;1;0;0;0;1;0;0;;
Campo Magro;De 1.000 a menos de 2.500 ha;1;0;1;0;0;0;1;0;1;0;0;0;0;0;0;0;;
Campo Magro;De 2.500 a menos de 10.000 ha;1;0;1;0;0;0;1;0;1;0;0;0;0;0;0;0;;
Campo Magro;De 10.000 ha e mais;0;0;0;0;0;0;0;0;0;0;0;0;0;0;0;0;;
Campo Magro;Produtor sem área;0;0;0;0;0;0;0;0;0;0;0;0;0;0;0;0;;
Campo Mourão;Mais de 0 a menos de 0,1 ha;0;0;0;0;0;0;0;0;0;0;0;0;0;0;0;0;;
Campo Mourão;De 0,1 a menos de 0,2 ha;0;0;0;0;0;0;0;0;0;0;0;0;0;0;0;0;;
Campo Mourão;De 0,2 a menos de 0,5 ha;1;0;0;1;0;0;0;1;0;0;0;1;0;0;0;1;;
Campo Mourão;De 0,5 a menos de 1 ha;4;0;2;2;0;0;1;3;0;2;1;1;0;2;1;0;;
Campo Mourão;De 1 a menos de 2 ha;10;14;1;9;0;0;3;7;0;1;3;6;0;0;2;4;;
Campo Mourão;De 2 a menos de 3 ha;22;55;5;17;13;42;2;20;0;5;2;15;2;2;9;4;;
Campo Mourão;De 3 a menos de 4 ha;23;80;5;18;16;64;7;16;1;4;6;12;0;4;1;8;;
Campo Mourão;De 4 a menos de 5 ha;27;130;4;23;19;111;10;17;0;4;10;13;0;3;1;10;;
Campo Mourão;De 5 a menos de 10 ha;93;689;17;76;126;563;45;48;6;11;39;37;2;6;1;21;;
Campo Mourão;De 10 a menos de 20 ha;103;1472;14;89;189;1283;63;40;4;10;59;30;0;8;3;19;;
Campo Mourão;De 20 a menos de 50 ha;117;3729;8;109;242;3487;91;26;2;6;89;20;0;5;1;15;;
Campo Mourão;De 50 a menos de 100 ha;70;5159;43;27;3538;1621;62;8;37;6;25;2;0;4;0;2;;
Campo Mourão;De 100 a menos de 200 ha;64;8967;64;0;8967;0;55;9;55;9;0;0;0;9;0;0;;
Campo Mourão;De 200 a menos de 500 ha;56;17144;56;0;17144;0;52;4;52;4;0;0;0;3;0;0;;
Campo Mourão;De 500 a menos de 1.000 ha;19;13446;19;0;13446;0;19;0;19;0;0;0;0;0;0;0;;
Campo Mourão;De 1.000 a menos de 2.500 ha;8;10484;8;0;10484;0;8;0;8;0;0;0;0;0;0;0;;
Campo Mourão;De 2.500 a menos de 10.000 ha;1;0;1;0;0;0;1;0;1;0;0;0;0;0;0;0;;
Campo Mourão;De 10.000 ha e mais;0;0;0;0;0;0;0;0;0;0;0;0;0;0;0;0;;
Campo Mourão;Produtor sem área;8;0;7;1;0;0;7;0;7;0;0;0;0;0;0;0;;
Cândido de Abreu;Mais de 0 a menos de 0,1 ha;16;1;7;9;0;0;2;14;0;7;2;7;0;7;0;7;;
Cândido de Abreu;De 0,1 a menos de 0,2 ha;32;5;9;23;1;4;4;28;2;7;2;21;0;7;1;20;;
Cândido de Abreu;De 0,2 a menos de 0,5 ha;96;38;30;66;12;26;42;54;16;14;26;40;0;14;1;33;;
Cândido de Abreu;De 0,5 a menos de 1 ha;76;55;25;51;19;36;23;53;8;17;15;36;0;15;3;28;;
Cândido de Abreu;De 1 a menos de 2 ha;126;177;22;104;32;145;68;58;9;13;59;45;1;11;3;36;;
Cândido de Abreu;De 2 a menos de 3 ha;141;343;32;109;79;265;81;60;19;13;62;47;0;12;4;38;;
Cândido de Abreu;De 3 a menos de 4 ha;112;385;20;92;69;316;57;55;9;11;48;44;0;8;2;37;;
Cândido de Abreu;De 4 a menos de 5 ha;146;697;34;112;164;534;89;57;19;15;70;42;2;13;3;30;;
Cândido de Abreu;De 5 a menos de 10 ha;356;2787;64;292;500;2288;201;155;22;42;179;113;2;38;4;97;;
Cândido de Abreu;De 10 a menos de 20 ha;524;7930;59;465;902;7028;331;193;23;36;308;157;2;33;7;124;;
Cândido de Abreu;De 20 a menos de 50 ha;466;14486;53;413;1617;12869;296;170;18;35;278;135;1;31;2;111;;
Cândido de Abreu;De 50 a menos de 100 ha;159;11105;46;113;3937;7168;100;59;30;16;70;43;0;14;2;34;;
Cândido de Abreu;De 100 a menos de 200 ha;85;12354;85;0;12354;0;49;36;49;36;0;0;0;29;0;0;;
Cândido de Abreu;De 200 a menos de 500 ha;76;23082;76;0;23082;0;38;38;38;38;0;0;1;27;0;0;;
Cândido de Abreu;De 500 a menos de 1.000 ha;28;19352;28;0;19352;0;19;9;19;9;0;0;0;9;0;0;;
Cândido de Abreu;De 1.000 a menos de 2.500 ha;9;15113;9;0;15113;0;6;3;6;3;0;0;0;1;0;0;;
Cândido de Abreu;De 2.500 a menos de 10.000 ha;1;0;1;0;0;0;1;0;1;0;0;0;0;0;0;0;;
Cândido de Abreu;De 10.000 ha e mais;0;0;0;0;0;0;0;0;0;0;0;0;0;0;0;0;;
Cândido de Abreu;Produtor sem área;3;0;2;1;0;0;0;2;0;2;0;0;1;1;0;0;;
Candói;Mais de 0 a menos de 0,1 ha;18;1;9;9;1;1;4;14;1;8;3;6;0;8;1;5;;
Candói;De 0,1 a menos de 0,2 ha;43;6;22;21;3;3;6;37;4;18;2;19;0;18;1;18;;
Candói;De 0,2 a menos de 0,5 ha;69;23;30;39;11;12;7;62;4;26;3;36;0;25;0;33;;
Candói;De 0,5 a menos de 1 ha;40;27;17;23;11;16;13;27;7;10;6;17;1;9;0;15;;
Candói;De 1 a menos de 2 ha;93;118;28;65;35;83;39;54;12;16;27;38;1;15;2;32;;
Candói;De 2 a menos de 3 ha;75;180;17;58;40;141;38;37;4;13;34;24;1;11;2;21;;
Candói;De 3 a menos de 4 ha;47;163;5;42;18;145;34;13;2;3;32;10;1;2;1;8;;
Candói;De 4 a menos de 5 ha;76;364;11;65;53;311;57;19;7;4;50;15;0;4;1;13;;
Candói;De 5 a menos de 10 ha;176;1364;19;157;150;1214;133;43;12;7;121;36;1;5;1;33;;
Candói;De 10 a menos de 20 ha;386;5633;31;355;455;5179;297;89;11;20;286;69;0;17;2;55;;
Candói;De 20 a menos de 50 ha;228;7157;12;216;440;6717;191;37;9;3;182;34;0;2;1;27;;
Candói;De 50 a menos de 100 ha;96;6833;48;48;3924;2909;92;4;46;2;46;2;0;2;0;2;;
Candói;De 100 a menos de 200 ha;58;7854;57;1;0;0;50;8;49;8;1;0;0;8;0;0;;
Candói;De 200 a menos de 500 ha;42;13489;42;0;13489;0;37;5;37;5;0;0;0;3;0;0;;
Candói;De 500 a menos de 1.000 ha;16;11499;16;0;11499;0;14;2;14;2;0;0;1;1;0;0;;
Candói;De 1.000 a menos de 2.500 ha;10;13217;10;0;13217;0;10;0;10;0;0;0;0;0;0;0;;
Candói;De 2.500 a menos de 10.000 ha;6;0;6;0;0;0;6;0;6;0;0;0;0;0;0;0;;
Candói;De 10.000 ha e mais;0;0;0;0;0;0;0;0;0;0;0;0;0;0;0;0;;
Candói;Produtor sem área;2;0;0;2;0;0;0;2;0;0;0;2;0;0;0;2;;
Cantagalo;Mais de 0 a menos de 0,1 ha;2;0;1;1;0;0;0;2;0;1;0;1;0;1;0;1;;
Cantagalo;De 0,1 a menos de 0,2 ha;7;1;1;6;0;0;1;6;0;1;1;5;0;1;0;4;;
Cantagalo;De 0,2 a menos de 0,5 ha;51;23;20;31;9;14;30;21;12;8;18;13;0;4;0;9;;
Cantagalo;De 0,5 a menos de 1 ha;17;11;4;13;2;9;5;12;1;3;4;9;0;1;0;5;;
Cantagalo;De 1 a menos de 2 ha;25;35;8;17;10;25;13;12;3;5;10;7;0;5;0;5;;
Cantagalo;De 2 a menos de 3 ha;52;126;10;42;24;102;31;21;4;6;27;15;0;4;0;11;;
Cantagalo;De 3 a menos de 4 ha;36;124;7;29;25;98;24;12;3;4;21;8;0;4;0;5;;
Cantagalo;De 4 a menos de 5 ha;50;236;4;46;0;0;39;11;2;2;37;9;0;1;0;7;;
Cantagalo;De 5 a menos de 10 ha;118;898;14;104;104;795;98;20;10;4;88;16;0;4;0;8;;
Cantagalo;De 10 a menos de 20 ha;177;2672;16;161;223;2449;150;27;12;4;138;23;0;3;0;18;;
Cantagalo;De 20 a menos de 50 ha;266;7834;10;256;313;7521;234;32;6;4;228;28;0;4;0;19;;
Cantagalo;De 50 a menos de 100 ha;62;4551;36;26;3021;1530;48;14;29;7;19;7;0;5;0;6;;
Cantagalo;De 100 a menos de 200 ha;37;5062;37;0;5062;0;31;6;31;6;0;0;0;4;0;0;;
Cantagalo;De 200 a menos de 500 ha;29;9298;29;0;9298;0;25;4;25;4;0;0;0;3;0;0;;
Cantagalo;De 500 a menos de 1.000 ha;9;6552;9;0;6552;0;9;0;9;0;0;0;0;0;0;0;;
Cantagalo;De 1.000 a menos de 2.500 ha;5;0;5;0;0;0;4;1;4;1;0;0;0;0;0;0;;
Cantagalo;De 2.500 a menos de 10.000 ha;0;0;0;0;0;0;0;0;0;0;0;0;0;0;0;0;;
Cantagalo;De 10.000 ha e mais;0;0;0;0;0;0;0;0;0;0;0;0;0;0;0;0;;
Cantagalo;Produtor sem área;0;0;0;0;0;0;0;0;0;0;0;0;0;0;0;0;;
Capanema;Mais de 0 a menos de 0,1 ha;3;0;0;3;0;0;0;3;0;0;0;3;0;0;0;3;;
Capanema;De 0,1 a menos de 0,2 ha;20;3;6;14;0;0;4;16;1;5;3;11;3;2;5;6;;
Capanema;De 0,2 a menos de 0,5 ha;29;10;12;17;4;6;10;19;6;6;4;13;3;1;4;8;;
Capanema;De 0,5 a menos de 1 ha;36;23;9;27;6;18;11;25;2;7;9;18;2;3;3;13;;
Capanema;De 1 a menos de 2 ha;73;97;16;57;20;77;29;44;6;10;23;34;2;7;13;17;;
Capanema;De 2 a menos de 3 ha;97;236;18;79;43;193;45;52;7;11;38;41;1;8;13;22;;
Capanema;De 3 a menos de 4 ha;123;418;26;97;86;332;74;49;15;11;59;38;2;7;10;18;;
Capanema;De 4 a menos de 5 ha;125;583;13;112;60;523;82;43;8;5;74;38;1;4;10;20;;
Capanema;De 5 a menos de 10 ha;470;3521;35;435;260;3262;356;114;25;10;331;104;5;3;28;48;;
Capanema;De 10 a menos de 20 ha;503;7031;26;477;347;6684;426;77;17;9;409;68;0;6;10;36;;
Capanema;De 20 a menos de 50 ha;316;9604;12;304;386;9217;292;24;8;4;284;20;1;2;3;11;;
Capanema;De 50 a menos de 100 ha;84;5712;22;62;1850;3862;77;7;19;3;58;4;0;3;0;2;;
Capanema;De 100 a menos de 200 ha;29;3695;29;0;3695;0;28;1;28;1;0;0;0;1;0;0;;
Capanema;De 200 a menos de 500 ha;9;0;9;0;0;0;9;0;9;0;0;0;0;0;0;0;;
Capanema;De 500 a menos de 1.000 ha;0;0;0;0;0;0;0;0;0;0;0;0;0;0;0;0;;
Capanema;De 1.000 a menos de 2.500 ha;0;0;0;0;0;0;0;0;0;0;0;0;0;0;0;0;;
Capanema;De 2.500 a menos de 10.000 ha;0;0;0;0;0;0;0;0;0;0;0;0;0;0;0;0;;
Capanema;De 10.000 ha e mais;0;0;0;0;0;0;0;0;0;0;0;0;0;0;0;0;;
Capanema;Produtor sem área;0;0;0;0;0;0;0;0;0;0;0;0;0;0;0;0;;
Capitão Leônidas Marques;Mais de 0 a menos de 0,1 ha;38;2;18;20;1;1;10;28;7;11;3;17;0;11;0;15;;
Capitão Leônidas Marques;De 0,1 a menos de 0,2 ha;10;1;4;6;0;1;5;5;0;4;5;1;0;3;0;1;;
Capitão Leônidas Marques;De 0,2 a menos de 0,5 ha;11;3;6;5;2;2;4;7;3;3;1;4;0;2;0;3;;
Capitão Leônidas Marques;De 0,5 a menos de 1 ha;50;30;23;27;14;16;33;17;16;7;17;10;0;4;3;5;;
Capitão Leônidas Marques;De 1 a menos de 2 ha;29;38;10;19;13;25;14;15;5;5;9;10;0;3;1;6;;
Capitão Leônidas Marques;De 2 a menos de 3 ha;51;123;19;32;46;77;36;15;13;6;23;9;2;2;0;5;;
Capitão Leônidas Marques;De 3 a menos de 4 ha;57;195;11;46;39;157;43;14;6;5;37;9;0;3;0;7;;
Capitão Leônidas Marques;De 4 a menos de 5 ha;63;296;14;49;66;230;49;14;11;3;38;11;0;2;0;6;;
Capitão Leônidas Marques;De 5 a menos de 10 ha;197;1492;41;156;290;1202;162;35;27;14;135;21;0;9;0;12;;
Capitão Leônidas Marques;De 10 a menos de 20 ha;217;3232;27;190;402;2829;193;24;19;8;174;16;0;3;1;5;;
Capitão Leônidas Marques;De 20 a menos de 50 ha;163;5088;11;152;306;4783;148;15;7;4;141;11;1;3;1;6;;
Capitão Leônidas Marques;De 50 a menos de 100 ha;68;4559;19;49;1422;3137;64;4;17;2;47;2;0;1;0;2;;
Capitão Leônidas Marques;De 100 a menos de 200 ha;25;3416;25;0;3416;0;25;0;25;0;0;0;0;0;0;0;;
Capitão Leônidas Marques;De 200 a menos de 500 ha;4;864;4;0;864;0;4;0;4;0;0;0;0;0;0;0;;
Capitão Leônidas Marques;De 500 a menos de 1.000 ha;4;3144;4;0;3144;0;4;0;4;0;0;0;0;0;0;0;;
Capitão Leônidas Marques;De 1.000 a menos de 2.500 ha;0;0;0;0;0;0;0;0;0;0;0;0;0;0;0;0;;
Capitão Leônidas Marques;De 2.500 a menos de 10.000 ha;0;0;0;0;0;0;0;0;0;0;0;0;0;0;0;0;;
Capitão Leônidas Marques;De 10.000 ha e mais;0;0;0;0;0;0;0;0;0;0;0;0;0;0;0;0;;
Capitão Leônidas Marques;Produtor sem área;0;0;0;0;0;0;0;0;0;0;0;0;0;0;0;0;;
Carambeí;Mais de 0 a menos de 0,1 ha;0;0;0;0;0;0;0;0;0;0;0;0;0;0;0;0;;
Carambeí;De 0,1 a menos de 0,2 ha;0;0;0;0;0;0;0;0;0;0;0;0;0;0;0;0;;
Carambeí;De 0,2 a menos de 0,5 ha;1;0;0;1;0;0;0;1;0;0;0;1;0;0;1;0;;
Carambeí;De 0,5 a menos de 1 ha;2;0;0;2;0;0;1;1;0;0;1;1;0;0;0;1;;
Carambeí;De 1 a menos de 2 ha;5;6;0;5;0;6;0;5;0;0;0;5;0;0;1;4;;
Carambeí;De 2 a menos de 3 ha;4;9;1;3;0;0;2;2;1;0;1;2;0;0;0;2;;
Carambeí;De 3 a menos de 4 ha;7;24;1;6;0;0;2;5;0;1;2;4;0;1;1;3;;
Carambeí;De 4 a menos de 5 ha;3;14;0;3;0;14;2;1;0;0;2;1;0;0;0;0;;
Carambeí;De 5 a menos de 10 ha;18;129;4;14;0;0;13;5;3;1;10;4;0;1;0;3;;
Carambeí;De 10 a menos de 20 ha;28;399;6;22;82;317;16;12;2;4;14;8;0;3;2;3;;
Carambeí;De 20 a menos de 50 ha;39;1389;15;24;576;813;36;3;13;2;23;1;0;1;0;0;;
Carambeí;De 50 a menos de 100 ha;28;1911;22;6;1577;334;26;2;21;1;5;1;0;1;0;0;;
Carambeí;De 100 a menos de 200 ha;36;4694;36;0;4694;0;34;2;34;2;0;0;0;1;0;0;;
Carambeí;De 200 a menos de 500 ha;29;8655;29;0;8655;0;27;2;27;2;0;0;0;1;0;0;;
Carambeí;De 500 a menos de 1.000 ha;13;8116;13;0;8116;0;10;3;10;3;0;0;0;3;0;0;;
Carambeí;De 1.000 a menos de 2.500 ha;9;13699;9;0;13699;0;8;1;8;1;0;0;0;0;0;0;;
Carambeí;De 2.500 a menos de 10.000 ha;0;0;0;0;0;0;0;0;0;0;0;0;0;0;0;0;;
Carambeí;De 10.000 ha e mais;0;0;0;0;0;0;0;0;0;0;0;0;0;0;0;0;;
Carambeí;Produtor sem área;0;0;0;0;0;0;0;0;0;0;0;0;0;0;0;0;;
Carlópolis;Mais de 0 a menos de 0,1 ha;6;0;1;5;0;0;2;4;1;0;1;4;0;0;0;4;;
Carlópolis;De 0,1 a menos de 0,2 ha;3;0;0;3;0;0;0;3;0;0;0;3;0;0;0;3;;
Carlópolis;De 0,2 a menos de 0,5 ha;14;4;0;14;0;4;0;14;0;0;0;14;0;0;0;9;;
Carlópolis;De 0,5 a menos de 1 ha;32;20;0;32;0;20;17;15;0;0;17;15;0;0;0;8;;
Carlópolis;De 1 a menos de 2 ha;62;81;5;57;6;75;25;37;2;3;23;34;0;3;0;21;;
Carlópolis;De 2 a menos de 3 ha;107;258;5;102;12;246;57;50;1;4;56;46;0;1;0;36;;
Carlópolis;De 3 a menos de 4 ha;180;616;8;172;28;588;114;66;4;4;110;62;0;2;0;42;;
Carlópolis;De 4 a menos de 5 ha;131;620;5;126;0;0;70;61;2;3;68;58;0;2;3;39;;
Carlópolis;De 5 a menos de 10 ha;307;2315;14;293;110;2205;179;128;10;4;169;124;0;3;0;92;;
Carlópolis;De 10 a menos de 20 ha;182;2608;15;167;210;2398;96;86;10;5;86;81;1;2;1;58;;
Carlópolis;De 20 a menos de 50 ha;147;4558;31;116;1005;3553;85;62;26;5;59;57;0;2;0;47;;
Carlópolis;De 50 a menos de 100 ha;55;3934;29;26;2353;1580;27;28;17;12;10;16;0;10;0;11;;
Carlópolis;De 100 a menos de 200 ha;24;3368;24;0;3368;0;16;8;16;8;0;0;0;6;0;0;;
Carlópolis;De 200 a menos de 500 ha;22;6881;22;0;6881;0;11;11;11;11;0;0;0;7;0;0;;
Carlópolis;De 500 a menos de 1.000 ha;1;0;1;0;0;0;1;0;1;0;0;0;0;0;0;0;;
Carlópolis;De 1.000 a menos de 2.500 ha;0;0;0;0;0;0;0;0;0;0;0;0;0;0;0;0;;
Carlópolis;De 2.500 a menos de 10.000 ha;0;0;0;0;0;0;0;0;0;0;0;0;0;0;0;0;;
Carlópolis;De 10.000 ha e mais;0;0;0;0;0;0;0;0;0;0;0;0;0;0;0;0;;
Carlópolis;Produtor sem área;0;0;0;0;0;0;0;0;0;0;0;0;0;0;0;0;;
Cascavel;Mais de 0 a menos de 0,1 ha;9;0;4;5;0;0;2;7;1;3;1;4;0;3;0;3;;
Cascavel;De 0,1 a menos de 0,2 ha;8;1;3;5;0;0;2;6;2;1;0;5;0;1;0;4;;
Cascavel;De 0,2 a menos de 0,5 ha;84;27;54;30;17;10;29;55;17;37;12;18;3;30;3;13;;
Cascavel;De 0,5 a menos de 1 ha;135;83;67;68;41;42;46;89;23;44;23;45;2;33;0;36;;
Cascavel;De 1 a menos de 2 ha;113;144;35;78;45;99;42;71;18;17;24;54;0;14;2;41;;
Cascavel;De 2 a menos de 3 ha;217;528;83;134;201;327;111;106;45;38;66;68;0;28;4;54;;
Cascavel;De 3 a menos de 4 ha;174;614;46;128;164;451;100;74;22;24;78;50;0;17;4;35;;
Cascavel;De 4 a menos de 5 ha;218;1030;71;147;334;696;131;87;40;31;91;56;0;25;4;42;;
Cascavel;De 5 a menos de 10 ha;561;4146;108;453;780;3366;412;149;64;44;348;105;4;31;12;65;;
Cascavel;De 10 a menos de 20 ha;603;8830;62;541;869;7961;504;99;30;32;474;67;0;21;7;49;;
Cascavel;De 20 a menos de 50 ha;513;15866;55;458;1737;14129;468;45;34;21;434;24;0;15;0;21;;
Cascavel;De 50 a menos de 100 ha;226;15919;118;108;9408;6511;213;13;106;12;107;1;1;11;0;0;;
Cascavel;De 100 a menos de 200 ha;142;20012;142;0;20012;0;132;10;132;10;0;0;0;7;0;0;;
Cascavel;De 200 a menos de 500 ha;140;44479;140;0;44479;0;131;9;131;9;0;0;0;9;0;0;;
Cascavel;De 500 a menos de 1.000 ha;55;37840;55;0;37840;0;50;5;50;5;0;0;0;2;0;0;;
Cascavel;De 1.000 a menos de 2.500 ha;17;23311;17;0;23311;0;15;2;15;2;0;0;0;2;0;0;;
Cascavel;De 2.500 a menos de 10.000 ha;1;0;1;0;0;0;1;0;1;0;0;0;0;0;0;0;;
Cascavel;De 10.000 ha e mais;0;0;0;0;0;0;0;0;0;0;0;0;0;0;0;0;;
Cascavel;Produtor sem área;5;0;5;0;0;0;0;0;0;0;0;0;0;0;0;0;;
Castro;Mais de 0 a menos de 0,1 ha;66;4;6;60;0;3;7;59;1;5;6;54;0;5;3;47;;
Castro;De 0,1 a menos de 0,2 ha;36;6;4;32;0;0;3;33;0;4;3;29;1;3;1;26;;
Castro;De 0,2 a menos de 0,5 ha;70;22;8;62;3;20;5;65;3;5;2;60;0;5;4;52;;
Castro;De 0,5 a menos de 1 ha;93;61;21;72;13;47;14;79;4;17;10;62;2;13;7;48;;
Castro;De 1 a menos de 2 ha;167;217;29;138;38;178;48;119;9;20;39;99;2;16;7;83;;
Castro;De 2 a menos de 3 ha;187;440;39;148;91;349;33;154;10;29;23;125;3;23;8;108;;
Castro;De 3 a menos de 4 ha;135;458;31;104;104;354;39;96;10;21;29;75;2;14;5;65;;
Castro;De 4 a menos de 5 ha;163;761;33;130;155;606;39;124;8;25;31;99;2;22;9;79;;
Castro;De 5 a menos de 10 ha;392;2931;77;315;570;2361;123;269;17;60;106;209;6;48;15;178;;
Castro;De 10 a menos de 20 ha;449;6535;99;350;1457;5078;186;263;31;68;155;195;2;59;18;142;;
Castro;De 20 a menos de 50 ha;401;12284;97;304;3142;9142;189;212;52;45;137;167;2;32;13;131;;
Castro;De 50 a menos de 100 ha;162;10971;116;46;8463;2508;91;71;70;46;21;25;0;36;1;17;;
Castro;De 100 a menos de 200 ha;106;14751;106;0;14751;0;72;34;72;34;0;0;1;24;0;0;;
Castro;De 200 a menos de 500 ha;111;35216;111;0;35216;0;85;26;85;26;0;0;1;21;0;0;;
Castro;De 500 a menos de 1.000 ha;42;27120;42;0;27120;0;33;9;33;9;0;0;0;9;0;0;;
Castro;De 1.000 a menos de 2.500 ha;16;20321;16;0;20321;0;14;2;14;2;0;0;0;2;0;0;;
Castro;De 2.500 a menos de 10.000 ha;1;0;1;0;0;0;0;1;0;1;0;0;0;1;0;0;;
Castro;De 10.000 ha e mais;0;0;0;0;0;0;0;0;0;0;0;0;0;0;0;0;;
Castro;Produtor sem área;6;0;1;5;0;0;0;4;0;0;0;4;0;0;1;3;;
Catanduvas;Mais de 0 a menos de 0,1 ha;5;0;0;5;0;0;4;1;0;0;4;1;0;0;0;1;;
Catanduvas;De 0,1 a menos de 0,2 ha;6;1;1;5;0;0;2;4;0;1;2;3;0;1;0;3;;
Catanduvas;De 0,2 a menos de 0,5 ha;108;37;58;50;20;17;21;87;6;52;15;35;0;44;0;26;;
Catanduvas;De 0,5 a menos de 1 ha;25;18;8;17;6;12;8;17;1;7;7;10;0;6;0;7;;
Catanduvas;De 1 a menos de 2 ha;95;119;7;88;8;110;76;19;4;3;72;16;0;3;0;15;;
Catanduvas;De 2 a menos de 3 ha;37;89;6;31;15;74;12;25;1;5;11;20;0;4;0;16;;
Catanduvas;De 3 a menos de 4 ha;40;140;7;33;24;116;24;16;4;3;20;13;0;3;0;12;;
Catanduvas;De 4 a menos de 5 ha;88;420;9;79;44;376;62;26;8;1;54;25;0;1;0;22;;
Catanduvas;De 5 a menos de 10 ha;153;1174;11;142;75;1099;101;52;5;6;96;46;0;4;0;42;;
Catanduvas;De 10 a menos de 20 ha;171;2390;17;154;258;2132;129;42;14;3;115;39;0;2;0;34;;
Catanduvas;De 20 a menos de 50 ha;160;4958;7;153;220;4738;142;18;4;3;138;15;0;3;0;13;;
Catanduvas;De 50 a menos de 100 ha;64;4711;33;31;2858;1853;60;4;32;1;28;3;0;1;0;3;;
Catanduvas;De 100 a menos de 200 ha;58;8266;58;0;8266;0;48;10;48;10;0;0;0;7;0;0;;
Catanduvas;De 200 a menos de 500 ha;50;15796;50;0;15796;0;44;6;44;6;0;0;0;6;0;0;;
Catanduvas;De 500 a menos de 1.000 ha;13;9255;13;0;9255;0;11;2;11;2;0;0;0;2;0;0;;
Catanduvas;De 1.000 a menos de 2.500 ha;2;0;2;0;0;0;2;0;2;0;0;0;0;0;0;0;;
Catanduvas;De 2.500 a menos de 10.000 ha;1;0;1;0;0;0;0;1;0;1;0;0;0;1;0;0;;
Catanduvas;De 10.000 ha e mais;0;0;0;0;0;0;0;0;0;0;0;0;0;0;0;0;;
Catanduvas;Produtor sem área;0;0;0;0;0;0;0;0;0;0;0;0;0;0;0;0;;
Centenário do Sul;Mais de 0 a menos de 0,1 ha;8;0;3;5;0;0;1;7;1;2;0;5;0;1;0;5;;
Centenário do Sul;De 0,1 a menos de 0,2 ha;27;3;3;24;0;3;0;27;0;3;0;24;0;3;1;21;;
Centenário do Sul;De 0,2 a menos de 0,5 ha;12;3;1;11;0;0;2;10;0;1;2;9;0;1;0;8;;
Centenário do Sul;De 0,5 a menos de 1 ha;52;28;14;38;7;20;7;45;3;11;4;34;0;8;0;26;;
Centenário do Sul;De 1 a menos de 2 ha;17;22;4;13;5;17;3;14;1;3;2;11;0;2;1;8;;
Centenário do Sul;De 2 a menos de 3 ha;51;127;5;46;12;115;20;31;1;4;19;27;0;2;2;15;;
Centenário do Sul;De 3 a menos de 4 ha;19;67;3;16;11;56;4;15;0;3;4;12;0;2;2;9;;
Centenário do Sul;De 4 a menos de 5 ha;62;302;5;57;24;278;36;26;2;3;34;23;0;3;1;20;;
Centenário do Sul;De 5 a menos de 10 ha;279;2397;12;267;98;2300;206;73;8;4;198;69;2;1;5;47;;
Centenário do Sul;De 10 a menos de 20 ha;83;1192;8;75;108;1084;62;21;6;2;56;19;0;1;1;12;;
Centenário do Sul;De 20 a menos de 50 ha;123;3799;5;118;217;3583;98;25;2;3;96;22;0;3;0;20;;
Centenário do Sul;De 50 a menos de 100 ha;32;2235;32;0;2235;0;29;3;29;3;0;0;0;1;0;0;;
Centenário do Sul;De 100 a menos de 200 ha;13;1903;13;0;1903;0;10;3;10;3;0;0;2;0;0;0;;
Centenário do Sul;De 200 a menos de 500 ha;8;2685;8;0;2685;0;7;1;7;1;0;0;0;0;0;0;;
Centenário do Sul;De 500 a menos de 1.000 ha;5;3381;5;0;3381;0;2;3;2;3;0;0;0;2;0;0;;
Centenário do Sul;De 1.000 a menos de 2.500 ha;2;0;2;0;0;0;2;0;2;0;0;0;0;0;0;0;;
Centenário do Sul;De 2.500 a menos de 10.000 ha;2;0;2;0;0;0;2;0;2;0;0;0;0;0;0;0;;
Centenário do Sul;De 10.000 ha e mais;0;0;0;0;0;0;0;0;0;0;0;0;0;0;0;0;;
Centenário do Sul;Produtor sem área;0;0;0;0;0;0;0;0;0;0;0;0;0;0;0;0;;
Cerro Azul;Mais de 0 a menos de 0,1 ha;16;1;5;11;0;1;7;9;2;3;5;6;0;3;0;6;;
Cerro Azul;De 0,1 a menos de 0,2 ha;20;3;6;14;1;2;5;15;1;5;4;10;0;2;0;9;;
Cerro Azul;De 0,2 a menos de 0,5 ha;37;12;9;28;3;9;10;27;1;8;9;19;0;7;0;17;;
Cerro Azul;De 0,5 a menos de 1 ha;130;82;47;83;30;52;33;97;7;40;26;57;0;34;2;50;;
Cerro Azul;De 1 a menos de 2 ha;272;375;65;207;92;283;119;153;20;45;99;108;0;40;2;84;;
Cerro Azul;De 2 a menos de 3 ha;231;560;42;189;102;458;119;112;16;26;103;86;0;21;1;69;;
Cerro Azul;De 3 a menos de 4 ha;144;505;26;118;93;413;72;72;9;17;63;55;0;15;0;47;;
Cerro Azul;De 4 a menos de 5 ha;141;672;11;130;52;620;90;51;5;6;85;45;0;5;1;29;;
Cerro Azul;De 5 a menos de 10 ha;282;2114;36;246;271;1843;146;136;11;25;135;111;1;21;2;88;;
Cerro Azul;De 10 a menos de 20 ha;306;4402;29;277;399;4002;169;137;8;21;161;116;0;18;3;94;;
Cerro Azul;De 20 a menos de 50 ha;247;8061;22;225;697;7364;158;89;11;11;147;78;0;11;1;61;;
Cerro Azul;De 50 a menos de 100 ha;93;6479;8;85;595;5884;44;49;1;7;43;42;0;7;1;35;;
Cerro Azul;De 100 a menos de 200 ha;40;5649;34;6;4991;658;20;20;17;17;3;3;0;15;0;3;;
Cerro Azul;De 200 a menos de 500 ha;19;5721;19;0;5721;0;8;11;8;11;0;0;0;9;0;0;;
Cerro Azul;De 500 a menos de 1.000 ha;4;2803;4;0;2803;0;1;3;1;3;0;0;0;2;0;0;;
Cerro Azul;De 1.000 a menos de 2.500 ha;3;3624;2;1;0;0;0;3;0;2;0;1;0;2;0;1;;
Cerro Azul;De 2.500 a menos de 10.000 ha;3;0;3;0;0;0;1;2;1;2;0;0;0;2;0;0;;
Cerro Azul;De 10.000 ha e mais;0;0;0;0;0;0;0;0;0;0;0;0;0;0;0;0;;
Cerro Azul;Produtor sem área;3;0;1;2;0;0;0;1;0;0;0;1;0;0;0;1;;
Céu Azul;Mais de 0 a menos de 0,1 ha;26;1;20;6;1;0;2;24;2;18;0;6;2;15;0;6;;
Céu Azul;De 0,1 a menos de 0,2 ha;6;1;2;4;0;0;3;3;1;1;2;2;0;1;0;2;;
Céu Azul;De 0,2 a menos de 0,5 ha;9;3;4;5;1;1;2;7;1;3;1;4;0;3;0;4;;
Céu Azul;De 0,5 a menos de 1 ha;33;20;19;14;11;9;19;14;11;8;8;6;2;2;0;6;;
Céu Azul;De 1 a menos de 2 ha;33;40;9;24;10;29;11;22;3;6;8;16;0;2;5;8;;
Céu Azul;De 2 a menos de 3 ha;40;96;5;35;12;84;16;24;0;5;16;19;0;5;6;11;;
Céu Azul;De 3 a menos de 4 ha;24;82;2;22;0;0;9;15;0;2;9;13;0;2;7;4;;
Céu Azul;De 4 a menos de 5 ha;49;235;8;41;39;196;32;17;5;3;27;14;0;3;2;10;;
Céu Azul;De 5 a menos de 10 ha;121;904;7;114;51;852;71;50;1;6;70;44;0;6;15;26;;
Céu Azul;De 10 a menos de 20 ha;171;2461;18;153;243;2218;132;39;7;11;125;28;0;10;1;25;;
Céu Azul;De 20 a menos de 50 ha;155;4792;11;144;360;4432;138;17;6;5;132;12;0;5;0;11;;
Céu Azul;De 50 a menos de 100 ha;58;4026;28;30;2248;1778;50;8;24;4;26;4;0;4;0;4;;
Céu Azul;De 100 a menos de 200 ha;44;6238;44;0;6238;0;41;3;41;3;0;0;0;3;0;0;;
Céu Azul;De 200 a menos de 500 ha;26;7808;26;0;7808;0;25;1;25;1;0;0;0;0;0;0;;
Céu Azul;De 500 a menos de 1.000 ha;5;0;5;0;0;0;4;1;4;1;0;0;0;1;0;0;;
Céu Azul;De 1.000 a menos de 2.500 ha;1;0;1;0;0;0;1;0;1;0;0;0;0;0;0;0;;
Céu Azul;De 2.500 a menos de 10.000 ha;0;0;0;0;0;0;0;0;0;0;0;0;0;0;0;0;;
Céu Azul;De 10.000 ha e mais;0;0;0;0;0;0;0;0;0;0;0;0;0;0;0;0;;
Céu Azul;Produtor sem área;0;0;0;0;0;0;0;0;0;0;0;0;0;0;0;0;;
Chopinzinho;Mais de 0 a menos de 0,1 ha;2;0;1;1;0;0;1;1;1;0;0;1;0;0;1;0;;
Chopinzinho;De 0,1 a menos de 0,2 ha;6;1;1;5;0;0;1;5;1;0;0;5;0;0;0;5;;
Chopinzinho;De 0,2 a menos de 0,5 ha;18;5;3;15;0;0;4;14;0;3;4;11;0;3;0;11;;
Chopinzinho;De 0,5 a menos de 1 ha;44;27;10;34;6;21;16;28;3;7;13;21;0;6;0;19;;
Chopinzinho;De 1 a menos de 2 ha;50;64;9;41;13;52;36;14;6;3;30;11;0;2;0;11;;
Chopinzinho;De 2 a menos de 3 ha;66;158;12;54;28;130;44;22;9;3;35;19;0;2;0;14;;
Chopinzinho;De 3 a menos de 4 ha;65;224;12;53;42;183;51;14;7;5;44;9;0;5;2;6;;
Chopinzinho;De 4 a menos de 5 ha;75;350;13;62;61;288;65;10;12;1;53;9;0;1;2;5;;
Chopinzinho;De 5 a menos de 10 ha;243;1828;28;215;208;1620;210;33;20;8;190;25;0;8;0;12;;
Chopinzinho;De 10 a menos de 20 ha;319;4693;20;299;283;4410;303;16;17;3;286;13;0;2;1;6;;
Chopinzinho;De 20 a menos de 50 ha;359;11128;23;336;726;10401;345;14;18;5;327;9;0;5;1;4;;
Chopinzinho;De 50 a menos de 100 ha;147;10305;45;102;3857;6448;137;10;41;4;96;6;0;4;1;3;;
Chopinzinho;De 100 a menos de 200 ha;84;11610;84;0;11610;0;84;0;84;0;0;0;0;0;0;0;;
Chopinzinho;De 200 a menos de 500 ha;44;12675;44;0;12675;0;43;1;43;1;0;0;0;1;0;0;;
Chopinzinho;De 500 a menos de 1.000 ha;21;13809;21;0;13809;0;19;2;19;2;0;0;0;2;0;0;;
Chopinzinho;De 1.000 a menos de 2.500 ha;1;0;1;0;0;0;1;0;1;0;0;0;0;0;0;0;;
Chopinzinho;De 2.500 a menos de 10.000 ha;0;0;0;0;0;0;0;0;0;0;0;0;0;0;0;0;;
Chopinzinho;De 10.000 ha e mais;0;0;0;0;0;0;0;0;0;0;0;0;0;0;0;0;;
Chopinzinho;Produtor sem área;6;0;3;3;0;0;1;0;1;0;0;0;0;0;0;0;;
Cianorte;Mais de 0 a menos de 0,1 ha;6;0;3;3;0;0;0;6;0;3;0;3;0;3;0;1;;
Cianorte;De 0,1 a menos de 0,2 ha;5;1;2;3;0;0;0;5;0;2;0;3;0;2;0;2;;
Cianorte;De 0,2 a menos de 0,5 ha;23;7;9;14;3;4;4;19;2;7;2;12;0;5;1;7;;
Cianorte;De 0,5 a menos de 1 ha;58;34;27;31;17;18;19;39;12;15;7;24;3;10;2;20;;
Cianorte;De 1 a menos de 2 ha;67;91;35;32;48;43;16;51;6;29;10;22;1;20;2;14;;
Cianorte;De 2 a menos de 3 ha;72;184;29;43;76;108;13;59;6;23;7;36;0;22;1;30;;
Cianorte;De 3 a menos de 4 ha;139;464;48;91;159;305;42;97;10;38;32;59;1;27;2;45;;
Cianorte;De 4 a menos de 5 ha;102;482;29;73;137;345;26;76;8;21;18;55;2;14;1;41;;
Cianorte;De 5 a menos de 10 ha;250;1854;77;173;554;1300;106;144;26;51;80;93;1;32;2;72;;
Cianorte;De 10 a menos de 20 ha;222;3188;47;175;701;2487;105;117;19;28;86;89;1;22;1;76;;
Cianorte;De 20 a menos de 50 ha;202;6444;50;152;1583;4861;110;92;23;27;87;65;0;20;1;43;;
Cianorte;De 50 a menos de 100 ha;96;6763;37;59;2931;3833;55;41;22;15;33;26;0;11;0;19;;
Cianorte;De 100 a menos de 200 ha;58;8030;58;0;8030;0;46;12;46;12;0;0;0;4;0;0;;
Cianorte;De 200 a menos de 500 ha;34;10732;34;0;10732;0;23;11;23;11;0;0;0;7;0;0;;
Cianorte;De 500 a menos de 1.000 ha;11;7319;11;0;7319;0;9;2;9;2;0;0;0;0;0;0;;
Cianorte;De 1.000 a menos de 2.500 ha;0;0;0;0;0;0;0;0;0;0;0;0;0;0;0;0;;
Cianorte;De 2.500 a menos de 10.000 ha;1;0;1;0;0;0;1;0;1;0;0;0;0;0;0;0;;
Cianorte;De 10.000 ha e mais;1;0;1;0;0;0;1;0;1;0;0;0;0;0;0;0;;
Cianorte;Produtor sem área;2;0;1;1;0;0;0;0;0;0;0;0;0;0;0;0;;
Cidade Gaúcha;Mais de 0 a menos de 0,1 ha;3;0;2;1;0;0;2;1;1;1;1;0;0;1;0;0;;
Cidade Gaúcha;De 0,1 a menos de 0,2 ha;2;0;0;2;0;0;2;0;0;0;2;0;0;0;0;0;;
Cidade Gaúcha;De 0,2 a menos de 0,5 ha;2;0;0;2;0;0;0;2;0;0;0;2;0;0;0;1;;
Cidade Gaúcha;De 0,5 a menos de 1 ha;112;57;66;46;33;24;51;61;28;38;23;23;0;22;0;12;;
Cidade Gaúcha;De 1 a menos de 2 ha;6;7;4;2;0;0;2;4;2;2;0;2;0;2;0;1;;
Cidade Gaúcha;De 2 a menos de 3 ha;7;17;5;2;0;0;2;5;1;4;1;1;0;3;0;0;;
Cidade Gaúcha;De 3 a menos de 4 ha;2;0;1;1;0;0;0;2;0;1;0;1;0;1;0;1;;
Cidade Gaúcha;De 4 a menos de 5 ha;9;43;3;6;14;29;4;5;2;1;2;4;0;1;0;0;;
Cidade Gaúcha;De 5 a menos de 10 ha;22;173;6;16;41;133;10;12;2;4;8;8;0;2;0;5;;
Cidade Gaúcha;De 10 a menos de 20 ha;31;448;12;19;173;275;9;22;3;9;6;13;0;7;0;8;;
Cidade Gaúcha;De 20 a menos de 50 ha;48;1753;15;33;586;1167;27;21;8;7;19;14;0;4;0;8;;
Cidade Gaúcha;De 50 a menos de 100 ha;18;1365;9;9;724;641;11;7;7;2;4;5;0;1;0;3;;
Cidade Gaúcha;De 100 a menos de 200 ha;29;4133;29;0;4133;0;21;8;21;8;0;0;0;4;0;0;;
Cidade Gaúcha;De 200 a menos de 500 ha;26;7625;26;0;7625;0;17;9;17;9;0;0;0;7;0;0;;
Cidade Gaúcha;De 500 a menos de 1.000 ha;6;4200;6;0;4200;0;5;1;5;1;0;0;0;0;0;0;;
Cidade Gaúcha;De 1.000 a menos de 2.500 ha;5;6703;5;0;6703;0;4;1;4;1;0;0;0;1;0;0;;
Cidade Gaúcha;De 2.500 a menos de 10.000 ha;1;0;1;0;0;0;1;0;1;0;0;0;0;0;0;0;;
Cidade Gaúcha;De 10.000 ha e mais;0;0;0;0;0;0;0;0;0;0;0;0;0;0;0;0;;
Cidade Gaúcha;Produtor sem área;3;0;2;1;0;0;0;1;0;1;0;0;0;0;0;0;;
Clevelândia;Mais de 0 a menos de 0,1 ha;0;0;0;0;0;0;0;0;0;0;0;0;0;0;0;0;;
Clevelândia;De 0,1 a menos de 0,2 ha;1;0;0;1;0;0;0;1;0;0;0;1;0;0;0;1;;
Clevelândia;De 0,2 a menos de 0,5 ha;10;3;0;10;0;3;1;9;0;0;1;9;0;0;3;3;;
Clevelândia;De 0,5 a menos de 1 ha;23;14;5;18;3;11;8;15;2;3;6;12;0;3;0;10;;
Clevelândia;De 1 a menos de 2 ha;11;15;5;6;6;8;6;5;4;1;2;4;0;1;0;4;;
Clevelândia;De 2 a menos de 3 ha;9;22;1;8;0;0;5;4;1;0;4;4;0;0;0;4;;
Clevelândia;De 3 a menos de 4 ha;12;42;1;11;0;0;7;5;0;1;7;4;1;0;1;2;;
Clevelândia;De 4 a menos de 5 ha;23;110;2;21;0;0;18;5;1;1;17;4;0;1;2;2;;
Clevelândia;De 5 a menos de 10 ha;75;566;3;72;24;542;65;10;2;1;63;9;0;1;1;5;;
Clevelândia;De 10 a menos de 20 ha;227;3070;8;219;111;2958;211;16;6;2;205;14;0;1;2;9;;
Clevelândia;De 20 a menos de 50 ha;149;4919;5;144;189;4731;135;14;1;4;134;10;0;3;1;5;;
Clevelândia;De 50 a menos de 100 ha;80;5725;19;61;1645;4080;74;6;16;3;58;3;0;3;0;3;;
Clevelândia;De 100 a menos de 200 ha;58;8210;58;0;8210;0;55;3;55;3;0;0;0;3;0;0;;
Clevelândia;De 200 a menos de 500 ha;58;17399;57;1;0;0;51;7;50;7;1;0;0;7;0;0;;
Clevelândia;De 500 a menos de 1.000 ha;18;12843;18;0;12843;0;18;0;18;0;0;0;0;0;0;0;;
Clevelândia;De 1.000 a menos de 2.500 ha;5;8126;5;0;8126;0;4;1;4;1;0;0;0;1;0;0;;
Clevelândia;De 2.500 a menos de 10.000 ha;1;0;1;0;0;0;1;0;1;0;0;0;0;0;0;0;;
Clevelândia;De 10.000 ha e mais;0;0;0;0;0;0;0;0;0;0;0;0;0;0;0;0;;
Clevelândia;Produtor sem área;1;0;0;1;0;0;0;0;0;0;0;0;0;0;0;0;;
Colombo;Mais de 0 a menos de 0,1 ha;0;0;0;0;0;0;0;0;0;0;0;0;0;0;0;0;;
Colombo;De 0,1 a menos de 0,2 ha;3;0;1;2;0;0;0;3;0;1;0;2;0;0;0;1;;
Colombo;De 0,2 a menos de 0,5 ha;9;3;0;9;0;3;1;8;0;0;1;8;0;0;0;7;;
Colombo;De 0,5 a menos de 1 ha;13;9;0;13;0;9;5;8;0;0;5;8;0;0;3;4;;
Colombo;De 1 a menos de 2 ha;38;50;3;35;4;46;14;24;1;2;13;22;1;1;5;5;;
Colombo;De 2 a menos de 3 ha;74;172;5;69;12;161;38;36;2;3;36;33;1;1;11;12;;
Colombo;De 3 a menos de 4 ha;54;184;4;50;14;170;30;24;2;2;28;22;0;2;4;8;;
Colombo;De 4 a menos de 5 ha;51;238;6;45;28;209;31;20;2;4;29;16;0;4;9;4;;
Colombo;De 5 a menos de 10 ha;73;549;9;64;69;480;38;35;3;6;35;29;0;3;4;7;;
Colombo;De 10 a menos de 20 ha;40;539;7;33;100;439;27;13;6;1;21;12;0;0;6;4;;
Colombo;De 20 a menos de 50 ha;15;453;7;8;0;0;8;7;2;5;6;2;3;2;1;0;;
Colombo;De 50 a menos de 100 ha;3;0;3;0;0;0;3;0;3;0;0;0;0;0;0;0;;
Colombo;De 100 a menos de 200 ha;0;0;0;0;0;0;0;0;0;0;0;0;0;0;0;0;;
Colombo;De 200 a menos de 500 ha;1;0;1;0;0;0;1;0;1;0;0;0;0;0;0;0;;
Colombo;De 500 a menos de 1.000 ha;0;0;0;0;0;0;0;0;0;0;0;0;0;0;0;0;;
Colombo;De 1.000 a menos de 2.500 ha;0;0;0;0;0;0;0;0;0;0;0;0;0;0;0;0;;
Colombo;De 2.500 a menos de 10.000 ha;0;0;0;0;0;0;0;0;0;0;0;0;0;0;0;0;;
Colombo;De 10.000 ha e mais;0;0;0;0;0;0;0;0;0;0;0;0;0;0;0;0;;
Colombo;Produtor sem área;0;0;0;0;0;0;0;0;0;0;0;0;0;0;0;0;;
Colorado;Mais de 0 a menos de 0,1 ha;0;0;0;0;0;0;0;0;0;0;0;0;0;0;0;0;;
Colorado;De 0,1 a menos de 0,2 ha;0;0;0;0;0;0;0;0;0;0;0;0;0;0;0;0;;
Colorado;De 0,2 a menos de 0,5 ha;7;2;2;5;0;0;2;5;0;2;2;3;0;2;1;2;;
Colorado;De 0,5 a menos de 1 ha;23;13;11;12;6;7;8;15;5;6;3;9;0;5;0;6;;
Colorado;De 1 a menos de 2 ha;14;18;11;3;0;0;3;11;3;8;0;3;0;5;0;3;;
Colorado;De 2 a menos de 3 ha;18;45;5;13;12;33;6;12;1;4;5;8;0;3;0;7;;
Colorado;De 3 a menos de 4 ha;18;62;8;10;28;34;8;10;4;4;4;6;0;3;2;4;;
Colorado;De 4 a menos de 5 ha;28;134;10;18;48;85;8;20;0;10;8;10;0;5;0;5;;
Colorado;De 5 a menos de 10 ha;68;511;24;44;179;333;23;45;9;15;14;30;0;8;0;18;;
Colorado;De 10 a menos de 20 ha;68;962;22;46;297;665;31;37;8;14;23;23;0;10;1;13;;
Colorado;De 20 a menos de 50 ha;86;2646;24;62;740;1906;24;62;8;16;16;46;0;10;0;22;;
Colorado;De 50 a menos de 100 ha;31;2051;16;15;1219;832;13;18;5;11;8;7;0;3;0;2;;
Colorado;De 100 a menos de 200 ha;18;2458;18;0;2458;0;6;12;6;12;0;0;0;7;0;0;;
Colorado;De 200 a menos de 500 ha;11;3212;11;0;3212;0;6;5;6;5;0;0;0;2;0;0;;
Colorado;De 500 a menos de 1.000 ha;1;0;1;0;0;0;1;0;1;0;0;0;0;0;0;0;;
Colorado;De 1.000 a menos de 2.500 ha;1;0;1;0;0;0;0;1;0;1;0;0;0;0;0;0;;
Colorado;De 2.500 a menos de 10.000 ha;0;0;0;0;0;0;0;0;0;0;0;0;0;0;0;0;;
Colorado;De 10.000 ha e mais;1;0;1;0;0;0;1;0;1;0;0;0;0;0;0;0;;
Colorado;Produtor sem área;0;0;0;0;0;0;0;0;0;0;0;0;0;0;0;0;;
Congonhinhas;Mais de 0 a menos de 0,1 ha;4;0;0;4;0;0;0;4;0;0;0;4;0;0;0;4;;
Congonhinhas;De 0,1 a menos de 0,2 ha;2;0;1;1;0;0;0;2;0;1;0;1;0;1;0;0;;
Congonhinhas;De 0,2 a menos de 0,5 ha;3;0;1;2;0;0;0;3;0;1;0;2;0;1;0;1;;
Congonhinhas;De 0,5 a menos de 1 ha;40;21;7;33;4;17;8;32;2;5;6;27;1;3;4;15;;
Congonhinhas;De 1 a menos de 2 ha;23;28;5;18;6;22;3;20;0;5;3;15;0;3;0;12;;
Congonhinhas;De 2 a menos de 3 ha;41;100;12;29;29;70;13;28;4;8;9;20;0;4;1;15;;
Congonhinhas;De 3 a menos de 4 ha;235;805;40;195;137;669;84;151;24;16;60;135;0;11;0;50;;
Congonhinhas;De 4 a menos de 5 ha;55;261;6;49;28;233;14;41;0;6;14;35;0;4;1;23;;
Congonhinhas;De 5 a menos de 10 ha;162;1279;21;141;185;1093;60;102;7;14;53;88;0;13;0;61;;
Congonhinhas;De 10 a menos de 20 ha;246;3198;22;224;304;2894;100;146;8;14;92;132;0;10;7;75;;
Congonhinhas;De 20 a menos de 50 ha;72;2225;14;58;417;1809;28;44;5;9;23;35;0;8;1;27;;
Congonhinhas;De 50 a menos de 100 ha;18;1337;13;5;1042;295;11;7;8;5;3;2;0;2;0;2;;
Congonhinhas;De 100 a menos de 200 ha;33;4909;33;0;4909;0;18;15;18;15;0;0;0;12;0;0;;
Congonhinhas;De 200 a menos de 500 ha;28;8957;28;0;8957;0;16;12;16;12;0;0;1;10;0;0;;
Congonhinhas;De 500 a menos de 1.000 ha;8;5175;8;0;5175;0;4;4;4;4;0;0;0;4;0;0;;
Congonhinhas;De 1.000 a menos de 2.500 ha;4;0;4;0;0;0;3;1;3;1;0;0;0;0;0;0;;
Congonhinhas;De 2.500 a menos de 10.000 ha;0;0;0;0;0;0;0;0;0;0;0;0;0;0;0;0;;
Congonhinhas;De 10.000 ha e mais;0;0;0;0;0;0;0;0;0;0;0;0;0;0;0;0;;
Congonhinhas;Produtor sem área;0;0;0;0;0;0;0;0;0;0;0;0;0;0;0;0;;
Conselheiro Mairinck;Mais de 0 a menos de 0,1 ha;3;0;0;3;0;0;0;3;0;0;0;3;0;0;0;2;;
Conselheiro Mairinck;De 0,1 a menos de 0,2 ha;0;0;0;0;0;0;0;0;0;0;0;0;0;0;0;0;;
Conselheiro Mairinck;De 0,2 a menos de 0,5 ha;2;0;1;1;0;0;1;1;0;1;1;0;0;1;0;0;;
Conselheiro Mairinck;De 0,5 a menos de 1 ha;16;10;6;10;4;6;5;11;2;4;3;7;0;4;0;3;;
Conselheiro Mairinck;De 1 a menos de 2 ha;10;13;4;6;5;8;5;5;3;1;2;4;0;1;0;3;;
Conselheiro Mairinck;De 2 a menos de 3 ha;17;42;2;15;0;0;2;15;1;1;1;14;0;1;0;12;;
Conselheiro Mairinck;De 3 a menos de 4 ha;6;21;2;4;0;0;2;4;0;2;2;2;0;1;0;2;;
Conselheiro Mairinck;De 4 a menos de 5 ha;17;80;5;12;22;57;6;11;0;5;6;6;0;4;0;3;;
Conselheiro Mairinck;De 5 a menos de 10 ha;48;375;11;37;87;288;20;28;4;7;16;21;0;6;1;11;;
Conselheiro Mairinck;De 10 a menos de 20 ha;36;541;7;29;99;442;6;30;1;6;5;24;0;4;0;10;;
Conselheiro Mairinck;De 20 a menos de 50 ha;21;564;2;19;0;0;9;12;0;2;9;10;0;2;0;7;;
Conselheiro Mairinck;De 50 a menos de 100 ha;19;1333;9;10;704;629;6;13;3;6;3;7;0;5;0;6;;
Conselheiro Mairinck;De 100 a menos de 200 ha;6;928;6;0;928;0;2;4;2;4;0;0;0;4;0;0;;
Conselheiro Mairinck;De 200 a menos de 500 ha;7;2261;7;0;2261;0;1;6;1;6;0;0;0;4;0;0;;
Conselheiro Mairinck;De 500 a menos de 1.000 ha;5;3215;5;0;3215;0;5;0;5;0;0;0;0;0;0;0;;
Conselheiro Mairinck;De 1.000 a menos de 2.500 ha;5;7110;5;0;7110;0;4;1;4;1;0;0;0;1;0;0;;
Conselheiro Mairinck;De 2.500 a menos de 10.000 ha;0;0;0;0;0;0;0;0;0;0;0;0;0;0;0;0;;
Conselheiro Mairinck;De 10.000 ha e mais;0;0;0;0;0;0;0;0;0;0;0;0;0;0;0;0;;
Conselheiro Mairinck;Produtor sem área;0;0;0;0;0;0;0;0;0;0;0;0;0;0;0;0;;
Contenda;Mais de 0 a menos de 0,1 ha;18;1;8;10;0;0;4;14;2;6;2;8;0;6;1;4;;
Contenda;De 0,1 a menos de 0,2 ha;6;1;2;4;0;0;1;5;0;2;1;3;2;0;0;3;;
Contenda;De 0,2 a menos de 0,5 ha;22;7;5;17;1;6;8;14;1;4;7;10;1;2;3;6;;
Contenda;De 0,5 a menos de 1 ha;37;26;14;23;10;16;9;28;2;12;7;16;0;10;2;10;;
Contenda;De 1 a menos de 2 ha;41;63;9;32;12;50;19;22;4;5;15;17;0;5;3;10;;
Contenda;De 2 a menos de 3 ha;71;175;21;50;51;123;35;36;10;11;25;25;1;10;4;11;;
Contenda;De 3 a menos de 4 ha;50;173;12;38;42;131;39;11;7;5;32;6;1;4;3;2;;
Contenda;De 4 a menos de 5 ha;62;295;9;53;43;252;49;13;4;5;45;8;3;1;0;6;;
Contenda;De 5 a menos de 10 ha;199;1475;31;168;234;1241;161;38;17;14;144;24;0;8;2;14;;
Contenda;De 10 a menos de 20 ha;244;3607;21;223;297;3310;215;29;15;6;200;23;2;2;2;11;;
Contenda;De 20 a menos de 50 ha;256;7707;29;227;1002;6705;234;22;25;4;209;18;0;3;2;11;;
Contenda;De 50 a menos de 100 ha;50;3380;50;0;3380;0;48;2;48;2;0;0;0;2;0;0;;
Contenda;De 100 a menos de 200 ha;13;1872;13;0;1872;0;13;0;13;0;0;0;0;0;0;0;;
Contenda;De 200 a menos de 500 ha;4;0;4;0;0;0;4;0;4;0;0;0;0;0;0;0;;
Contenda;De 500 a menos de 1.000 ha;1;0;1;0;0;0;1;0;1;0;0;0;0;0;0;0;;
Contenda;De 1.000 a menos de 2.500 ha;0;0;0;0;0;0;0;0;0;0;0;0;0;0;0;0;;
Contenda;De 2.500 a menos de 10.000 ha;0;0;0;0;0;0;0;0;0;0;0;0;0;0;0;0;;
Contenda;De 10.000 ha e mais;0;0;0;0;0;0;0;0;0;0;0;0;0;0;0;0;;
Contenda;Produtor sem área;0;0;0;0;0;0;0;0;0;0;0;0;0;0;0;0;;
Corbélia;Mais de 0 a menos de 0,1 ha;0;0;0;0;0;0;0;0;0;0;0;0;0;0;0;0;;
Corbélia;De 0,1 a menos de 0,2 ha;1;0;0;1;0;0;0;1;0;0;0;1;0;0;0;1;;
Corbélia;De 0,2 a menos de 0,5 ha;2;0;1;1;0;0;1;1;1;0;0;1;0;0;1;0;;
Corbélia;De 0,5 a menos de 1 ha;3;2;1;2;0;0;0;3;0;1;0;2;0;0;0;2;;
Corbélia;De 1 a menos de 2 ha;15;21;4;11;5;16;1;14;0;4;1;10;0;4;0;9;;
Corbélia;De 2 a menos de 3 ha;18;42;3;15;7;35;4;14;2;1;2;13;0;1;1;10;;
Corbélia;De 3 a menos de 4 ha;14;50;3;11;10;40;6;8;0;3;6;5;0;3;0;4;;
Corbélia;De 4 a menos de 5 ha;13;63;2;11;0;0;4;9;1;1;3;8;0;1;1;7;;
Corbélia;De 5 a menos de 10 ha;55;437;10;45;79;358;41;14;6;4;35;10;0;3;0;9;;
Corbélia;De 10 a menos de 20 ha;68;1001;6;62;96;905;60;8;3;3;57;5;0;3;0;3;;
Corbélia;De 20 a menos de 50 ha;100;3218;8;92;297;2921;93;7;4;4;89;3;0;4;0;3;;
Corbélia;De 50 a menos de 100 ha;63;4446;33;30;2627;1819;57;6;28;5;29;1;0;5;0;1;;
Corbélia;De 100 a menos de 200 ha;44;6295;44;0;6295;0;40;4;40;4;0;0;0;4;0;0;;
Corbélia;De 200 a menos de 500 ha;39;13313;39;0;13313;0;37;2;37;2;0;0;0;2;0;0;;
Corbélia;De 500 a menos de 1.000 ha;17;12199;17;0;12199;0;17;0;17;0;0;0;0;0;0;0;;
Corbélia;De 1.000 a menos de 2.500 ha;2;0;2;0;0;0;2;0;2;0;0;0;0;0;0;0;;
Corbélia;De 2.500 a menos de 10.000 ha;0;0;0;0;0;0;0;0;0;0;0;0;0;0;0;0;;
Corbélia;De 10.000 ha e mais;0;0;0;0;0;0;0;0;0;0;0;0;0;0;0;0;;
Corbélia;Produtor sem área;0;0;0;0;0;0;0;0;0;0;0;0;0;0;0;0;;
Cornélio Procópio;Mais de 0 a menos de 0,1 ha;0;0;0;0;0;0;0;0;0;0;0;0;0;0;0;0;;
Cornélio Procópio;De 0,1 a menos de 0,2 ha;0;0;0;0;0;0;0;0;0;0;0;0;0;0;0;0;;
Cornélio Procópio;De 0,2 a menos de 0,5 ha;1;0;1;0;0;0;0;1;0;1;0;0;1;0;0;0;;
Cornélio Procópio;De 0,5 a menos de 1 ha;4;3;1;3;0;0;2;2;0;1;2;1;0;1;0;1;;
Cornélio Procópio;De 1 a menos de 2 ha;19;27;3;16;0;0;7;12;2;1;5;11;0;0;1;9;;
Cornélio Procópio;De 2 a menos de 3 ha;24;60;1;23;0;0;12;12;1;0;11;12;0;0;1;11;;
Cornélio Procópio;De 3 a menos de 4 ha;42;142;3;39;10;132;19;23;0;3;19;20;0;3;0;16;;
Cornélio Procópio;De 4 a menos de 5 ha;32;150;5;27;23;127;13;19;2;3;11;16;0;3;2;12;;
Cornélio Procópio;De 5 a menos de 10 ha;91;678;9;82;63;614;60;31;4;5;56;26;2;3;1;24;;
Cornélio Procópio;De 10 a menos de 20 ha;138;2013;9;129;133;1880;101;37;6;3;95;34;0;2;0;33;;
Cornélio Procópio;De 20 a menos de 50 ha;176;5507;18;158;560;4947;128;48;14;4;114;44;0;4;0;40;;
Cornélio Procópio;De 50 a menos de 100 ha;73;5364;55;18;4277;1087;48;25;33;22;15;3;0;21;0;2;;
Cornélio Procópio;De 100 a menos de 200 ha;65;9618;65;0;9618;0;44;21;44;21;0;0;0;20;0;0;;
Cornélio Procópio;De 200 a menos de 500 ha;42;12869;42;0;12869;0;33;9;33;9;0;0;0;7;0;0;;
Cornélio Procópio;De 500 a menos de 1.000 ha;13;8443;13;0;8443;0;11;2;11;2;0;0;0;1;0;0;;
Cornélio Procópio;De 1.000 a menos de 2.500 ha;6;8011;6;0;8011;0;6;0;6;0;0;0;0;0;0;0;;
Cornélio Procópio;De 2.500 a menos de 10.000 ha;1;0;1;0;0;0;1;0;1;0;0;0;0;0;0;0;;
Cornélio Procópio;De 10.000 ha e mais;0;0;0;0;0;0;0;0;0;0;0;0;0;0;0;0;;
Cornélio Procópio;Produtor sem área;2;0;0;2;0;0;0;1;0;0;0;1;0;0;0;1;;
Coronel Domingos Soares;Mais de 0 a menos de 0,1 ha;12;1;6;6;0;0;0;12;0;6;0;6;0;6;0;6;;
Coronel Domingos Soares;De 0,1 a menos de 0,2 ha;9;1;3;6;0;0;3;6;0;3;3;3;0;3;0;3;;
Coronel Domingos Soares;De 0,2 a menos de 0,5 ha;15;5;7;8;2;3;2;13;1;6;1;7;0;6;0;6;;
Coronel Domingos Soares;De 0,5 a menos de 1 ha;69;42;37;32;23;20;24;45;10;27;14;18;0;24;0;17;;
Coronel Domingos Soares;De 1 a menos de 2 ha;20;27;7;13;9;18;6;14;2;5;4;9;0;4;0;8;;
Coronel Domingos Soares;De 2 a menos de 3 ha;39;94;21;18;51;43;18;21;10;11;8;10;1;9;0;8;;
Coronel Domingos Soares;De 3 a menos de 4 ha;13;47;2;11;0;0;5;8;1;1;4;7;0;1;4;3;;
Coronel Domingos Soares;De 4 a menos de 5 ha;32;154;12;20;57;97;13;19;6;6;7;13;0;4;0;11;;
Coronel Domingos Soares;De 5 a menos de 10 ha;55;444;6;49;51;393;25;30;5;1;20;29;0;1;2;24;;
Coronel Domingos Soares;De 10 a menos de 20 ha;176;2701;18;158;276;2425;114;62;12;6;102;56;0;6;1;51;;
Coronel Domingos Soares;De 20 a menos de 50 ha;446;14428;35;411;1139;13290;322;124;23;12;299;112;0;10;1;92;;
Coronel Domingos Soares;De 50 a menos de 100 ha;96;6618;20;76;1496;5122;70;26;14;6;56;20;0;6;2;13;;
Coronel Domingos Soares;De 100 a menos de 200 ha;80;11284;77;3;10843;440;57;23;57;20;0;3;1;16;0;3;;
Coronel Domingos Soares;De 200 a menos de 500 ha;83;26220;80;3;0;0;65;18;64;16;1;2;3;12;1;1;;
Coronel Domingos Soares;De 500 a menos de 1.000 ha;23;16748;23;0;16748;0;21;2;21;2;0;0;0;2;0;0;;
Coronel Domingos Soares;De 1.000 a menos de 2.500 ha;20;33553;20;0;33553;0;13;7;13;7;0;0;0;7;0;0;;
Coronel Domingos Soares;De 2.500 a menos de 10.000 ha;1;0;1;0;0;0;0;1;0;1;0;0;0;1;0;0;;
Coronel Domingos Soares;De 10.000 ha e mais;1;0;1;0;0;0;1;0;1;0;0;0;0;0;0;0;;
Coronel Domingos Soares;Produtor sem área;8;0;3;5;0;0;1;4;0;3;1;1;0;3;0;1;;
Coronel Vivida;Mais de 0 a menos de 0,1 ha;2;0;2;0;0;0;0;2;0;2;0;0;0;2;0;0;;
Coronel Vivida;De 0,1 a menos de 0,2 ha;3;0;0;3;0;0;0;3;0;0;0;3;0;0;0;2;;
Coronel Vivida;De 0,2 a menos de 0,5 ha;11;4;3;8;0;0;3;8;1;2;2;6;0;2;1;4;;
Coronel Vivida;De 0,5 a menos de 1 ha;29;19;9;20;6;14;15;14;5;4;10;10;0;4;0;9;;
Coronel Vivida;De 1 a menos de 2 ha;57;82;16;41;23;59;25;32;6;10;19;22;2;7;2;10;;
Coronel Vivida;De 2 a menos de 3 ha;61;149;12;49;29;120;38;23;5;7;33;16;0;7;0;10;;
Coronel Vivida;De 3 a menos de 4 ha;55;192;16;39;55;137;36;19;9;7;27;12;1;2;1;7;;
Coronel Vivida;De 4 a menos de 5 ha;69;329;15;54;71;258;49;20;9;6;40;14;1;4;1;9;;
Coronel Vivida;De 5 a menos de 10 ha;241;1859;38;203;280;1579;182;59;24;14;158;45;0;14;1;26;;
Coronel Vivida;De 10 a menos de 20 ha;339;4903;25;314;334;4569;299;40;16;9;283;31;0;6;0;15;;
Coronel Vivida;De 20 a menos de 50 ha;357;11232;13;344;408;10824;338;19;9;4;329;15;0;4;0;6;;
Coronel Vivida;De 50 a menos de 100 ha;151;10461;45;106;3855;6606;142;9;43;2;99;7;1;1;0;6;;
Coronel Vivida;De 100 a menos de 200 ha;61;8532;61;0;8532;0;57;4;57;4;0;0;0;2;0;0;;
Coronel Vivida;De 200 a menos de 500 ha;40;12716;40;0;12716;0;38;2;38;2;0;0;0;2;0;0;;
Coronel Vivida;De 500 a menos de 1.000 ha;3;0;3;0;0;0;3;0;3;0;0;0;0;0;0;0;;
Coronel Vivida;De 1.000 a menos de 2.500 ha;2;0;2;0;0;0;2;0;2;0;0;0;0;0;0;0;;
Coronel Vivida;De 2.500 a menos de 10.000 ha;0;0;0;0;0;0;0;0;0;0;0;0;0;0;0;0;;
Coronel Vivida;De 10.000 ha e mais;0;0;0;0;0;0;0;0;0;0;0;0;0;0;0;0;;
Coronel Vivida;Produtor sem área;0;0;0;0;0;0;0;0;0;0;0;0;0;0;0;0;;
Corumbataí do Sul;Mais de 0 a menos de 0,1 ha;0;0;0;0;0;0;0;0;0;0;0;0;0;0;0;0;;
Corumbataí do Sul;De 0,1 a menos de 0,2 ha;0;0;0;0;0;0;0;0;0;0;0;0;0;0;0;0;;
Corumbataí do Sul;De 0,2 a menos de 0,5 ha;1;0;0;1;0;0;1;0;0;0;1;0;0;0;0;0;;
Corumbataí do Sul;De 0,5 a menos de 1 ha;15;8;8;7;4;4;7;8;4;4;3;4;2;1;1;0;;
Corumbataí do Sul;De 1 a menos de 2 ha;6;0;2;4;0;0;0;6;0;2;0;4;0;1;1;3;;
Corumbataí do Sul;De 2 a menos de 3 ha;21;51;3;18;7;44;5;16;1;2;4;14;0;1;0;10;;
Corumbataí do Sul;De 3 a menos de 4 ha;30;106;9;21;31;74;6;24;2;7;4;17;0;5;2;7;;
Corumbataí do Sul;De 4 a menos de 5 ha;31;147;4;27;19;128;15;16;1;3;14;13;0;2;0;10;;
Corumbataí do Sul;De 5 a menos de 10 ha;78;578;17;61;115;464;31;47;6;11;25;36;1;7;0;18;;
Corumbataí do Sul;De 10 a menos de 20 ha;87;1253;6;81;79;1174;46;41;1;5;45;36;1;4;0;23;;
Corumbataí do Sul;De 20 a menos de 50 ha;52;1697;6;46;168;1529;25;27;2;4;23;23;0;3;0;14;;
Corumbataí do Sul;De 50 a menos de 100 ha;29;1907;3;26;264;1644;17;12;3;0;14;12;0;0;0;8;;
Corumbataí do Sul;De 100 a menos de 200 ha;19;2794;19;0;2794;0;13;6;13;6;0;0;1;4;0;0;;
Corumbataí do Sul;De 200 a menos de 500 ha;12;3692;12;0;3692;0;11;1;11;1;0;0;1;0;0;0;;
Corumbataí do Sul;De 500 a menos de 1.000 ha;1;0;1;0;0;0;0;1;0;1;0;0;0;1;0;0;;
Corumbataí do Sul;De 1.000 a menos de 2.500 ha;0;0;0;0;0;0;0;0;0;0;0;0;0;0;0;0;;
Corumbataí do Sul;De 2.500 a menos de 10.000 ha;0;0;0;0;0;0;0;0;0;0;0;0;0;0;0;0;;
Corumbataí do Sul;De 10.000 ha e mais;0;0;0;0;0;0;0;0;0;0;0;0;0;0;0;0;;
Corumbataí do Sul;Produtor sem área;0;0;0;0;0;0;0;0;0;0;0;0;0;0;0;0;;
Cruzeiro do Iguaçu;Mais de 0 a menos de 0,1 ha;11;1;1;10;0;0;1;10;0;1;1;9;0;1;0;8;;
Cruzeiro do Iguaçu;De 0,1 a menos de 0,2 ha;12;2;7;5;0;0;2;10;2;5;0;5;0;4;0;4;;
Cruzeiro do Iguaçu;De 0,2 a menos de 0,5 ha;11;3;2;9;0;0;3;8;0;2;3;6;0;2;0;6;;
Cruzeiro do Iguaçu;De 0,5 a menos de 1 ha;31;21;9;22;7;14;16;15;7;2;9;13;0;2;0;13;;
Cruzeiro do Iguaçu;De 1 a menos de 2 ha;30;39;8;22;10;29;20;10;6;2;14;8;0;2;0;6;;
Cruzeiro do Iguaçu;De 2 a menos de 3 ha;36;90;10;26;25;65;18;18;4;6;14;12;0;4;0;10;;
Cruzeiro do Iguaçu;De 3 a menos de 4 ha;28;99;7;21;26;73;18;10;5;2;13;8;0;1;0;6;;
Cruzeiro do Iguaçu;De 4 a menos de 5 ha;24;114;8;16;38;75;17;7;6;2;11;5;0;2;0;5;;
Cruzeiro do Iguaçu;De 5 a menos de 10 ha;67;503;12;55;84;419;57;10;5;7;52;3;0;7;0;3;;
Cruzeiro do Iguaçu;De 10 a menos de 20 ha;77;1161;11;66;180;982;68;9;9;2;59;7;0;2;0;6;;
Cruzeiro do Iguaçu;De 20 a menos de 50 ha;66;2062;7;59;195;1867;62;4;6;1;56;3;0;1;0;3;;
Cruzeiro do Iguaçu;De 50 a menos de 100 ha;23;1629;6;17;476;1153;22;1;5;1;17;0;0;1;0;0;;
Cruzeiro do Iguaçu;De 100 a menos de 200 ha;16;2318;16;0;2318;0;14;2;14;2;0;0;0;2;0;0;;
Cruzeiro do Iguaçu;De 200 a menos de 500 ha;9;2586;9;0;2586;0;8;1;8;1;0;0;0;0;0;0;;
Cruzeiro do Iguaçu;De 500 a menos de 1.000 ha;7;3965;7;0;3965;0;7;0;7;0;0;0;0;0;0;0;;
Cruzeiro do Iguaçu;De 1.000 a menos de 2.500 ha;0;0;0;0;0;0;0;0;0;0;0;0;0;0;0;0;;
Cruzeiro do Iguaçu;De 2.500 a menos de 10.000 ha;0;0;0;0;0;0;0;0;0;0;0;0;0;0;0;0;;
Cruzeiro do Iguaçu;De 10.000 ha e mais;0;0;0;0;0;0;0;0;0;0;0;0;0;0;0;0;;
Cruzeiro do Iguaçu;Produtor sem área;0;0;0;0;0;0;0;0;0;0;0;0;0;0;0;0;;
Cruzeiro do Oeste;Mais de 0 a menos de 0,1 ha;9;0;2;7;0;0;2;7;1;1;1;6;0;0;2;3;;
Cruzeiro do Oeste;De 0,1 a menos de 0,2 ha;2;0;1;1;0;0;0;2;0;1;0;1;0;1;0;1;;
Cruzeiro do Oeste;De 0,2 a menos de 0,5 ha;20;6;8;12;3;4;1;19;1;7;0;12;0;4;0;10;;
Cruzeiro do Oeste;De 0,5 a menos de 1 ha;41;26;9;32;6;20;3;38;1;8;2;30;0;6;9;13;;
Cruzeiro do Oeste;De 1 a menos de 2 ha;42;57;16;26;23;34;2;40;0;16;2;24;1;10;0;14;;
Cruzeiro do Oeste;De 2 a menos de 3 ha;43;104;10;33;24;80;6;37;1;9;5;28;0;7;1;22;;
Cruzeiro do Oeste;De 3 a menos de 4 ha;46;162;7;39;25;136;6;40;1;6;5;34;0;3;2;24;;
Cruzeiro do Oeste;De 4 a menos de 5 ha;94;447;12;82;57;390;14;80;2;10;12;70;1;8;4;33;;
Cruzeiro do Oeste;De 5 a menos de 10 ha;212;1666;30;182;240;1425;30;182;5;25;25;157;1;19;6;71;;
Cruzeiro do Oeste;De 10 a menos de 20 ha;181;2604;17;164;237;2368;25;156;0;17;25;139;0;14;2;72;;
Cruzeiro do Oeste;De 20 a menos de 50 ha;145;4644;17;128;518;4127;42;103;5;12;37;91;0;7;4;36;;
Cruzeiro do Oeste;De 50 a menos de 100 ha;70;5054;23;47;1979;3075;26;44;8;15;18;29;1;7;1;10;;
Cruzeiro do Oeste;De 100 a menos de 200 ha;45;6153;45;0;6153;0;20;25;20;25;0;0;1;9;0;0;;
Cruzeiro do Oeste;De 200 a menos de 500 ha;44;13119;44;0;13119;0;16;28;16;28;0;0;2;12;0;0;;
Cruzeiro do Oeste;De 500 a menos de 1.000 ha;12;8686;12;0;8686;0;2;10;2;10;0;0;0;5;0;0;;
Cruzeiro do Oeste;De 1.000 a menos de 2.500 ha;6;8604;6;0;8604;0;1;5;1;5;0;0;0;0;0;0;;
Cruzeiro do Oeste;De 2.500 a menos de 10.000 ha;1;0;1;0;0;0;1;0;1;0;0;0;0;0;0;0;;
Cruzeiro do Oeste;De 10.000 ha e mais;1;0;1;0;0;0;1;0;1;0;0;0;0;0;0;0;;
Cruzeiro do Oeste;Produtor sem área;5;0;2;3;0;0;0;0;0;0;0;0;0;0;0;0;;
Cruzeiro do Sul;Mais de 0 a menos de 0,1 ha;1;0;0;1;0;0;0;1;0;0;0;1;0;0;0;1;;
Cruzeiro do Sul;De 0,1 a menos de 0,2 ha;0;0;0;0;0;0;0;0;0;0;0;0;0;0;0;0;;
Cruzeiro do Sul;De 0,2 a menos de 0,5 ha;1;0;1;0;0;0;0;1;0;1;0;0;1;0;0;0;;
Cruzeiro do Sul;De 0,5 a menos de 1 ha;27;15;15;12;8;7;7;20;5;10;2;10;0;9;1;6;;
Cruzeiro do Sul;De 1 a menos de 2 ha;3;4;1;2;0;0;2;1;1;0;1;1;0;0;0;1;;
Cruzeiro do Sul;De 2 a menos de 3 ha;3;0;0;3;0;0;2;1;0;0;2;1;0;0;1;0;;
Cruzeiro do Sul;De 3 a menos de 4 ha;16;52;1;15;0;0;4;12;0;1;4;11;0;1;2;7;;
Cruzeiro do Sul;De 4 a menos de 5 ha;27;123;2;25;0;0;16;11;1;1;15;10;0;0;1;8;;
Cruzeiro do Sul;De 5 a menos de 10 ha;30;219;9;21;62;157;15;15;4;5;11;10;0;5;1;3;;
Cruzeiro do Sul;De 10 a menos de 20 ha;47;677;7;40;96;581;27;20;5;2;22;18;0;2;1;12;;
Cruzeiro do Sul;De 20 a menos de 50 ha;45;1345;9;36;270;1075;33;12;7;2;26;10;0;2;2;5;;
Cruzeiro do Sul;De 50 a menos de 100 ha;21;1403;7;14;480;923;20;1;6;1;14;0;0;1;0;0;;
Cruzeiro do Sul;De 100 a menos de 200 ha;16;2489;16;0;2489;0;11;5;11;5;0;0;0;5;0;0;;
Cruzeiro do Sul;De 200 a menos de 500 ha;14;3960;14;0;3960;0;13;1;13;1;0;0;0;0;0;0;;
Cruzeiro do Sul;De 500 a menos de 1.000 ha;3;1815;3;0;1815;0;3;0;3;0;0;0;0;0;0;0;;
Cruzeiro do Sul;De 1.000 a menos de 2.500 ha;2;0;2;0;0;0;1;1;1;1;0;0;0;0;0;0;;
Cruzeiro do Sul;De 2.500 a menos de 10.000 ha;1;0;1;0;0;0;1;0;1;0;0;0;0;0;0;0;;
Cruzeiro do Sul;De 10.000 ha e mais;0;0;0;0;0;0;0;0;0;0;0;0;0;0;0;0;;
Cruzeiro do Sul;Produtor sem área;0;0;0;0;0;0;0;0;0;0;0;0;0;0;0;0;;
Cruz Machado;Mais de 0 a menos de 0,1 ha;5;0;1;4;0;0;1;4;0;1;1;3;0;1;0;2;;
Cruz Machado;De 0,1 a menos de 0,2 ha;11;2;7;4;0;0;2;9;1;6;1;3;0;5;1;2;;
Cruz Machado;De 0,2 a menos de 0,5 ha;31;10;9;22;3;7;4;27;2;7;2;20;0;5;0;16;;
Cruz Machado;De 0,5 a menos de 1 ha;44;29;23;21;15;14;14;30;7;16;7;14;1;14;0;9;;
Cruz Machado;De 1 a menos de 2 ha;84;113;32;52;40;73;29;55;8;24;21;31;0;16;0;16;;
Cruz Machado;De 2 a menos de 3 ha;107;257;35;72;84;173;40;67;13;22;27;45;0;17;1;31;;
Cruz Machado;De 3 a menos de 4 ha;79;267;23;56;78;189;54;25;20;3;34;22;0;3;1;16;;
Cruz Machado;De 4 a menos de 5 ha;124;591;31;93;145;445;71;53;11;20;60;33;0;18;3;12;;
Cruz Machado;De 5 a menos de 10 ha;359;2708;80;279;589;2119;208;151;35;45;173;106;1;32;4;57;;
Cruz Machado;De 10 a menos de 20 ha;623;9046;89;534;1302;7744;420;203;44;45;376;158;1;36;3;74;;
Cruz Machado;De 20 a menos de 50 ha;1204;36417;115;1089;3356;33061;910;294;60;55;850;239;1;43;8;92;;
Cruz Machado;De 50 a menos de 100 ha;280;18840;38;242;2930;15910;234;46;31;7;203;39;0;5;3;20;;
Cruz Machado;De 100 a menos de 200 ha;45;5883;40;5;5117;766;34;11;30;10;4;1;0;6;0;1;;
Cruz Machado;De 200 a menos de 500 ha;15;4255;13;2;0;0;7;8;5;8;2;0;0;8;0;0;;
Cruz Machado;De 500 a menos de 1.000 ha;14;9153;14;0;9153;0;4;10;4;10;0;0;0;10;0;0;;
Cruz Machado;De 1.000 a menos de 2.500 ha;8;11628;8;0;11628;0;0;8;0;8;0;0;1;7;0;0;;
Cruz Machado;De 2.500 a menos de 10.000 ha;3;0;3;0;0;0;1;2;1;2;0;0;0;2;0;0;;
Cruz Machado;De 10.000 ha e mais;0;0;0;0;0;0;0;0;0;0;0;0;0;0;0;0;;
Cruz Machado;Produtor sem área;15;0;8;7;0;0;2;3;1;2;1;1;0;2;0;1;;
Cruzmaltina;Mais de 0 a menos de 0,1 ha;6;0;1;5;0;0;6;0;1;0;5;0;0;0;0;0;;
Cruzmaltina;De 0,1 a menos de 0,2 ha;1;0;0;1;0;0;0;1;0;0;0;1;0;0;0;0;;
Cruzmaltina;De 0,2 a menos de 0,5 ha;7;2;0;7;0;2;6;1;0;0;6;1;0;0;0;1;;
Cruzmaltina;De 0,5 a menos de 1 ha;20;11;7;13;4;7;11;9;4;3;7;6;0;1;0;6;;
Cruzmaltina;De 1 a menos de 2 ha;16;20;2;14;0;0;12;4;0;2;12;2;0;2;0;2;;
Cruzmaltina;De 2 a menos de 3 ha;16;39;2;14;0;0;11;5;0;2;11;3;0;2;0;0;;
Cruzmaltina;De 3 a menos de 4 ha;21;73;1;20;0;0;14;7;1;0;13;7;0;0;0;6;;
Cruzmaltina;De 4 a menos de 5 ha;24;115;2;22;0;0;13;11;0;2;13;9;0;1;0;6;;
Cruzmaltina;De 5 a menos de 10 ha;45;338;2;43;0;0;35;10;2;0;33;10;0;0;0;8;;
Cruzmaltina;De 10 a menos de 20 ha;45;644;3;42;34;610;38;7;1;2;37;5;0;2;0;3;;
Cruzmaltina;De 20 a menos de 50 ha;39;1197;5;34;185;1012;30;9;3;2;27;7;0;1;2;5;;
Cruzmaltina;De 50 a menos de 100 ha;21;1438;10;11;779;659;19;2;8;2;11;0;0;2;0;0;;
Cruzmaltina;De 100 a menos de 200 ha;26;3566;26;0;3566;0;21;5;21;5;0;0;0;5;0;0;;
Cruzmaltina;De 200 a menos de 500 ha;25;7913;25;0;7913;0;22;3;22;3;0;0;1;2;0;0;;
Cruzmaltina;De 500 a menos de 1.000 ha;10;6829;10;0;6829;0;8;2;8;2;0;0;0;2;0;0;;
Cruzmaltina;De 1.000 a menos de 2.500 ha;3;0;3;0;0;0;2;1;2;1;0;0;0;1;0;0;;
Cruzmaltina;De 2.500 a menos de 10.000 ha;0;0;0;0;0;0;0;0;0;0;0;0;0;0;0;0;;
Cruzmaltina;De 10.000 ha e mais;0;0;0;0;0;0;0;0;0;0;0;0;0;0;0;0;;
Cruzmaltina;Produtor sem área;0;0;0;0;0;0;0;0;0;0;0;0;0;0;0;0;;
Curitiba;Mais de 0 a menos de 0,1 ha;4;0;1;3;0;0;0;4;0;1;0;3;0;1;0;1;;
Curitiba;De 0,1 a menos de 0,2 ha;5;1;2;3;0;0;1;4;0;2;1;2;0;2;0;1;;
Curitiba;De 0,2 a menos de 0,5 ha;8;2;4;4;1;1;0;8;0;4;0;4;0;3;1;1;;
Curitiba;De 0,5 a menos de 1 ha;13;9;7;6;5;4;3;10;1;6;2;4;0;3;0;3;;
Curitiba;De 1 a menos de 2 ha;13;16;3;10;3;12;6;7;0;3;6;4;0;2;0;2;;
Curitiba;De 2 a menos de 3 ha;17;39;3;14;7;31;8;9;0;3;8;6;0;2;0;0;;
Curitiba;De 3 a menos de 4 ha;11;39;3;8;11;28;7;4;1;2;6;2;0;1;0;1;;
Curitiba;De 4 a menos de 5 ha;11;52;2;9;0;0;9;2;2;0;7;2;0;0;0;1;;
Curitiba;De 5 a menos de 10 ha;25;187;7;18;54;132;6;19;2;5;4;14;0;3;0;10;;
Curitiba;De 10 a menos de 20 ha;10;118;3;7;32;86;2;8;0;3;2;5;0;2;0;3;;
Curitiba;De 20 a menos de 50 ha;3;81;3;0;81;0;1;2;1;2;0;0;0;0;0;0;;
Curitiba;De 50 a menos de 100 ha;3;203;3;0;203;0;3;0;3;0;0;0;0;0;0;0;;
Curitiba;De 100 a menos de 200 ha;0;0;0;0;0;0;0;0;0;0;0;0;0;0;0;0;;
Curitiba;De 200 a menos de 500 ha;0;0;0;0;0;0;0;0;0;0;0;0;0;0;0;0;;
Curitiba;De 500 a menos de 1.000 ha;0;0;0;0;0;0;0;0;0;0;0;0;0;0;0;0;;
Curitiba;De 1.000 a menos de 2.500 ha;0;0;0;0;0;0;0;0;0;0;0;0;0;0;0;0;;
Curitiba;De 2.500 a menos de 10.000 ha;0;0;0;0;0;0;0;0;0;0;0;0;0;0;0;0;;
Curitiba;De 10.000 ha e mais;0;0;0;0;0;0;0;0;0;0;0;0;0;0;0;0;;
Curitiba;Produtor sem área;0;0;0;0;0;0;0;0;0;0;0;0;0;0;0;0;;
Curiúva;Mais de 0 a menos de 0,1 ha;0;0;0;0;0;0;0;0;0;0;0;0;0;0;0;0;;
Curiúva;De 0,1 a menos de 0,2 ha;1;0;0;1;0;0;0;1;0;0;0;1;0;0;0;1;;
Curiúva;De 0,2 a menos de 0,5 ha;2;0;0;2;0;0;0;2;0;0;0;2;0;0;0;2;;
Curiúva;De 0,5 a menos de 1 ha;40;24;9;31;6;19;8;32;1;8;7;24;2;3;5;11;;
Curiúva;De 1 a menos de 2 ha;32;44;5;27;6;37;10;22;1;4;9;18;0;2;2;11;;
Curiúva;De 2 a menos de 3 ha;49;120;15;34;37;83;18;31;6;9;12;22;2;5;0;15;;
Curiúva;De 3 a menos de 4 ha;34;119;12;22;43;76;13;21;5;7;8;14;1;4;1;9;;
Curiúva;De 4 a menos de 5 ha;64;306;24;40;115;191;27;37;8;16;19;21;0;9;1;10;;
Curiúva;De 5 a menos de 10 ha;195;1494;64;131;492;1002;79;116;17;47;62;69;1;40;4;38;;
Curiúva;De 10 a menos de 20 ha;175;2528;43;132;624;1904;97;78;18;25;79;53;1;18;2;23;;
Curiúva;De 20 a menos de 50 ha;170;5340;28;142;826;4515;89;81;3;25;86;56;1;20;2;35;;
Curiúva;De 50 a menos de 100 ha;71;4913;37;34;2873;2040;47;24;21;16;26;8;0;13;1;5;;
Curiúva;De 100 a menos de 200 ha;32;4608;32;0;4608;0;19;13;19;13;0;0;0;11;0;0;;
Curiúva;De 200 a menos de 500 ha;34;9455;34;0;9455;0;12;22;12;22;0;0;1;18;0;0;;
Curiúva;De 500 a menos de 1.000 ha;6;4928;6;0;4928;0;2;4;2;4;0;0;0;3;0;0;;
Curiúva;De 1.000 a menos de 2.500 ha;5;0;5;0;0;0;4;1;4;1;0;0;0;0;0;0;;
Curiúva;De 2.500 a menos de 10.000 ha;1;0;1;0;0;0;1;0;1;0;0;0;0;0;0;0;;
Curiúva;De 10.000 ha e mais;0;0;0;0;0;0;0;0;0;0;0;0;0;0;0;0;;
Curiúva;Produtor sem área;0;0;0;0;0;0;0;0;0;0;0;0;0;0;0;0;;
Diamante do Norte;Mais de 0 a menos de 0,1 ha;0;0;0;0;0;0;0;0;0;0;0;0;0;0;0;0;;
Diamante do Norte;De 0,1 a menos de 0,2 ha;0;0;0;0;0;0;0;0;0;0;0;0;0;0;0;0;;
Diamante do Norte;De 0,2 a menos de 0,5 ha;2;0;2;0;0;0;0;2;0;2;0;0;0;2;0;0;;
Diamante do Norte;De 0,5 a menos de 1 ha;37;19;17;20;9;11;2;35;1;16;1;19;0;13;0;14;;
Diamante do Norte;De 1 a menos de 2 ha;3;4;1;2;0;0;0;3;0;1;0;2;0;1;0;2;;
Diamante do Norte;De 2 a menos de 3 ha;4;10;0;4;0;10;0;4;0;0;0;4;0;0;0;3;;
Diamante do Norte;De 3 a menos de 4 ha;6;21;2;4;0;0;0;6;0;2;0;4;0;2;0;2;;
Diamante do Norte;De 4 a menos de 5 ha;10;46;2;8;0;0;2;8;0;2;2;6;0;2;0;4;;
Diamante do Norte;De 5 a menos de 10 ha;14;94;4;10;29;65;0;14;0;4;0;10;0;4;0;7;;
Diamante do Norte;De 10 a menos de 20 ha;30;436;9;21;128;309;6;24;1;8;5;16;0;8;0;7;;
Diamante do Norte;De 20 a menos de 50 ha;28;802;5;23;120;683;4;24;1;4;3;20;0;2;0;13;;
Diamante do Norte;De 50 a menos de 100 ha;17;1154;4;13;282;872;3;14;1;3;2;11;0;1;0;5;;
Diamante do Norte;De 100 a menos de 200 ha;7;1025;7;0;1025;0;2;5;2;5;0;0;0;2;0;0;;
Diamante do Norte;De 200 a menos de 500 ha;8;2818;8;0;2818;0;4;4;4;4;0;0;0;2;0;0;;
Diamante do Norte;De 500 a menos de 1.000 ha;5;3615;5;0;3615;0;2;3;2;3;0;0;0;1;0;0;;
Diamante do Norte;De 1.000 a menos de 2.500 ha;4;5012;4;0;5012;0;1;3;1;3;0;0;0;1;0;0;;
Diamante do Norte;De 2.500 a menos de 10.000 ha;1;0;1;0;0;0;0;1;0;1;0;0;0;0;0;0;;
Diamante do Norte;De 10.000 ha e mais;0;0;0;0;0;0;0;0;0;0;0;0;0;0;0;0;;
Diamante do Norte;Produtor sem área;0;0;0;0;0;0;0;0;0;0;0;0;0;0;0;0;;
Diamante do Sul;Mais de 0 a menos de 0,1 ha;1;0;1;0;0;0;1;0;1;0;0;0;0;0;0;0;;
Diamante do Sul;De 0,1 a menos de 0,2 ha;9;2;3;6;0;0;1;8;0;3;1;5;0;3;0;4;;
Diamante do Sul;De 0,2 a menos de 0,5 ha;12;4;7;5;0;0;3;9;2;5;1;4;0;4;0;3;;
Diamante do Sul;De 0,5 a menos de 1 ha;27;19;10;17;7;12;11;16;3;7;8;9;0;6;0;6;;
Diamante do Sul;De 1 a menos de 2 ha;57;79;24;33;32;47;22;35;10;14;12;21;0;11;0;14;;
Diamante do Sul;De 2 a menos de 3 ha;49;119;10;39;25;94;33;16;7;3;26;13;0;3;0;12;;
Diamante do Sul;De 3 a menos de 4 ha;30;106;10;20;34;72;19;11;5;5;14;6;0;2;0;5;;
Diamante do Sul;De 4 a menos de 5 ha;40;191;10;30;48;143;24;16;3;7;21;9;0;6;0;7;;
Diamante do Sul;De 5 a menos de 10 ha;92;698;24;68;189;510;58;34;13;11;45;23;0;8;0;17;;
Diamante do Sul;De 10 a menos de 20 ha;76;1103;12;64;173;930;51;25;6;6;45;19;0;4;0;13;;
Diamante do Sul;De 20 a menos de 50 ha;57;1717;14;43;432;1284;33;24;6;8;27;16;0;6;0;12;;
Diamante do Sul;De 50 a menos de 100 ha;37;2604;12;25;968;1636;29;8;9;3;20;5;0;1;0;4;;
Diamante do Sul;De 100 a menos de 200 ha;22;3002;22;0;3002;0;14;8;14;8;0;0;0;5;0;0;;
Diamante do Sul;De 200 a menos de 500 ha;22;7256;22;0;7256;0;21;1;21;1;0;0;0;1;0;0;;
Diamante do Sul;De 500 a menos de 1.000 ha;10;7106;10;0;7106;0;9;1;9;1;0;0;0;1;0;0;;
Diamante do Sul;De 1.000 a menos de 2.500 ha;3;0;3;0;0;0;2;1;2;1;0;0;0;1;0;0;;
Diamante do Sul;De 2.500 a menos de 10.000 ha;0;0;0;0;0;0;0;0;0;0;0;0;0;0;0;0;;
Diamante do Sul;De 10.000 ha e mais;0;0;0;0;0;0;0;0;0;0;0;0;0;0;0;0;;
Diamante do Sul;Produtor sem área;0;0;0;0;0;0;0;0;0;0;0;0;0;0;0;0;;
Diamante D'Oeste;Mais de 0 a menos de 0,1 ha;4;0;0;4;0;0;0;4;0;0;0;4;0;0;0;4;;
Diamante D'Oeste;De 0,1 a menos de 0,2 ha;7;1;2;5;0;0;0;7;0;2;0;5;0;2;1;4;;
Diamante D'Oeste;De 0,2 a menos de 0,5 ha;12;4;3;9;1;3;1;11;0;3;1;8;0;3;0;8;;
Diamante D'Oeste;De 0,5 a menos de 1 ha;26;15;5;21;3;12;6;20;0;5;6;15;2;2;6;8;;
Diamante D'Oeste;De 1 a menos de 2 ha;81;105;15;66;21;85;6;75;1;14;5;61;1;13;0;60;;
Diamante D'Oeste;De 2 a menos de 3 ha;52;124;11;41;26;98;2;50;0;11;2;39;0;11;1;36;;
Diamante D'Oeste;De 3 a menos de 4 ha;30;105;9;21;32;73;4;26;1;8;3;18;0;8;0;17;;
Diamante D'Oeste;De 4 a menos de 5 ha;44;211;11;33;53;158;13;31;4;7;9;24;1;6;0;21;;
Diamante D'Oeste;De 5 a menos de 10 ha;105;802;34;71;258;545;51;54;19;15;32;39;0;14;0;37;;
Diamante D'Oeste;De 10 a menos de 20 ha;135;2045;16;119;232;1813;81;54;10;6;71;48;1;5;10;23;;
Diamante D'Oeste;De 20 a menos de 50 ha;98;3070;14;84;437;2633;70;28;11;3;59;25;0;3;5;12;;
Diamante D'Oeste;De 50 a menos de 100 ha;45;3298;25;20;2102;1196;36;9;23;2;13;7;0;2;0;6;;
Diamante D'Oeste;De 100 a menos de 200 ha;22;3007;22;0;3007;0;20;2;20;2;0;0;0;2;0;0;;
Diamante D'Oeste;De 200 a menos de 500 ha;24;6974;23;1;0;0;20;4;20;3;0;1;0;2;0;1;;
Diamante D'Oeste;De 500 a menos de 1.000 ha;4;2341;4;0;2341;0;4;0;4;0;0;0;0;0;0;0;;
Diamante D'Oeste;De 1.000 a menos de 2.500 ha;4;5848;4;0;5848;0;3;1;3;1;0;0;0;1;0;0;;
Diamante D'Oeste;De 2.500 a menos de 10.000 ha;0;0;0;0;0;0;0;0;0;0;0;0;0;0;0;0;;
Diamante D'Oeste;De 10.000 ha e mais;0;0;0;0;0;0;0;0;0;0;0;0;0;0;0;0;;
Diamante D'Oeste;Produtor sem área;3;0;2;1;0;0;0;1;0;1;0;0;0;1;0;0;;
Dois Vizinhos;Mais de 0 a menos de 0,1 ha;23;1;13;10;1;0;2;21;1;12;1;9;1;10;0;8;;
Dois Vizinhos;De 0,1 a menos de 0,2 ha;16;2;9;7;0;0;3;13;2;7;1;6;0;6;1;4;;
Dois Vizinhos;De 0,2 a menos de 0,5 ha;50;17;14;36;4;12;6;44;2;12;4;32;0;8;3;25;;
Dois Vizinhos;De 0,5 a menos de 1 ha;114;73;47;67;30;43;43;71;18;29;25;42;0;22;1;34;;
Dois Vizinhos;De 1 a menos de 2 ha;109;149;44;65;59;90;38;71;9;35;29;36;0;32;0;28;;
Dois Vizinhos;De 2 a menos de 3 ha;99;240;26;73;63;177;50;49;10;16;40;33;1;11;0;20;;
Dois Vizinhos;De 3 a menos de 4 ha;146;497;38;108;134;363;87;59;20;18;67;41;1;12;1;28;;
Dois Vizinhos;De 4 a menos de 5 ha;152;720;37;115;174;546;95;57;15;22;80;35;0;18;0;30;;
Dois Vizinhos;De 5 a menos de 10 ha;414;3142;60;354;442;2700;304;110;37;23;267;87;0;20;2;64;;
Dois Vizinhos;De 10 a menos de 20 ha;371;5327;26;345;368;4959;324;47;18;8;306;39;0;8;1;25;;
Dois Vizinhos;De 20 a menos de 50 ha;254;7813;30;224;997;6816;243;11;28;2;215;9;0;2;0;5;;
Dois Vizinhos;De 50 a menos de 100 ha;76;5292;28;48;2268;3024;73;3;25;3;48;0;0;1;0;0;;
Dois Vizinhos;De 100 a menos de 200 ha;30;4293;30;0;4293;0;29;1;29;1;0;0;0;1;0;0;;
Dois Vizinhos;De 200 a menos de 500 ha;18;4821;18;0;4821;0;15;3;15;3;0;0;0;3;0;0;;
Dois Vizinhos;De 500 a menos de 1.000 ha;4;0;4;0;0;0;4;0;4;0;0;0;0;0;0;0;;
Dois Vizinhos;De 1.000 a menos de 2.500 ha;0;0;0;0;0;0;0;0;0;0;0;0;0;0;0;0;;
Dois Vizinhos;De 2.500 a menos de 10.000 ha;0;0;0;0;0;0;0;0;0;0;0;0;0;0;0;0;;
Dois Vizinhos;De 10.000 ha e mais;0;0;0;0;0;0;0;0;0;0;0;0;0;0;0;0;;
Dois Vizinhos;Produtor sem área;4;0;2;2;0;0;0;0;0;0;0;0;0;0;0;0;;
Douradina;Mais de 0 a menos de 0,1 ha;3;0;1;2;0;0;0;3;0;1;0;2;1;0;0;2;;
Douradina;De 0,1 a menos de 0,2 ha;4;0;1;3;0;0;0;4;0;1;0;3;0;1;0;3;;
Douradina;De 0,2 a menos de 0,5 ha;3;1;0;3;0;1;0;3;0;0;0;3;0;0;0;3;;
Douradina;De 0,5 a menos de 1 ha;39;21;18;21;10;11;9;30;4;14;5;16;1;10;2;12;;
Douradina;De 1 a menos de 2 ha;7;9;5;2;0;0;2;5;2;3;0;2;0;2;0;0;;
Douradina;De 2 a menos de 3 ha;30;72;15;15;36;36;5;25;1;14;4;11;0;14;0;11;;
Douradina;De 3 a menos de 4 ha;24;85;4;20;14;71;0;24;0;4;0;20;0;3;0;17;;
Douradina;De 4 a menos de 5 ha;37;176;13;24;62;114;6;31;5;8;1;23;0;8;1;19;;
Douradina;De 5 a menos de 10 ha;54;399;12;42;89;310;10;44;3;9;7;35;0;7;0;28;;
Douradina;De 10 a menos de 20 ha;122;1616;30;92;382;1234;36;86;12;18;24;68;1;14;1;55;;
Douradina;De 20 a menos de 50 ha;94;2984;20;74;684;2300;24;70;6;14;18;56;1;10;1;36;;
Douradina;De 50 a menos de 100 ha;28;2004;8;20;748;1256;12;16;2;6;10;10;0;5;0;6;;
Douradina;De 100 a menos de 200 ha;22;3092;22;0;3092;0;7;15;7;15;0;0;0;10;0;0;;
Douradina;De 200 a menos de 500 ha;25;7203;25;0;7203;0;2;23;2;23;0;0;0;12;0;0;;
Douradina;De 500 a menos de 1.000 ha;10;6237;10;0;6237;0;4;6;4;6;0;0;0;2;0;0;;
Douradina;De 1.000 a menos de 2.500 ha;7;8942;7;0;8942;0;4;3;4;3;0;0;0;2;0;0;;
Douradina;De 2.500 a menos de 10.000 ha;2;0;2;0;0;0;1;1;1;1;0;0;0;1;0;0;;
Douradina;De 10.000 ha e mais;0;0;0;0;0;0;0;0;0;0;0;0;0;0;0;0;;
Douradina;Produtor sem área;1;0;0;1;0;0;0;1;0;0;0;1;0;0;0;1;;
Doutor Camargo;Mais de 0 a menos de 0,1 ha;1;0;0;1;0;0;1;0;0;0;1;0;0;0;0;0;;
Doutor Camargo;De 0,1 a menos de 0,2 ha;1;0;0;1;0;0;0;1;0;0;0;1;0;0;0;1;;
Doutor Camargo;De 0,2 a menos de 0,5 ha;2;0;1;1;0;0;1;1;0;1;1;0;0;0;0;0;;
Doutor Camargo;De 0,5 a menos de 1 ha;3;0;0;3;0;0;0;3;0;0;0;3;0;0;0;0;;
Doutor Camargo;De 1 a menos de 2 ha;11;15;1;10;0;0;6;5;1;0;5;5;0;0;0;5;;
Doutor Camargo;De 2 a menos de 3 ha;8;20;4;4;10;10;2;6;1;3;1;3;0;3;0;2;;
Doutor Camargo;De 3 a menos de 4 ha;17;57;3;14;0;0;11;6;2;1;9;5;0;1;0;4;;
Doutor Camargo;De 4 a menos de 5 ha;22;105;2;20;0;0;18;4;1;1;17;3;0;1;0;2;;
Doutor Camargo;De 5 a menos de 10 ha;57;432;0;57;0;432;51;6;0;0;51;6;0;0;1;3;;
Doutor Camargo;De 10 a menos de 20 ha;42;597;3;39;42;555;41;1;3;0;38;1;0;0;0;1;;
Doutor Camargo;De 20 a menos de 50 ha;73;2329;2;71;0;0;71;2;2;0;69;2;0;0;0;2;;
Doutor Camargo;De 50 a menos de 100 ha;30;2041;17;13;1306;734;30;0;17;0;13;0;0;0;0;0;;
Doutor Camargo;De 100 a menos de 200 ha;19;2796;19;0;2796;0;18;1;18;1;0;0;0;1;0;0;;
Doutor Camargo;De 200 a menos de 500 ha;2;0;2;0;0;0;2;0;2;0;0;0;0;0;0;0;;
Doutor Camargo;De 500 a menos de 1.000 ha;0;0;0;0;0;0;0;0;0;0;0;0;0;0;0;0;;
Doutor Camargo;De 1.000 a menos de 2.500 ha;0;0;0;0;0;0;0;0;0;0;0;0;0;0;0;0;;
Doutor Camargo;De 2.500 a menos de 10.000 ha;0;0;0;0;0;0;0;0;0;0;0;0;0;0;0;0;;
Doutor Camargo;De 10.000 ha e mais;0;0;0;0;0;0;0;0;0;0;0;0;0;0;0;0;;
Doutor Camargo;Produtor sem área;0;0;0;0;0;0;0;0;0;0;0;0;0;0;0;0;;
Enéas Marques;Mais de 0 a menos de 0,1 ha;12;1;7;5;0;0;4;8;3;4;1;4;0;1;0;2;;
Enéas Marques;De 0,1 a menos de 0,2 ha;11;1;9;2;0;0;3;8;3;6;0;2;0;4;0;1;;
Enéas Marques;De 0,2 a menos de 0,5 ha;15;4;9;6;2;2;7;8;5;4;2;4;0;4;0;3;;
Enéas Marques;De 0,5 a menos de 1 ha;31;20;17;14;11;9;14;17;9;8;5;9;0;6;0;9;;
Enéas Marques;De 1 a menos de 2 ha;38;50;20;18;25;25;28;10;15;5;13;5;0;2;0;3;;
Enéas Marques;De 2 a menos de 3 ha;35;86;12;23;29;57;23;12;8;4;15;8;0;3;0;4;;
Enéas Marques;De 3 a menos de 4 ha;63;213;13;50;45;168;51;12;11;2;40;10;0;2;0;7;;
Enéas Marques;De 4 a menos de 5 ha;86;405;18;68;85;320;70;16;14;4;56;12;0;1;0;8;;
Enéas Marques;De 5 a menos de 10 ha;205;1560;44;161;328;1232;176;29;36;8;140;21;0;3;0;17;;
Enéas Marques;De 10 a menos de 20 ha;199;2905;28;171;398;2507;187;12;27;1;160;11;0;1;0;10;;
Enéas Marques;De 20 a menos de 50 ha;158;4635;16;142;477;4158;145;13;12;4;133;9;0;3;0;5;;
Enéas Marques;De 50 a menos de 100 ha;34;2323;17;17;1292;1031;29;5;14;3;15;2;0;2;0;0;;
Enéas Marques;De 100 a menos de 200 ha;13;1804;13;0;1804;0;9;4;9;4;0;0;0;4;0;0;;
Enéas Marques;De 200 a menos de 500 ha;5;1336;5;0;1336;0;5;0;5;0;0;0;0;0;0;0;;
Enéas Marques;De 500 a menos de 1.000 ha;1;0;1;0;0;0;1;0;1;0;0;0;0;0;0;0;;
Enéas Marques;De 1.000 a menos de 2.500 ha;0;0;0;0;0;0;0;0;0;0;0;0;0;0;0;0;;
Enéas Marques;De 2.500 a menos de 10.000 ha;0;0;0;0;0;0;0;0;0;0;0;0;0;0;0;0;;
Enéas Marques;De 10.000 ha e mais;0;0;0;0;0;0;0;0;0;0;0;0;0;0;0;0;;
Enéas Marques;Produtor sem área;4;0;3;1;0;0;1;3;1;2;0;1;0;0;0;0;;
Engenheiro Beltrão;Mais de 0 a menos de 0,1 ha;1;0;0;1;0;0;0;1;0;0;0;1;0;0;0;1;;
Engenheiro Beltrão;De 0,1 a menos de 0,2 ha;2;0;0;2;0;0;0;2;0;0;0;2;0;0;0;2;;
Engenheiro Beltrão;De 0,2 a menos de 0,5 ha;5;1;0;5;0;1;1;4;0;0;1;4;0;0;0;3;;
Engenheiro Beltrão;De 0,5 a menos de 1 ha;29;16;12;17;7;9;17;12;6;6;11;6;0;4;0;6;;
Engenheiro Beltrão;De 1 a menos de 2 ha;20;26;9;11;11;15;8;12;5;4;3;8;0;3;0;7;;
Engenheiro Beltrão;De 2 a menos de 3 ha;25;61;2;23;0;0;16;9;0;2;16;7;0;1;0;5;;
Engenheiro Beltrão;De 3 a menos de 4 ha;23;78;2;21;0;0;7;16;1;1;6;15;0;1;0;15;;
Engenheiro Beltrão;De 4 a menos de 5 ha;17;80;2;15;0;0;10;7;1;1;9;6;0;1;0;5;;
Engenheiro Beltrão;De 5 a menos de 10 ha;54;384;6;48;43;341;36;18;1;5;35;13;0;2;1;10;;
Engenheiro Beltrão;De 10 a menos de 20 ha;79;1157;2;77;0;0;61;18;0;2;61;16;0;1;0;14;;
Engenheiro Beltrão;De 20 a menos de 50 ha;101;3312;7;94;235;3077;90;11;6;1;84;10;0;0;0;8;;
Engenheiro Beltrão;De 50 a menos de 100 ha;92;6964;49;43;4171;2793;86;6;46;3;40;3;0;2;0;2;;
Engenheiro Beltrão;De 100 a menos de 200 ha;37;5523;37;0;5523;0;35;2;35;2;0;0;0;2;0;0;;
Engenheiro Beltrão;De 200 a menos de 500 ha;45;13611;45;0;13611;0;44;1;44;1;0;0;0;1;0;0;;
Engenheiro Beltrão;De 500 a menos de 1.000 ha;9;5806;9;0;5806;0;9;0;9;0;0;0;0;0;0;0;;
Engenheiro Beltrão;De 1.000 a menos de 2.500 ha;1;0;1;0;0;0;1;0;1;0;0;0;0;0;0;0;;
Engenheiro Beltrão;De 2.500 a menos de 10.000 ha;1;0;1;0;0;0;1;0;1;0;0;0;0;0;0;0;;
Engenheiro Beltrão;De 10.000 ha e mais;0;0;0;0;0;0;0;0;0;0;0;0;0;0;0;0;;
Engenheiro Beltrão;Produtor sem área;2;0;1;1;0;0;0;0;0;0;0;0;0;0;0;0;;
Esperança Nova;Mais de 0 a menos de 0,1 ha;2;0;1;1;0;0;0;2;0;1;0;1;0;1;0;1;;
Esperança Nova;De 0,1 a menos de 0,2 ha;0;0;0;0;0;0;0;0;0;0;0;0;0;0;0;0;;
Esperança Nova;De 0,2 a menos de 0,5 ha;2;0;0;2;0;0;0;2;0;0;0;2;0;0;0;0;;
Esperança Nova;De 0,5 a menos de 1 ha;13;7;4;9;0;0;0;13;0;4;0;9;0;3;2;7;;
Esperança Nova;De 1 a menos de 2 ha;7;10;2;5;0;0;3;4;1;1;2;3;0;0;0;3;;
Esperança Nova;De 2 a menos de 3 ha;6;15;2;4;0;0;1;5;1;1;0;4;0;1;0;1;;
Esperança Nova;De 3 a menos de 4 ha;13;44;1;12;0;0;2;11;0;1;2;10;0;0;0;7;;
Esperança Nova;De 4 a menos de 5 ha;16;76;4;12;19;57;1;15;0;4;1;11;0;3;0;6;;
Esperança Nova;De 5 a menos de 10 ha;61;455;8;53;57;399;7;54;1;7;6;47;0;5;2;27;;
Esperança Nova;De 10 a menos de 20 ha;94;1373;17;77;232;1140;10;84;0;17;10;67;0;10;1;33;;
Esperança Nova;De 20 a menos de 50 ha;85;2660;9;76;271;2389;5;80;1;8;4;72;0;4;0;41;;
Esperança Nova;De 50 a menos de 100 ha;26;1833;11;15;848;985;3;23;3;8;0;15;0;5;0;7;;
Esperança Nova;De 100 a menos de 200 ha;15;2121;15;0;2121;0;1;14;1;14;0;0;0;10;0;0;;
Esperança Nova;De 200 a menos de 500 ha;8;2342;8;0;2342;0;3;5;3;5;0;0;0;3;0;0;;
Esperança Nova;De 500 a menos de 1.000 ha;3;2219;3;0;2219;0;0;3;0;3;0;0;0;0;0;0;;
Esperança Nova;De 1.000 a menos de 2.500 ha;0;0;0;0;0;0;0;0;0;0;0;0;0;0;0;0;;
Esperança Nova;De 2.500 a menos de 10.000 ha;0;0;0;0;0;0;0;0;0;0;0;0;0;0;0;0;;
Esperança Nova;De 10.000 ha e mais;0;0;0;0;0;0;0;0;0;0;0;0;0;0;0;0;;
Esperança Nova;Produtor sem área;1;0;1;0;0;0;0;0;0;0;0;0;0;0;0;0;;
Entre Rios do Oeste;Mais de 0 a menos de 0,1 ha;5;0;0;5;0;0;0;5;0;0;0;5;0;0;0;4;;
Entre Rios do Oeste;De 0,1 a menos de 0,2 ha;2;0;0;2;0;0;0;2;0;0;0;2;0;0;1;1;;
Entre Rios do Oeste;De 0,2 a menos de 0,5 ha;0;0;0;0;0;0;0;0;0;0;0;0;0;0;0;0;;
Entre Rios do Oeste;De 0,5 a menos de 1 ha;3;2;0;3;0;2;0;3;0;0;0;3;0;0;1;2;;
Entre Rios do Oeste;De 1 a menos de 2 ha;7;7;0;7;0;7;1;6;0;0;1;6;0;0;2;4;;
Entre Rios do Oeste;De 2 a menos de 3 ha;15;36;2;13;0;0;6;9;0;2;6;7;1;1;0;6;;
Entre Rios do Oeste;De 3 a menos de 4 ha;19;66;1;18;0;0;12;7;1;0;11;7;0;0;1;5;;
Entre Rios do Oeste;De 4 a menos de 5 ha;13;60;1;12;0;0;6;7;0;1;6;6;1;0;1;3;;
Entre Rios do Oeste;De 5 a menos de 10 ha;68;474;5;63;36;438;48;20;4;1;44;19;0;1;4;8;;
Entre Rios do Oeste;De 10 a menos de 20 ha;84;1221;2;82;0;0;76;8;1;1;75;7;0;0;0;3;;
Entre Rios do Oeste;De 20 a menos de 50 ha;63;1854;0;63;0;1854;56;7;0;0;56;7;0;0;0;2;;
Entre Rios do Oeste;De 50 a menos de 100 ha;22;1526;10;12;823;703;21;1;9;1;12;0;0;0;0;0;;
Entre Rios do Oeste;De 100 a menos de 200 ha;6;744;6;0;744;0;6;0;6;0;0;0;0;0;0;0;;
Entre Rios do Oeste;De 200 a menos de 500 ha;6;1553;6;0;1553;0;6;0;6;0;0;0;0;0;0;0;;
Entre Rios do Oeste;De 500 a menos de 1.000 ha;0;0;0;0;0;0;0;0;0;0;0;0;0;0;0;0;;
Entre Rios do Oeste;De 1.000 a menos de 2.500 ha;0;0;0;0;0;0;0;0;0;0;0;0;0;0;0;0;;
Entre Rios do Oeste;De 2.500 a menos de 10.000 ha;0;0;0;0;0;0;0;0;0;0;0;0;0;0;0;0;;
Entre Rios do Oeste;De 10.000 ha e mais;0;0;0;0;0;0;0;0;0;0;0;0;0;0;0;0;;
Entre Rios do Oeste;Produtor sem área;3;0;0;3;0;0;0;0;0;0;0;0;0;0;0;0;;
Espigão Alto do Iguaçu;Mais de 0 a menos de 0,1 ha;3;0;0;3;0;0;0;3;0;0;0;3;0;0;0;3;;
Espigão Alto do Iguaçu;De 0,1 a menos de 0,2 ha;19;3;7;12;1;2;3;16;0;7;3;9;1;5;0;7;;
Espigão Alto do Iguaçu;De 0,2 a menos de 0,5 ha;20;6;1;19;0;0;5;15;1;0;4;15;0;0;1;14;;
Espigão Alto do Iguaçu;De 0,5 a menos de 1 ha;20;13;2;18;0;0;2;18;0;2;2;16;0;2;0;13;;
Espigão Alto do Iguaçu;De 1 a menos de 2 ha;27;35;6;21;7;28;4;23;0;6;4;17;0;3;0;15;;
Espigão Alto do Iguaçu;De 2 a menos de 3 ha;35;84;7;28;17;67;20;15;4;3;16;12;0;2;1;8;;
Espigão Alto do Iguaçu;De 3 a menos de 4 ha;33;116;8;25;28;88;21;12;3;5;18;7;0;3;2;3;;
Espigão Alto do Iguaçu;De 4 a menos de 5 ha;39;186;8;31;38;148;30;9;7;1;23;8;0;1;0;5;;
Espigão Alto do Iguaçu;De 5 a menos de 10 ha;97;741;14;83;103;638;88;9;10;4;78;5;0;3;1;4;;
Espigão Alto do Iguaçu;De 10 a menos de 20 ha;170;2471;19;151;276;2196;158;12;13;6;145;6;0;3;0;1;;
Espigão Alto do Iguaçu;De 20 a menos de 50 ha;141;4192;5;136;152;4039;136;5;5;0;131;5;0;0;0;4;;
Espigão Alto do Iguaçu;De 50 a menos de 100 ha;35;2493;15;20;1266;1227;33;2;13;2;20;0;0;2;0;0;;
Espigão Alto do Iguaçu;De 100 a menos de 200 ha;19;2791;19;0;2791;0;18;1;18;1;0;0;0;1;0;0;;
Espigão Alto do Iguaçu;De 200 a menos de 500 ha;11;3572;11;0;3572;0;11;0;11;0;0;0;0;0;0;0;;
Espigão Alto do Iguaçu;De 500 a menos de 1.000 ha;4;3269;4;0;3269;0;2;2;2;2;0;0;0;2;0;0;;
Espigão Alto do Iguaçu;De 1.000 a menos de 2.500 ha;1;0;1;0;0;0;1;0;1;0;0;0;0;0;0;0;;
Espigão Alto do Iguaçu;De 2.500 a menos de 10.000 ha;0;0;0;0;0;0;0;0;0;0;0;0;0;0;0;0;;
Espigão Alto do Iguaçu;De 10.000 ha e mais;0;0;0;0;0;0;0;0;0;0;0;0;0;0;0;0;;
Espigão Alto do Iguaçu;Produtor sem área;0;0;0;0;0;0;0;0;0;0;0;0;0;0;0;0;;
Farol;Mais de 0 a menos de 0,1 ha;0;0;0;0;0;0;0;0;0;0;0;0;0;0;0;0;;
Farol;De 0,1 a menos de 0,2 ha;0;0;0;0;0;0;0;0;0;0;0;0;0;0;0;0;;
Farol;De 0,2 a menos de 0,5 ha;0;0;0;0;0;0;0;0;0;0;0;0;0;0;0;0;;
Farol;De 0,5 a menos de 1 ha;15;8;5;10;3;5;8;7;2;3;6;4;0;1;0;2;;
Farol;De 1 a menos de 2 ha;11;14;4;7;6;9;3;8;1;3;2;5;0;2;0;4;;
Farol;De 2 a menos de 3 ha;7;0;4;3;10;0;2;5;2;2;0;3;0;1;0;3;;
Farol;De 3 a menos de 4 ha;13;44;3;10;10;33;5;8;1;2;4;6;0;2;1;4;;
Farol;De 4 a menos de 5 ha;15;70;7;8;33;37;9;6;4;3;5;3;0;3;0;3;;
Farol;De 5 a menos de 10 ha;47;391;3;44;21;370;27;20;2;1;25;19;0;0;0;13;;
Farol;De 10 a menos de 20 ha;45;595;4;41;46;549;34;11;2;2;32;9;0;2;0;6;;
Farol;De 20 a menos de 50 ha;42;1314;1;41;0;0;36;6;1;0;35;6;0;0;2;0;;
Farol;De 50 a menos de 100 ha;28;1969;15;13;1211;757;27;1;14;1;13;0;0;1;0;0;;
Farol;De 100 a menos de 200 ha;23;3267;23;0;3267;0;23;0;23;0;0;0;0;0;0;0;;
Farol;De 200 a menos de 500 ha;21;6535;21;0;6535;0;21;0;21;0;0;0;0;0;0;0;;
Farol;De 500 a menos de 1.000 ha;12;7864;12;0;7864;0;12;0;12;0;0;0;0;0;0;0;;
Farol;De 1.000 a menos de 2.500 ha;3;0;3;0;0;0;3;0;3;0;0;0;0;0;0;0;;
Farol;De 2.500 a menos de 10.000 ha;0;0;0;0;0;0;0;0;0;0;0;0;0;0;0;0;;
Farol;De 10.000 ha e mais;0;0;0;0;0;0;0;0;0;0;0;0;0;0;0;0;;
Farol;Produtor sem área;0;0;0;0;0;0;0;0;0;0;0;0;0;0;0;0;;
Faxinal;Mais de 0 a menos de 0,1 ha;2;0;0;2;0;0;0;2;0;0;0;2;0;0;0;2;;
Faxinal;De 0,1 a menos de 0,2 ha;4;0;2;2;0;0;2;2;0;2;2;0;0;1;0;0;;
Faxinal;De 0,2 a menos de 0,5 ha;23;7;2;21;0;0;19;4;2;0;17;4;0;0;0;4;;
Faxinal;De 0,5 a menos de 1 ha;26;17;2;24;0;0;21;5;1;1;20;4;0;1;0;4;;
Faxinal;De 1 a menos de 2 ha;35;46;7;28;11;36;26;9;5;2;21;7;0;2;0;7;;
Faxinal;De 2 a menos de 3 ha;35;84;9;26;21;63;24;11;7;2;17;9;0;2;0;6;;
Faxinal;De 3 a menos de 4 ha;20;70;3;17;11;60;12;8;1;2;11;6;0;2;0;6;;
Faxinal;De 4 a menos de 5 ha;29;140;7;22;34;106;15;14;1;6;14;8;0;6;1;7;;
Faxinal;De 5 a menos de 10 ha;79;600;25;54;194;407;56;23;16;9;40;14;1;8;0;12;;
Faxinal;De 10 a menos de 20 ha;83;1206;11;72;143;1063;65;18;8;3;57;15;0;3;1;10;;
Faxinal;De 20 a menos de 50 ha;61;2048;10;51;328;1720;43;18;8;2;35;16;0;1;0;15;;
Faxinal;De 50 a menos de 100 ha;25;1868;16;9;1329;539;17;8;11;5;6;3;0;5;0;3;;
Faxinal;De 100 a menos de 200 ha;47;7170;47;0;7170;0;35;12;35;12;0;0;0;10;0;0;;
Faxinal;De 200 a menos de 500 ha;43;13872;43;0;13872;0;30;13;30;13;0;0;0;12;0;0;;
Faxinal;De 500 a menos de 1.000 ha;18;12140;18;0;12140;0;16;2;16;2;0;0;0;2;0;0;;
Faxinal;De 1.000 a menos de 2.500 ha;7;9208;7;0;9208;0;6;1;6;1;0;0;0;1;0;0;;
Faxinal;De 2.500 a menos de 10.000 ha;0;0;0;0;0;0;0;0;0;0;0;0;0;0;0;0;;
Faxinal;De 10.000 ha e mais;0;0;0;0;0;0;0;0;0;0;0;0;0;0;0;0;;
Faxinal;Produtor sem área;2;0;0;2;0;0;0;1;0;0;0;1;0;0;0;1;;
Fazenda Rio Grande;Mais de 0 a menos de 0,1 ha;1;0;0;1;0;0;0;1;0;0;0;1;0;0;0;1;;
Fazenda Rio Grande;De 0,1 a menos de 0,2 ha;1;0;0;1;0;0;0;1;0;0;0;1;0;0;1;0;;
Fazenda Rio Grande;De 0,2 a menos de 0,5 ha;7;2;1;6;0;0;0;7;0;1;0;6;1;0;1;1;;
Fazenda Rio Grande;De 0,5 a menos de 1 ha;10;7;3;7;2;5;2;8;1;2;1;6;0;1;0;1;;
Fazenda Rio Grande;De 1 a menos de 2 ha;16;21;4;12;5;17;5;11;1;3;4;8;0;1;2;1;;
Fazenda Rio Grande;De 2 a menos de 3 ha;12;28;4;8;9;18;1;11;1;3;0;8;0;2;3;3;;
Fazenda Rio Grande;De 3 a menos de 4 ha;10;33;2;8;0;0;5;5;1;1;4;4;0;0;2;1;;
Fazenda Rio Grande;De 4 a menos de 5 ha;7;34;1;6;0;0;3;4;1;0;2;4;0;0;0;0;;
Fazenda Rio Grande;De 5 a menos de 10 ha;33;245;5;28;37;208;14;19;0;5;14;14;1;4;3;3;;
Fazenda Rio Grande;De 10 a menos de 20 ha;22;310;3;19;46;264;12;10;1;2;11;8;0;0;2;1;;
Fazenda Rio Grande;De 20 a menos de 50 ha;13;437;5;8;230;208;10;3;2;3;8;0;0;2;0;0;;
Fazenda Rio Grande;De 50 a menos de 100 ha;0;0;0;0;0;0;0;0;0;0;0;0;0;0;0;0;;
Fazenda Rio Grande;De 100 a menos de 200 ha;2;0;2;0;0;0;1;1;1;1;0;0;0;0;0;0;;
Fazenda Rio Grande;De 200 a menos de 500 ha;0;0;0;0;0;0;0;0;0;0;0;0;0;0;0;0;;
Fazenda Rio Grande;De 500 a menos de 1.000 ha;0;0;0;0;0;0;0;0;0;0;0;0;0;0;0;0;;
Fazenda Rio Grande;De 1.000 a menos de 2.500 ha;0;0;0;0;0;0;0;0;0;0;0;0;0;0;0;0;;
Fazenda Rio Grande;De 2.500 a menos de 10.000 ha;0;0;0;0;0;0;0;0;0;0;0;0;0;0;0;0;;
Fazenda Rio Grande;De 10.000 ha e mais;0;0;0;0;0;0;0;0;0;0;0;0;0;0;0;0;;
Fazenda Rio Grande;Produtor sem área;0;0;0;0;0;0;0;0;0;0;0;0;0;0;0;0;;
Fênix;Mais de 0 a menos de 0,1 ha;0;0;0;0;0;0;0;0;0;0;0;0;0;0;0;0;;
Fênix;De 0,1 a menos de 0,2 ha;0;0;0;0;0;0;0;0;0;0;0;0;0;0;0;0;;
Fênix;De 0,2 a menos de 0,5 ha;1;0;0;1;0;0;1;0;0;0;1;0;0;0;0;0;;
Fênix;De 0,5 a menos de 1 ha;48;24;2;46;0;0;37;11;2;0;35;11;0;0;0;4;;
Fênix;De 1 a menos de 2 ha;8;0;0;8;0;0;5;3;0;0;5;3;0;0;0;3;;
Fênix;De 2 a menos de 3 ha;10;25;1;9;0;0;4;6;0;1;4;5;0;1;1;3;;
Fênix;De 3 a menos de 4 ha;18;62;5;13;16;46;13;5;5;0;8;5;0;0;0;3;;
Fênix;De 4 a menos de 5 ha;11;53;1;10;0;0;7;4;1;0;6;4;0;0;0;3;;
Fênix;De 5 a menos de 10 ha;53;391;6;47;45;346;44;9;6;0;38;9;0;0;0;6;;
Fênix;De 10 a menos de 20 ha;46;641;0;46;0;641;44;2;0;0;44;2;0;0;0;2;;
Fênix;De 20 a menos de 50 ha;46;1540;4;42;135;1406;41;5;3;1;38;4;0;0;0;3;;
Fênix;De 50 a menos de 100 ha;30;2230;12;18;1053;1177;29;1;11;1;18;0;0;1;0;0;;
Fênix;De 100 a menos de 200 ha;27;4175;27;0;4175;0;27;0;27;0;0;0;0;0;0;0;;
Fênix;De 200 a menos de 500 ha;18;5033;18;0;5033;0;18;0;18;0;0;0;0;0;0;0;;
Fênix;De 500 a menos de 1.000 ha;4;2773;4;0;2773;0;4;0;4;0;0;0;0;0;0;0;;
Fênix;De 1.000 a menos de 2.500 ha;2;0;2;0;0;0;2;0;2;0;0;0;0;0;0;0;;
Fênix;De 2.500 a menos de 10.000 ha;0;0;0;0;0;0;0;0;0;0;0;0;0;0;0;0;;
Fênix;De 10.000 ha e mais;0;0;0;0;0;0;0;0;0;0;0;0;0;0;0;0;;
Fênix;Produtor sem área;0;0;0;0;0;0;0;0;0;0;0;0;0;0;0;0;;
Fernandes Pinheiro;Mais de 0 a menos de 0,1 ha;2;0;0;2;0;0;0;2;0;0;0;2;0;0;0;2;;
Fernandes Pinheiro;De 0,1 a menos de 0,2 ha;1;0;0;1;0;0;0;1;0;0;0;1;0;0;0;1;;
Fernandes Pinheiro;De 0,2 a menos de 0,5 ha;6;3;0;6;0;3;1;5;0;0;1;5;0;0;0;4;;
Fernandes Pinheiro;De 0,5 a menos de 1 ha;16;12;2;14;0;0;5;11;0;2;5;9;0;1;0;7;;
Fernandes Pinheiro;De 1 a menos de 2 ha;38;56;3;35;4;52;21;17;1;2;20;15;0;0;0;11;;
Fernandes Pinheiro;De 2 a menos de 3 ha;47;116;4;43;10;105;31;16;1;3;30;13;0;1;0;11;;
Fernandes Pinheiro;De 3 a menos de 4 ha;42;148;8;34;27;120;29;13;4;4;25;9;0;2;0;5;;
Fernandes Pinheiro;De 4 a menos de 5 ha;39;183;9;30;41;142;26;13;4;5;22;8;0;5;0;5;;
Fernandes Pinheiro;De 5 a menos de 10 ha;84;630;5;79;41;589;62;22;2;3;60;19;1;2;1;11;;
Fernandes Pinheiro;De 10 a menos de 20 ha;86;1196;8;78;104;1092;66;20;6;2;60;18;0;2;3;10;;
Fernandes Pinheiro;De 20 a menos de 50 ha;62;2013;4;58;133;1880;53;9;1;3;52;6;0;3;0;4;;
Fernandes Pinheiro;De 50 a menos de 100 ha;49;3522;31;18;2517;1005;45;4;28;3;17;1;0;2;0;0;;
Fernandes Pinheiro;De 100 a menos de 200 ha;20;2882;19;1;0;0;16;4;16;3;0;1;0;2;0;1;;
Fernandes Pinheiro;De 200 a menos de 500 ha;21;6191;21;0;6191;0;18;3;18;3;0;0;0;2;0;0;;
Fernandes Pinheiro;De 500 a menos de 1.000 ha;3;2184;3;0;2184;0;3;0;3;0;0;0;0;0;0;0;;
Fernandes Pinheiro;De 1.000 a menos de 2.500 ha;4;5998;4;0;5998;0;4;0;4;0;0;0;0;0;0;0;;
Fernandes Pinheiro;De 2.500 a menos de 10.000 ha;1;0;1;0;0;0;1;0;1;0;0;0;0;0;0;0;;
Fernandes Pinheiro;De 10.000 ha e mais;0;0;0;0;0;0;0;0;0;0;0;0;0;0;0;0;;
Fernandes Pinheiro;Produtor sem área;0;0;0;0;0;0;0;0;0;0;0;0;0;0;0;0;;
Figueira;Mais de 0 a menos de 0,1 ha;10;1;3;7;0;0;0;10;0;3;0;7;0;3;0;7;;
Figueira;De 0,1 a menos de 0,2 ha;15;2;5;10;1;1;0;15;0;5;0;10;0;5;0;10;;
Figueira;De 0,2 a menos de 0,5 ha;23;7;11;12;3;3;0;23;0;11;0;12;0;10;0;11;;
Figueira;De 0,5 a menos de 1 ha;25;14;9;16;5;9;1;24;0;9;1;15;0;7;0;14;;
Figueira;De 1 a menos de 2 ha;18;22;6;12;7;15;2;16;1;5;1;11;0;3;0;7;;
Figueira;De 2 a menos de 3 ha;25;61;5;20;13;48;5;20;0;5;5;15;0;4;0;9;;
Figueira;De 3 a menos de 4 ha;9;31;1;8;0;0;1;8;0;1;1;7;0;1;0;4;;
Figueira;De 4 a menos de 5 ha;25;120;7;18;33;87;5;20;2;5;3;15;0;4;0;9;;
Figueira;De 5 a menos de 10 ha;47;381;14;33;115;265;17;30;1;13;16;17;0;12;1;13;;
Figueira;De 10 a menos de 20 ha;54;752;5;49;71;681;12;42;2;3;10;39;0;2;2;29;;
Figueira;De 20 a menos de 50 ha;35;1005;10;25;312;693;10;25;3;7;7;18;0;5;0;12;;
Figueira;De 50 a menos de 100 ha;11;742;5;6;0;0;2;9;1;4;1;5;0;2;0;2;;
Figueira;De 100 a menos de 200 ha;16;2031;16;0;2031;0;6;10;6;10;0;0;0;9;0;0;;
Figueira;De 200 a menos de 500 ha;9;3238;9;0;3238;0;7;2;7;2;0;0;0;2;0;0;;
Figueira;De 500 a menos de 1.000 ha;1;0;1;0;0;0;0;1;0;1;0;0;0;0;0;0;;
Figueira;De 1.000 a menos de 2.500 ha;1;0;1;0;0;0;1;0;1;0;0;0;0;0;0;0;;
Figueira;De 2.500 a menos de 10.000 ha;0;0;0;0;0;0;0;0;0;0;0;0;0;0;0;0;;
Figueira;De 10.000 ha e mais;0;0;0;0;0;0;0;0;0;0;0;0;0;0;0;0;;
Figueira;Produtor sem área;2;0;1;1;0;0;0;0;0;0;0;0;0;0;0;0;;
Floraí;Mais de 0 a menos de 0,1 ha;9;0;2;7;0;0;2;7;1;1;1;6;0;1;0;6;;
Floraí;De 0,1 a menos de 0,2 ha;1;0;1;0;0;0;0;1;0;1;0;0;0;1;0;0;;
Floraí;De 0,2 a menos de 0,5 ha;2;0;0;2;0;0;0;2;0;0;0;2;0;0;0;1;;
Floraí;De 0,5 a menos de 1 ha;4;3;1;3;0;0;3;1;1;0;2;1;0;0;0;1;;
Floraí;De 1 a menos de 2 ha;12;17;4;8;5;12;6;6;2;2;4;4;0;2;0;4;;
Floraí;De 2 a menos de 3 ha;5;12;1;4;0;0;3;2;0;1;3;1;0;1;0;0;;
Floraí;De 3 a menos de 4 ha;7;25;1;6;0;0;4;3;1;0;3;3;0;0;0;3;;
Floraí;De 4 a menos de 5 ha;11;52;4;7;0;0;4;7;1;3;3;4;0;3;0;3;;
Floraí;De 5 a menos de 10 ha;17;140;3;14;22;118;8;9;1;2;7;7;0;2;0;3;;
Floraí;De 10 a menos de 20 ha;32;446;6;26;91;355;19;13;2;4;17;9;0;3;0;7;;
Floraí;De 20 a menos de 50 ha;40;1317;9;31;313;1004;31;9;5;4;26;5;0;3;0;3;;
Floraí;De 50 a menos de 100 ha;27;1824;16;11;1224;601;22;5;13;3;9;2;0;2;0;1;;
Floraí;De 100 a menos de 200 ha;24;3395;24;0;3395;0;22;2;22;2;0;0;0;2;0;0;;
Floraí;De 200 a menos de 500 ha;13;3876;13;0;3876;0;12;1;12;1;0;0;0;0;0;0;;
Floraí;De 500 a menos de 1.000 ha;5;3526;5;0;3526;0;5;0;5;0;0;0;0;0;0;0;;
Floraí;De 1.000 a menos de 2.500 ha;3;3655;3;0;3655;0;3;0;3;0;0;0;0;0;0;0;;
Floraí;De 2.500 a menos de 10.000 ha;0;0;0;0;0;0;0;0;0;0;0;0;0;0;0;0;;
Floraí;De 10.000 ha e mais;0;0;0;0;0;0;0;0;0;0;0;0;0;0;0;0;;
Floraí;Produtor sem área;6;0;4;2;0;0;0;0;0;0;0;0;0;0;0;0;;
Flor da Serra do Sul;Mais de 0 a menos de 0,1 ha;1;0;0;1;0;0;0;1;0;0;0;1;0;0;0;1;;
Flor da Serra do Sul;De 0,1 a menos de 0,2 ha;2;0;0;2;0;0;0;2;0;0;0;2;0;0;0;2;;
Flor da Serra do Sul;De 0,2 a menos de 0,5 ha;2;0;2;0;0;0;0;2;0;2;0;0;0;2;0;0;;
Flor da Serra do Sul;De 0,5 a menos de 1 ha;2;0;1;1;0;0;1;1;1;0;0;1;0;0;1;0;;
Flor da Serra do Sul;De 1 a menos de 2 ha;8;10;3;5;4;6;5;3;2;1;3;2;0;1;0;2;;
Flor da Serra do Sul;De 2 a menos de 3 ha;18;41;3;15;7;34;12;6;0;3;12;3;0;3;0;3;;
Flor da Serra do Sul;De 3 a menos de 4 ha;19;63;8;11;26;37;12;7;6;2;6;5;0;2;0;4;;
Flor da Serra do Sul;De 4 a menos de 5 ha;27;122;4;23;19;102;19;8;3;1;16;7;0;1;0;6;;
Flor da Serra do Sul;De 5 a menos de 10 ha;129;956;16;113;110;845;100;29;11;5;89;24;0;4;1;20;;
Flor da Serra do Sul;De 10 a menos de 20 ha;205;2941;20;185;287;2654;175;30;11;9;164;21;0;8;0;16;;
Flor da Serra do Sul;De 20 a menos de 50 ha;160;4908;11;149;306;4602;144;16;5;6;139;10;0;6;0;10;;
Flor da Serra do Sul;De 50 a menos de 100 ha;46;3192;14;32;1199;1993;41;5;13;1;28;4;0;1;0;2;;
Flor da Serra do Sul;De 100 a menos de 200 ha;27;3581;27;0;3581;0;22;5;22;5;0;0;0;4;0;0;;
Flor da Serra do Sul;De 200 a menos de 500 ha;14;4201;14;0;4201;0;13;1;13;1;0;0;0;1;0;0;;
Flor da Serra do Sul;De 500 a menos de 1.000 ha;1;0;1;0;0;0;0;1;0;1;0;0;0;1;0;0;;
Flor da Serra do Sul;De 1.000 a menos de 2.500 ha;0;0;0;0;0;0;0;0;0;0;0;0;0;0;0;0;;
Flor da Serra do Sul;De 2.500 a menos de 10.000 ha;0;0;0;0;0;0;0;0;0;0;0;0;0;0;0;0;;
Flor da Serra do Sul;De 10.000 ha e mais;0;0;0;0;0;0;0;0;0;0;0;0;0;0;0;0;;
Flor da Serra do Sul;Produtor sem área;0;0;0;0;0;0;0;0;0;0;0;0;0;0;0;0;;
Floresta;Mais de 0 a menos de 0,1 ha;0;0;0;0;0;0;0;0;0;0;0;0;0;0;0;0;;
Floresta;De 0,1 a menos de 0,2 ha;0;0;0;0;0;0;0;0;0;0;0;0;0;0;0;0;;
Floresta;De 0,2 a menos de 0,5 ha;0;0;0;0;0;0;0;0;0;0;0;0;0;0;0;0;;
Floresta;De 0,5 a menos de 1 ha;19;10;1;18;0;0;3;16;0;1;3;15;0;1;0;14;;
Floresta;De 1 a menos de 2 ha;3;4;0;3;0;4;2;1;0;0;2;1;0;0;0;1;;
Floresta;De 2 a menos de 3 ha;2;0;0;2;0;0;1;1;0;0;1;1;0;0;0;1;;
Floresta;De 3 a menos de 4 ha;2;0;0;2;0;0;1;1;0;0;1;1;0;0;0;0;;
Floresta;De 4 a menos de 5 ha;9;43;0;9;0;43;5;4;0;0;5;4;0;0;2;2;;
Floresta;De 5 a menos de 10 ha;9;69;0;9;0;69;9;0;0;0;9;0;0;0;0;0;;
Floresta;De 10 a menos de 20 ha;23;358;1;22;0;0;23;0;1;0;22;0;0;0;0;0;;
Floresta;De 20 a menos de 50 ha;41;1249;2;39;0;0;40;1;2;0;38;1;0;0;0;0;;
Floresta;De 50 a menos de 100 ha;16;1208;12;4;970;237;15;1;11;1;4;0;0;1;0;0;;
Floresta;De 100 a menos de 200 ha;15;2035;15;0;2035;0;15;0;15;0;0;0;0;0;0;0;;
Floresta;De 200 a menos de 500 ha;14;4637;14;0;4637;0;14;0;14;0;0;0;0;0;0;0;;
Floresta;De 500 a menos de 1.000 ha;5;2743;5;0;2743;0;5;0;5;0;0;0;0;0;0;0;;
Floresta;De 1.000 a menos de 2.500 ha;0;0;0;0;0;0;0;0;0;0;0;0;0;0;0;0;;
Floresta;De 2.500 a menos de 10.000 ha;0;0;0;0;0;0;0;0;0;0;0;0;0;0;0;0;;
Floresta;De 10.000 ha e mais;0;0;0;0;0;0;0;0;0;0;0;0;0;0;0;0;;
Floresta;Produtor sem área;0;0;0;0;0;0;0;0;0;0;0;0;0;0;0;0;;
Florestópolis;Mais de 0 a menos de 0,1 ha;0;0;0;0;0;0;0;0;0;0;0;0;0;0;0;0;;
Florestópolis;De 0,1 a menos de 0,2 ha;0;0;0;0;0;0;0;0;0;0;0;0;0;0;0;0;;
Florestópolis;De 0,2 a menos de 0,5 ha;5;0;0;5;0;0;0;5;0;0;0;5;0;0;0;5;;
Florestópolis;De 0,5 a menos de 1 ha;28;17;0;28;0;17;4;24;0;0;4;24;0;0;0;24;;
Florestópolis;De 1 a menos de 2 ha;11;14;2;9;0;0;2;9;0;2;2;7;0;1;0;5;;
Florestópolis;De 2 a menos de 3 ha;22;53;1;21;0;0;10;12;0;1;10;11;0;0;1;7;;
Florestópolis;De 3 a menos de 4 ha;16;56;0;16;0;56;8;8;0;0;8;8;0;0;0;7;;
Florestópolis;De 4 a menos de 5 ha;12;58;0;12;0;58;4;8;0;0;4;8;0;0;0;7;;
Florestópolis;De 5 a menos de 10 ha;31;245;3;28;21;224;10;21;0;3;10;18;0;3;0;13;;
Florestópolis;De 10 a menos de 20 ha;44;642;2;42;0;0;28;16;2;0;26;16;0;0;0;12;;
Florestópolis;De 20 a menos de 50 ha;7;252;2;5;0;0;7;0;2;0;5;0;0;0;0;0;;
Florestópolis;De 50 a menos de 100 ha;9;584;7;2;0;0;9;0;7;0;2;0;0;0;0;0;;
Florestópolis;De 100 a menos de 200 ha;7;946;7;0;946;0;6;1;6;1;0;0;0;0;0;0;;
Florestópolis;De 200 a menos de 500 ha;9;2718;9;0;2718;0;9;0;9;0;0;0;0;0;0;0;;
Florestópolis;De 500 a menos de 1.000 ha;9;6311;9;0;6311;0;8;1;8;1;0;0;0;0;0;0;;
Florestópolis;De 1.000 a menos de 2.500 ha;0;0;0;0;0;0;0;0;0;0;0;0;0;0;0;0;;
Florestópolis;De 2.500 a menos de 10.000 ha;1;0;1;0;0;0;1;0;1;0;0;0;0;0;0;0;;
Florestópolis;De 10.000 ha e mais;0;0;0;0;0;0;0;0;0;0;0;0;0;0;0;0;;
Florestópolis;Produtor sem área;0;0;0;0;0;0;0;0;0;0;0;0;0;0;0;0;;
Flórida;Mais de 0 a menos de 0,1 ha;0;0;0;0;0;0;0;0;0;0;0;0;0;0;0;0;;
Flórida;De 0,1 a menos de 0,2 ha;0;0;0;0;0;0;0;0;0;0;0;0;0;0;0;0;;
Flórida;De 0,2 a menos de 0,5 ha;2;0;0;2;0;0;1;1;0;0;1;1;0;0;0;1;;
Flórida;De 0,5 a menos de 1 ha;10;6;1;9;0;0;2;8;0;1;2;7;0;1;0;6;;
Flórida;De 1 a menos de 2 ha;10;12;0;10;0;12;4;6;0;0;4;6;0;0;0;2;;
Flórida;De 2 a menos de 3 ha;1;0;0;1;0;0;0;1;0;0;0;1;0;0;0;1;;
Flórida;De 3 a menos de 4 ha;4;14;1;3;0;0;0;4;0;1;0;3;0;1;0;2;;
Flórida;De 4 a menos de 5 ha;2;0;0;2;0;0;0;2;0;0;0;2;0;0;0;2;;
Flórida;De 5 a menos de 10 ha;12;86;3;9;21;66;6;6;2;1;4;5;0;1;0;4;;
Flórida;De 10 a menos de 20 ha;14;194;2;12;0;0;5;9;1;1;4;8;0;1;0;3;;
Flórida;De 20 a menos de 50 ha;19;609;4;15;133;476;10;9;1;3;9;6;0;2;0;1;;
Flórida;De 50 a menos de 100 ha;8;616;7;1;0;0;7;1;6;1;1;0;0;0;0;0;;
Flórida;De 100 a menos de 200 ha;9;1333;9;0;1333;0;6;3;6;3;0;0;0;1;0;0;;
Flórida;De 200 a menos de 500 ha;4;1407;4;0;1407;0;3;1;3;1;0;0;0;0;0;0;;
Flórida;De 500 a menos de 1.000 ha;5;3376;5;0;3376;0;5;0;5;0;0;0;0;0;0;0;;
Flórida;De 1.000 a menos de 2.500 ha;0;0;0;0;0;0;0;0;0;0;0;0;0;0;0;0;;
Flórida;De 2.500 a menos de 10.000 ha;0;0;0;0;0;0;0;0;0;0;0;0;0;0;0;0;;
Flórida;De 10.000 ha e mais;0;0;0;0;0;0;0;0;0;0;0;0;0;0;0;0;;
Flórida;Produtor sem área;0;0;0;0;0;0;0;0;0;0;0;0;0;0;0;0;;
Formosa do Oeste;Mais de 0 a menos de 0,1 ha;3;0;1;2;0;0;0;3;0;1;0;2;0;0;2;0;;
Formosa do Oeste;De 0,1 a menos de 0,2 ha;0;0;0;0;0;0;0;0;0;0;0;0;0;0;0;0;;
Formosa do Oeste;De 0,2 a menos de 0,5 ha;2;0;0;2;0;0;1;1;0;0;1;1;0;0;1;0;;
Formosa do Oeste;De 0,5 a menos de 1 ha;28;16;7;21;4;12;11;17;4;3;7;14;0;2;3;10;;
Formosa do Oeste;De 1 a menos de 2 ha;24;33;6;18;8;24;12;12;2;4;10;8;0;3;0;8;;
Formosa do Oeste;De 2 a menos de 3 ha;34;83;10;24;24;59;23;11;8;2;15;9;0;1;0;9;;
Formosa do Oeste;De 3 a menos de 4 ha;41;145;3;38;11;134;29;12;3;0;26;12;0;0;0;8;;
Formosa do Oeste;De 4 a menos de 5 ha;39;187;5;34;24;163;24;15;2;3;22;12;0;3;0;9;;
Formosa do Oeste;De 5 a menos de 10 ha;138;1048;9;129;67;981;121;17;6;3;115;14;0;3;0;10;;
Formosa do Oeste;De 10 a menos de 20 ha;168;2367;15;153;200;2167;142;26;7;8;135;18;0;8;1;13;;
Formosa do Oeste;De 20 a menos de 50 ha;169;5239;9;160;243;4996;146;23;6;3;140;20;0;2;0;8;;
Formosa do Oeste;De 50 a menos de 100 ha;75;5155;30;45;2456;2698;64;11;26;4;38;7;0;2;0;1;;
Formosa do Oeste;De 100 a menos de 200 ha;34;4610;34;0;4610;0;34;0;34;0;0;0;0;0;0;0;;
Formosa do Oeste;De 200 a menos de 500 ha;14;4031;14;0;4031;0;13;1;13;1;0;0;0;1;0;0;;
Formosa do Oeste;De 500 a menos de 1.000 ha;2;0;2;0;0;0;2;0;2;0;0;0;0;0;0;0;;
Formosa do Oeste;De 1.000 a menos de 2.500 ha;0;0;0;0;0;0;0;0;0;0;0;0;0;0;0;0;;
Formosa do Oeste;De 2.500 a menos de 10.000 ha;0;0;0;0;0;0;0;0;0;0;0;0;0;0;0;0;;
Formosa do Oeste;De 10.000 ha e mais;0;0;0;0;0;0;0;0;0;0;0;0;0;0;0;0;;
Formosa do Oeste;Produtor sem área;0;0;0;0;0;0;0;0;0;0;0;0;0;0;0;0;;
Foz do Iguaçu;Mais de 0 a menos de 0,1 ha;9;0;3;6;0;0;0;9;0;3;0;6;0;3;0;5;;
Foz do Iguaçu;De 0,1 a menos de 0,2 ha;12;2;4;8;0;0;1;11;0;4;1;7;0;3;0;7;;
Foz do Iguaçu;De 0,2 a menos de 0,5 ha;48;15;14;34;4;11;2;46;1;13;1;33;1;12;0;33;;
Foz do Iguaçu;De 0,5 a menos de 1 ha;148;83;46;102;24;58;10;138;5;41;5;97;0;36;3;85;;
Foz do Iguaçu;De 1 a menos de 2 ha;98;128;20;78;25;103;16;82;1;19;15;63;0;14;0;51;;
Foz do Iguaçu;De 2 a menos de 3 ha;46;108;14;32;34;74;2;44;0;14;2;30;0;13;5;20;;
Foz do Iguaçu;De 3 a menos de 4 ha;27;90;8;19;27;63;2;25;0;8;2;17;0;6;0;14;;
Foz do Iguaçu;De 4 a menos de 5 ha;35;163;12;23;56;107;4;31;0;12;4;19;0;11;0;12;;
Foz do Iguaçu;De 5 a menos de 10 ha;33;237;11;22;71;166;10;23;3;8;7;15;0;6;2;10;;
Foz do Iguaçu;De 10 a menos de 20 ha;35;534;9;26;135;399;16;19;3;6;13;13;0;3;1;9;;
Foz do Iguaçu;De 20 a menos de 50 ha;29;864;8;21;231;633;17;12;3;5;14;7;1;4;1;5;;
Foz do Iguaçu;De 50 a menos de 100 ha;16;1203;10;6;0;0;12;4;8;2;4;2;0;2;0;1;;
Foz do Iguaçu;De 100 a menos de 200 ha;12;1776;12;0;1776;0;11;1;11;1;0;0;0;1;0;0;;
Foz do Iguaçu;De 200 a menos de 500 ha;12;3701;12;0;3701;0;12;0;12;0;0;0;0;0;0;0;;
Foz do Iguaçu;De 500 a menos de 1.000 ha;3;2154;3;0;2154;0;3;0;3;0;0;0;0;0;0;0;;
Foz do Iguaçu;De 1.000 a menos de 2.500 ha;2;0;2;0;0;0;2;0;2;0;0;0;0;0;0;0;;
Foz do Iguaçu;De 2.500 a menos de 10.000 ha;0;0;0;0;0;0;0;0;0;0;0;0;0;0;0;0;;
Foz do Iguaçu;De 10.000 ha e mais;0;0;0;0;0;0;0;0;0;0;0;0;0;0;0;0;;
Foz do Iguaçu;Produtor sem área;3;0;1;2;0;0;1;1;1;0;0;1;0;0;0;1;;
Francisco Alves;Mais de 0 a menos de 0,1 ha;76;4;21;55;1;3;4;72;2;19;2;53;15;4;27;25;;
Francisco Alves;De 0,1 a menos de 0,2 ha;12;2;1;11;0;0;2;10;1;0;1;10;0;0;9;1;;
Francisco Alves;De 0,2 a menos de 0,5 ha;7;2;3;4;1;1;1;6;0;3;1;3;2;0;2;1;;
Francisco Alves;De 0,5 a menos de 1 ha;25;13;3;22;0;0;0;25;0;3;0;22;1;2;0;20;;
Francisco Alves;De 1 a menos de 2 ha;20;26;4;16;6;21;0;20;0;4;0;16;1;3;0;15;;
Francisco Alves;De 2 a menos de 3 ha;49;120;10;39;24;96;8;41;0;10;8;31;2;8;6;14;;
Francisco Alves;De 3 a menos de 4 ha;30;105;5;25;17;88;13;17;2;3;11;14;1;2;5;4;;
Francisco Alves;De 4 a menos de 5 ha;36;169;7;29;33;136;13;23;1;6;12;17;5;1;5;6;;
Francisco Alves;De 5 a menos de 10 ha;95;720;9;86;61;658;40;55;1;8;39;47;2;5;17;15;;
Francisco Alves;De 10 a menos de 20 ha;96;1372;9;87;122;1249;51;45;4;5;47;40;1;3;14;11;;
Francisco Alves;De 20 a menos de 50 ha;109;3413;11;98;407;3007;74;35;5;6;69;29;0;1;1;7;;
Francisco Alves;De 50 a menos de 100 ha;61;4355;20;41;1685;2670;47;14;19;1;28;13;1;0;3;7;;
Francisco Alves;De 100 a menos de 200 ha;29;4145;28;1;0;0;25;4;24;4;1;0;0;2;0;0;;
Francisco Alves;De 200 a menos de 500 ha;17;5746;17;0;5746;0;17;0;17;0;0;0;0;0;0;0;;
Francisco Alves;De 500 a menos de 1.000 ha;9;6006;9;0;6006;0;7;2;7;2;0;0;0;0;0;0;;
Francisco Alves;De 1.000 a menos de 2.500 ha;5;0;5;0;0;0;5;0;5;0;0;0;0;0;0;0;;
Francisco Alves;De 2.500 a menos de 10.000 ha;0;0;0;0;0;0;0;0;0;0;0;0;0;0;0;0;;
Francisco Alves;De 10.000 ha e mais;0;0;0;0;0;0;0;0;0;0;0;0;0;0;0;0;;
Francisco Alves;Produtor sem área;3;0;1;2;0;0;0;3;0;1;0;2;0;1;0;2;;
Francisco Beltrão;Mais de 0 a menos de 0,1 ha;10;1;5;5;0;0;2;8;1;4;1;4;0;4;0;4;;
Francisco Beltrão;De 0,1 a menos de 0,2 ha;14;2;9;5;0;0;1;13;1;8;0;5;0;7;0;4;;
Francisco Beltrão;De 0,2 a menos de 0,5 ha;28;9;8;20;2;7;4;24;0;8;4;16;0;8;0;14;;
Francisco Beltrão;De 0,5 a menos de 1 ha;114;65;38;76;24;41;28;86;13;25;15;61;0;23;2;52;;
Francisco Beltrão;De 1 a menos de 2 ha;77;101;32;45;42;59;35;42;16;16;19;26;0;15;0;25;;
Francisco Beltrão;De 2 a menos de 3 ha;95;230;24;71;57;173;44;51;12;12;32;39;0;10;0;35;;
Francisco Beltrão;De 3 a menos de 4 ha;128;437;29;99;96;341;71;57;12;17;59;40;0;16;1;33;;
Francisco Beltrão;De 4 a menos de 5 ha;173;814;35;138;164;650;104;69;21;14;83;55;0;13;0;46;;
Francisco Beltrão;De 5 a menos de 10 ha;526;4015;77;449;571;3445;383;143;46;31;337;112;0;27;1;94;;
Francisco Beltrão;De 10 a menos de 20 ha;757;10632;82;675;1130;9502;644;113;40;42;604;71;0;41;3;52;;
Francisco Beltrão;De 20 a menos de 50 ha;474;14622;56;418;1784;12838;413;61;31;25;382;36;0;23;1;31;;
Francisco Beltrão;De 50 a menos de 100 ha;135;9279;69;66;5456;3823;120;15;56;13;64;2;0;13;0;2;;
Francisco Beltrão;De 100 a menos de 200 ha;57;8054;57;0;8054;0;51;6;51;6;0;0;0;6;0;0;;
Francisco Beltrão;De 200 a menos de 500 ha;24;7044;24;0;7044;0;20;4;20;4;0;0;0;2;0;0;;
Francisco Beltrão;De 500 a menos de 1.000 ha;3;0;3;0;0;0;1;2;1;2;0;0;0;2;0;0;;
Francisco Beltrão;De 1.000 a menos de 2.500 ha;1;0;1;0;0;0;1;0;1;0;0;0;0;0;0;0;;
Francisco Beltrão;De 2.500 a menos de 10.000 ha;0;0;0;0;0;0;0;0;0;0;0;0;0;0;0;0;;
Francisco Beltrão;De 10.000 ha e mais;0;0;0;0;0;0;0;0;0;0;0;0;0;0;0;0;;
Francisco Beltrão;Produtor sem área;5;0;4;1;0;0;0;0;0;0;0;0;0;0;0;0;;
Foz do Jordão;Mais de 0 a menos de 0,1 ha;21;1;17;4;0;0;0;21;0;17;0;4;0;17;0;4;;
Foz do Jordão;De 0,1 a menos de 0,2 ha;12;2;7;5;1;1;0;12;0;7;0;5;0;7;0;5;;
Foz do Jordão;De 0,2 a menos de 0,5 ha;8;2;6;2;0;0;4;4;4;2;0;2;0;2;0;2;;
Foz do Jordão;De 0,5 a menos de 1 ha;11;8;0;11;0;8;6;5;0;0;6;5;0;0;0;5;;
Foz do Jordão;De 1 a menos de 2 ha;11;15;7;4;10;6;4;7;2;5;2;2;0;5;0;2;;
Foz do Jordão;De 2 a menos de 3 ha;18;45;10;8;25;20;12;6;8;2;4;4;0;2;0;3;;
Foz do Jordão;De 3 a menos de 4 ha;6;21;3;3;0;0;6;0;3;0;3;0;0;0;0;0;;
Foz do Jordão;De 4 a menos de 5 ha;14;67;3;11;15;53;11;3;3;0;8;3;0;0;1;0;;
Foz do Jordão;De 5 a menos de 10 ha;34;252;8;26;57;195;30;4;6;2;24;2;0;2;0;2;;
Foz do Jordão;De 10 a menos de 20 ha;29;374;0;29;0;374;27;2;0;0;27;2;0;0;0;2;;
Foz do Jordão;De 20 a menos de 50 ha;47;1468;8;39;300;1168;44;3;7;1;37;2;0;1;1;1;;
Foz do Jordão;De 50 a menos de 100 ha;20;1469;14;6;1139;330;20;0;14;0;6;0;0;0;0;0;;
Foz do Jordão;De 100 a menos de 200 ha;7;940;7;0;940;0;6;1;6;1;0;0;0;0;0;0;;
Foz do Jordão;De 200 a menos de 500 ha;11;3711;11;0;3711;0;11;0;11;0;0;0;0;0;0;0;;
Foz do Jordão;De 500 a menos de 1.000 ha;4;2651;4;0;2651;0;4;0;4;0;0;0;0;0;0;0;;
Foz do Jordão;De 1.000 a menos de 2.500 ha;2;0;2;0;0;0;2;0;2;0;0;0;0;0;0;0;;
Foz do Jordão;De 2.500 a menos de 10.000 ha;3;0;3;0;0;0;3;0;3;0;0;0;0;0;0;0;;
Foz do Jordão;De 10.000 ha e mais;0;0;0;0;0;0;0;0;0;0;0;0;0;0;0;0;;
Foz do Jordão;Produtor sem área;1;0;0;1;0;0;0;1;0;0;0;1;0;0;0;1;;
General Carneiro;Mais de 0 a menos de 0,1 ha;2;0;0;2;0;0;0;2;0;0;0;2;0;0;0;2;;
General Carneiro;De 0,1 a menos de 0,2 ha;0;0;0;0;0;0;0;0;0;0;0;0;0;0;0;0;;
General Carneiro;De 0,2 a menos de 0,5 ha;3;1;0;3;0;1;0;3;0;0;0;3;0;0;0;1;;
General Carneiro;De 0,5 a menos de 1 ha;24;14;7;17;4;9;2;22;0;7;2;15;0;6;0;11;;
General Carneiro;De 1 a menos de 2 ha;10;12;2;8;0;0;0;10;0;2;0;8;0;2;1;7;;
General Carneiro;De 2 a menos de 3 ha;18;43;5;13;12;31;3;15;2;3;1;12;0;2;1;9;;
General Carneiro;De 3 a menos de 4 ha;26;92;12;14;42;50;7;19;3;9;4;10;0;8;2;6;;
General Carneiro;De 4 a menos de 5 ha;16;76;6;10;28;48;2;14;1;5;1;9;0;5;0;8;;
General Carneiro;De 5 a menos de 10 ha;80;623;26;54;186;438;8;72;3;23;5;49;0;20;2;34;;
General Carneiro;De 10 a menos de 20 ha;110;1629;23;87;331;1298;13;97;4;19;9;78;0;11;3;54;;
General Carneiro;De 20 a menos de 50 ha;190;5921;30;160;1027;4894;52;138;3;27;49;111;0;24;0;83;;
General Carneiro;De 50 a menos de 100 ha;57;3928;12;45;940;2988;18;39;3;9;15;30;0;7;1;27;;
General Carneiro;De 100 a menos de 200 ha;54;7696;47;7;6772;924;15;39;13;34;2;5;3;24;0;4;;
General Carneiro;De 200 a menos de 500 ha;34;10577;30;4;9318;1258;9;25;8;22;1;3;0;15;0;3;;
General Carneiro;De 500 a menos de 1.000 ha;19;12976;17;2;0;0;7;12;7;10;0;2;0;10;0;2;;
General Carneiro;De 1.000 a menos de 2.500 ha;19;33924;17;2;0;0;2;17;1;16;1;1;0;16;0;1;;
General Carneiro;De 2.500 a menos de 10.000 ha;5;0;5;0;0;0;1;4;1;4;0;0;0;4;0;0;;
General Carneiro;De 10.000 ha e mais;0;0;0;0;0;0;0;0;0;0;0;0;0;0;0;0;;
General Carneiro;Produtor sem área;1;0;0;1;0;0;0;0;0;0;0;0;0;0;0;0;;
Godoy Moreira;Mais de 0 a menos de 0,1 ha;10;0;6;4;0;0;1;9;0;6;1;3;0;6;0;3;;
Godoy Moreira;De 0,1 a menos de 0,2 ha;0;0;0;0;0;0;0;0;0;0;0;0;0;0;0;0;;
Godoy Moreira;De 0,2 a menos de 0,5 ha;2;0;2;0;0;0;1;1;1;1;0;0;0;0;0;0;;
Godoy Moreira;De 0,5 a menos de 1 ha;31;18;12;19;7;11;10;21;5;7;5;14;0;6;0;11;;
Godoy Moreira;De 1 a menos de 2 ha;25;35;7;18;10;24;8;17;1;6;7;11;0;4;0;9;;
Godoy Moreira;De 2 a menos de 3 ha;30;73;8;22;19;54;14;16;3;5;11;11;0;4;0;9;;
Godoy Moreira;De 3 a menos de 4 ha;28;101;3;25;11;90;8;20;1;2;7;18;0;2;0;11;;
Godoy Moreira;De 4 a menos de 5 ha;45;216;7;38;33;183;18;27;2;5;16;22;0;4;0;16;;
Godoy Moreira;De 5 a menos de 10 ha;98;748;13;85;96;652;33;65;5;8;28;57;0;6;1;44;;
Godoy Moreira;De 10 a menos de 20 ha;103;1505;11;92;169;1336;48;55;3;8;45;47;0;8;0;39;;
Godoy Moreira;De 20 a menos de 50 ha;47;1418;2;45;0;0;28;19;2;0;26;19;0;0;0;13;;
Godoy Moreira;De 50 a menos de 100 ha;18;1354;11;7;970;385;14;4;9;2;5;2;0;2;0;2;;
Godoy Moreira;De 100 a menos de 200 ha;14;1968;14;0;1968;0;11;3;11;3;0;0;0;2;0;0;;
Godoy Moreira;De 200 a menos de 500 ha;7;1978;7;0;1978;0;6;1;6;1;0;0;0;1;0;0;;
Godoy Moreira;De 500 a menos de 1.000 ha;1;0;1;0;0;0;0;1;0;1;0;0;0;1;0;0;;
Godoy Moreira;De 1.000 a menos de 2.500 ha;0;0;0;0;0;0;0;0;0;0;0;0;0;0;0;0;;
Godoy Moreira;De 2.500 a menos de 10.000 ha;0;0;0;0;0;0;0;0;0;0;0;0;0;0;0;0;;
Godoy Moreira;De 10.000 ha e mais;0;0;0;0;0;0;0;0;0;0;0;0;0;0;0;0;;
Godoy Moreira;Produtor sem área;6;0;4;2;0;0;0;6;0;4;0;2;0;4;0;2;;
Goioerê;Mais de 0 a menos de 0,1 ha;0;0;0;0;0;0;0;0;0;0;0;0;0;0;0;0;;
Goioerê;De 0,1 a menos de 0,2 ha;0;0;0;0;0;0;0;0;0;0;0;0;0;0;0;0;;
Goioerê;De 0,2 a menos de 0,5 ha;0;0;0;0;0;0;0;0;0;0;0;0;0;0;0;0;;
Goioerê;De 0,5 a menos de 1 ha;30;18;7;23;5;13;11;19;3;4;8;15;0;2;1;8;;
Goioerê;De 1 a menos de 2 ha;7;8;4;3;0;0;0;7;0;4;0;3;0;4;0;3;;
Goioerê;De 2 a menos de 3 ha;33;79;10;23;24;55;7;26;2;8;5;18;0;7;1;13;;
Goioerê;De 3 a menos de 4 ha;24;87;5;19;18;69;6;18;0;5;6;13;0;3;0;7;;
Goioerê;De 4 a menos de 5 ha;38;182;6;32;29;154;8;30;0;6;8;24;0;3;5;15;;
Goioerê;De 5 a menos de 10 ha;107;801;21;86;156;644;31;76;1;20;30;56;2;13;1;36;;
Goioerê;De 10 a menos de 20 ha;97;1367;7;90;98;1269;49;48;1;6;48;42;1;4;2;23;;
Goioerê;De 20 a menos de 50 ha;92;3133;11;81;458;2674;63;29;10;1;53;28;0;1;0;17;;
Goioerê;De 50 a menos de 100 ha;31;2232;18;13;0;0;26;5;13;5;13;0;0;4;0;0;;
Goioerê;De 100 a menos de 200 ha;24;3289;24;0;3289;0;20;4;20;4;0;0;0;0;0;0;;
Goioerê;De 200 a menos de 500 ha;32;9838;32;0;9838;0;30;2;30;2;0;0;0;1;0;0;;
Goioerê;De 500 a menos de 1.000 ha;10;6493;10;0;6493;0;9;1;9;1;0;0;0;1;0;0;;
Goioerê;De 1.000 a menos de 2.500 ha;5;0;5;0;0;0;5;0;5;0;0;0;0;0;0;0;;
Goioerê;De 2.500 a menos de 10.000 ha;2;0;2;0;0;0;2;0;2;0;0;0;0;0;0;0;;
Goioerê;De 10.000 ha e mais;0;0;0;0;0;0;0;0;0;0;0;0;0;0;0;0;;
Goioerê;Produtor sem área;0;0;0;0;0;0;0;0;0;0;0;0;0;0;0;0;;
Goioxim;Mais de 0 a menos de 0,1 ha;1;0;0;1;0;0;0;1;0;0;0;1;0;0;0;1;;
Goioxim;De 0,1 a menos de 0,2 ha;0;0;0;0;0;0;0;0;0;0;0;0;0;0;0;0;;
Goioxim;De 0,2 a menos de 0,5 ha;26;12;1;25;0;0;11;15;0;1;11;14;0;1;0;13;;
Goioxim;De 0,5 a menos de 1 ha;3;2;1;2;0;0;1;2;0;1;1;1;0;1;0;1;;
Goioxim;De 1 a menos de 2 ha;14;20;1;13;0;0;6;8;0;1;6;7;0;1;0;6;;
Goioxim;De 2 a menos de 3 ha;31;71;13;18;30;41;22;9;11;2;11;7;0;2;0;6;;
Goioxim;De 3 a menos de 4 ha;23;79;3;20;11;68;16;7;3;0;13;7;0;0;0;5;;
Goioxim;De 4 a menos de 5 ha;35;168;4;31;19;149;26;9;3;1;23;8;0;1;0;5;;
Goioxim;De 5 a menos de 10 ha;91;690;4;87;28;663;64;27;3;1;61;26;0;1;0;20;;
Goioxim;De 10 a menos de 20 ha;134;2058;8;126;110;1947;111;23;5;3;106;20;0;3;1;14;;
Goioxim;De 20 a menos de 50 ha;368;9781;12;356;359;9421;292;76;7;5;285;71;0;4;3;41;;
Goioxim;De 50 a menos de 100 ha;57;4244;30;27;2516;1729;43;14;22;8;21;6;0;8;0;4;;
Goioxim;De 100 a menos de 200 ha;30;3927;30;0;3927;0;27;3;27;3;0;0;0;3;0;0;;
Goioxim;De 200 a menos de 500 ha;32;10072;31;1;0;0;26;6;26;5;0;1;0;4;0;1;;
Goioxim;De 500 a menos de 1.000 ha;6;3641;6;0;3641;0;4;2;4;2;0;0;0;2;0;0;;
Goioxim;De 1.000 a menos de 2.500 ha;3;3950;3;0;3950;0;3;0;3;0;0;0;0;0;0;0;;
Goioxim;De 2.500 a menos de 10.000 ha;2;0;2;0;0;0;2;0;2;0;0;0;0;0;0;0;;
Goioxim;De 10.000 ha e mais;0;0;0;0;0;0;0;0;0;0;0;0;0;0;0;0;;
Goioxim;Produtor sem área;0;0;0;0;0;0;0;0;0;0;0;0;0;0;0;0;;
Grandes Rios;Mais de 0 a menos de 0,1 ha;2;0;0;2;0;0;0;2;0;0;0;2;0;0;0;2;;
Grandes Rios;De 0,1 a menos de 0,2 ha;1;0;1;0;0;0;1;0;1;0;0;0;0;0;0;0;;
Grandes Rios;De 0,2 a menos de 0,5 ha;5;1;2;3;0;0;3;2;2;0;1;2;0;0;0;0;;
Grandes Rios;De 0,5 a menos de 1 ha;4;3;2;2;0;0;3;1;2;0;1;1;0;0;0;1;;
Grandes Rios;De 1 a menos de 2 ha;16;19;2;14;0;0;8;8;2;0;6;8;0;0;0;5;;
Grandes Rios;De 2 a menos de 3 ha;17;41;2;15;0;0;9;8;2;0;7;8;0;0;0;6;;
Grandes Rios;De 3 a menos de 4 ha;25;89;7;18;24;65;20;5;6;1;14;4;0;1;0;3;;
Grandes Rios;De 4 a menos de 5 ha;55;260;7;48;33;227;47;8;5;2;42;6;0;1;0;5;;
Grandes Rios;De 5 a menos de 10 ha;147;1109;23;124;185;924;113;34;16;7;97;27;0;6;0;16;;
Grandes Rios;De 10 a menos de 20 ha;104;1463;17;87;244;1219;72;32;11;6;61;26;0;5;0;15;;
Grandes Rios;De 20 a menos de 50 ha;101;3083;27;74;825;2258;74;27;22;5;52;22;0;5;0;15;;
Grandes Rios;De 50 a menos de 100 ha;37;2697;23;14;1874;823;25;12;15;8;10;4;0;4;0;2;;
Grandes Rios;De 100 a menos de 200 ha;21;2728;21;0;2728;0;19;2;19;2;0;0;0;2;0;0;;
Grandes Rios;De 200 a menos de 500 ha;23;6514;23;0;6514;0;21;2;21;2;0;0;0;1;0;0;;
Grandes Rios;De 500 a menos de 1.000 ha;13;8211;13;0;8211;0;12;1;12;1;0;0;0;1;0;0;;
Grandes Rios;De 1.000 a menos de 2.500 ha;1;0;1;0;0;0;1;0;1;0;0;0;0;0;0;0;;
Grandes Rios;De 2.500 a menos de 10.000 ha;0;0;0;0;0;0;0;0;0;0;0;0;0;0;0;0;;
Grandes Rios;De 10.000 ha e mais;0;0;0;0;0;0;0;0;0;0;0;0;0;0;0;0;;
Grandes Rios;Produtor sem área;0;0;0;0;0;0;0;0;0;0;0;0;0;0;0;0;;
Guaíra;Mais de 0 a menos de 0,1 ha;0;0;0;0;0;0;0;0;0;0;0;0;0;0;0;0;;
Guaíra;De 0,1 a menos de 0,2 ha;1;0;0;1;0;0;0;1;0;0;0;1;0;0;0;1;;
Guaíra;De 0,2 a menos de 0,5 ha;6;2;0;6;0;2;0;6;0;0;0;6;0;0;0;5;;
Guaíra;De 0,5 a menos de 1 ha;35;23;9;26;6;17;17;18;1;8;16;10;0;8;0;7;;
Guaíra;De 1 a menos de 2 ha;34;42;2;32;0;0;14;20;1;1;13;19;0;0;3;13;;
Guaíra;De 2 a menos de 3 ha;46;114;5;41;12;102;19;27;2;3;17;24;0;3;1;18;;
Guaíra;De 3 a menos de 4 ha;29;101;0;29;0;101;14;15;0;0;14;15;0;0;3;8;;
Guaíra;De 4 a menos de 5 ha;43;205;3;40;14;191;25;18;2;1;23;17;0;1;1;11;;
Guaíra;De 5 a menos de 10 ha;87;656;3;84;22;634;66;21;2;1;64;20;0;1;2;11;;
Guaíra;De 10 a menos de 20 ha;118;1683;2;116;0;0;110;8;2;0;108;8;0;0;1;6;;
Guaíra;De 20 a menos de 50 ha;118;3640;3;115;104;3536;112;6;1;2;111;4;0;2;0;4;;
Guaíra;De 50 a menos de 100 ha;60;4246;19;41;1647;2599;58;2;18;1;40;1;0;0;0;0;;
Guaíra;De 100 a menos de 200 ha;44;6265;44;0;6265;0;43;1;43;1;0;0;0;1;0;0;;
Guaíra;De 200 a menos de 500 ha;22;7023;22;0;7023;0;21;1;21;1;0;0;0;1;0;0;;
Guaíra;De 500 a menos de 1.000 ha;7;5233;7;0;5233;0;7;0;7;0;0;0;0;0;0;0;;
Guaíra;De 1.000 a menos de 2.500 ha;3;0;3;0;0;0;3;0;3;0;0;0;0;0;0;0;;
Guaíra;De 2.500 a menos de 10.000 ha;0;0;0;0;0;0;0;0;0;0;0;0;0;0;0;0;;
Guaíra;De 10.000 ha e mais;0;0;0;0;0;0;0;0;0;0;0;0;0;0;0;0;;
Guaíra;Produtor sem área;8;0;2;6;0;0;0;0;0;0;0;0;0;0;0;0;;
Guairaçá;Mais de 0 a menos de 0,1 ha;3;0;3;0;0;0;0;3;0;3;0;0;0;3;0;0;;
Guairaçá;De 0,1 a menos de 0,2 ha;0;0;0;0;0;0;0;0;0;0;0;0;0;0;0;0;;
Guairaçá;De 0,2 a menos de 0,5 ha;2;0;1;1;0;0;0;2;0;1;0;1;0;1;0;1;;
Guairaçá;De 0,5 a menos de 1 ha;47;24;22;25;11;13;2;45;0;22;2;23;0;19;0;20;;
Guairaçá;De 1 a menos de 2 ha;33;37;23;10;25;12;1;32;0;23;1;9;0;22;0;9;;
Guairaçá;De 2 a menos de 3 ha;49;119;30;19;73;46;1;48;0;30;1;18;0;28;0;16;;
Guairaçá;De 3 a menos de 4 ha;9;32;2;7;0;0;0;9;0;2;0;7;0;2;0;5;;
Guairaçá;De 4 a menos de 5 ha;47;227;17;30;82;145;5;42;1;16;4;26;0;15;0;25;;
Guairaçá;De 5 a menos de 10 ha;58;458;20;38;152;306;7;51;2;18;5;33;0;15;0;26;;
Guairaçá;De 10 a menos de 20 ha;61;860;19;42;253;607;10;51;5;14;5;37;0;14;0;31;;
Guairaçá;De 20 a menos de 50 ha;68;2233;18;50;572;1660;20;48;9;9;11;39;0;9;0;28;;
Guairaçá;De 50 a menos de 100 ha;39;2768;16;23;1235;1533;13;26;5;11;8;15;0;8;0;14;;
Guairaçá;De 100 a menos de 200 ha;34;5076;34;0;5076;0;13;21;13;21;0;0;0;15;0;0;;
Guairaçá;De 200 a menos de 500 ha;33;9217;33;0;9217;0;15;18;15;18;0;0;0;15;0;0;;
Guairaçá;De 500 a menos de 1.000 ha;12;8286;12;0;8286;0;4;8;4;8;0;0;0;4;0;0;;
Guairaçá;De 1.000 a menos de 2.500 ha;3;0;3;0;0;0;2;1;2;1;0;0;0;1;0;0;;
Guairaçá;De 2.500 a menos de 10.000 ha;0;0;0;0;0;0;0;0;0;0;0;0;0;0;0;0;;
Guairaçá;De 10.000 ha e mais;1;0;1;0;0;0;1;0;1;0;0;0;0;0;0;0;;
Guairaçá;Produtor sem área;0;0;0;0;0;0;0;0;0;0;0;0;0;0;0;0;;
Guamiranga;Mais de 0 a menos de 0,1 ha;2;0;0;2;0;0;0;2;0;0;0;2;0;0;0;2;;
Guamiranga;De 0,1 a menos de 0,2 ha;4;0;0;4;0;0;0;4;0;0;0;4;0;0;0;3;;
Guamiranga;De 0,2 a menos de 0,5 ha;18;6;4;14;0;0;2;16;0;4;2;12;1;3;2;8;;
Guamiranga;De 0,5 a menos de 1 ha;32;23;5;27;4;20;9;23;2;3;7;20;0;3;2;14;;
Guamiranga;De 1 a menos de 2 ha;64;88;19;45;25;63;39;25;11;8;28;17;0;6;2;12;;
Guamiranga;De 2 a menos de 3 ha;99;243;13;86;33;211;83;16;10;3;73;13;0;3;1;9;;
Guamiranga;De 3 a menos de 4 ha;101;354;7;94;24;330;79;22;4;3;75;19;0;3;2;13;;
Guamiranga;De 4 a menos de 5 ha;104;493;10;94;48;445;96;8;8;2;88;6;0;2;0;3;;
Guamiranga;De 5 a menos de 10 ha;240;1757;14;226;105;1652;220;20;12;2;208;18;0;1;2;15;;
Guamiranga;De 10 a menos de 20 ha;184;2641;10;174;139;2503;156;28;6;4;150;24;0;1;1;20;;
Guamiranga;De 20 a menos de 50 ha;117;3697;17;100;592;3105;106;11;13;4;93;7;0;4;0;6;;
Guamiranga;De 50 a menos de 100 ha;38;2784;31;7;2391;393;32;6;26;5;6;1;0;2;0;1;;
Guamiranga;De 100 a menos de 200 ha;14;1974;14;0;1974;0;10;4;10;4;0;0;0;4;0;0;;
Guamiranga;De 200 a menos de 500 ha;11;3273;11;0;3273;0;11;0;11;0;0;0;0;0;0;0;;
Guamiranga;De 500 a menos de 1.000 ha;0;0;0;0;0;0;0;0;0;0;0;0;0;0;0;0;;
Guamiranga;De 1.000 a menos de 2.500 ha;0;0;0;0;0;0;0;0;0;0;0;0;0;0;0;0;;
Guamiranga;De 2.500 a menos de 10.000 ha;0;0;0;0;0;0;0;0;0;0;0;0;0;0;0;0;;
Guamiranga;De 10.000 ha e mais;0;0;0;0;0;0;0;0;0;0;0;0;0;0;0;0;;
Guamiranga;Produtor sem área;6;0;3;3;0;0;2;0;2;0;0;0;0;0;0;0;;
Guapirama;Mais de 0 a menos de 0,1 ha;2;0;0;2;0;0;0;2;0;0;0;2;0;0;1;1;;
Guapirama;De 0,1 a menos de 0,2 ha;1;0;1;0;0;0;1;0;1;0;0;0;0;0;0;0;;
Guapirama;De 0,2 a menos de 0,5 ha;2;0;1;1;0;0;1;1;1;0;0;1;0;0;0;1;;
Guapirama;De 0,5 a menos de 1 ha;45;24;20;25;10;14;18;27;11;9;7;18;0;9;0;18;;
Guapirama;De 1 a menos de 2 ha;13;17;3;10;4;13;2;11;0;3;2;8;0;3;0;7;;
Guapirama;De 2 a menos de 3 ha;7;17;3;4;7;10;1;6;0;3;1;3;0;2;0;3;;
Guapirama;De 3 a menos de 4 ha;12;42;4;8;15;27;3;9;0;4;3;5;0;2;0;3;;
Guapirama;De 4 a menos de 5 ha;10;46;3;7;14;32;3;7;1;2;2;5;0;2;0;4;;
Guapirama;De 5 a menos de 10 ha;64;489;16;48;122;368;29;35;10;6;19;29;0;5;0;22;;
Guapirama;De 10 a menos de 20 ha;52;714;9;43;131;583;25;27;5;4;20;23;0;4;0;19;;
Guapirama;De 20 a menos de 50 ha;50;1536;3;47;80;1457;26;24;2;1;24;23;0;1;0;16;;
Guapirama;De 50 a menos de 100 ha;26;1743;13;13;1004;740;20;6;11;2;9;4;0;1;0;2;;
Guapirama;De 100 a menos de 200 ha;16;2246;16;0;2246;0;11;5;11;5;0;0;0;5;0;0;;
Guapirama;De 200 a menos de 500 ha;20;6683;20;0;6683;0;14;6;14;6;0;0;0;4;0;0;;
Guapirama;De 500 a menos de 1.000 ha;3;2108;3;0;2108;0;3;0;3;0;0;0;0;0;0;0;;
Guapirama;De 1.000 a menos de 2.500 ha;2;0;2;0;0;0;2;0;2;0;0;0;0;0;0;0;;
Guapirama;De 2.500 a menos de 10.000 ha;0;0;0;0;0;0;0;0;0;0;0;0;0;0;0;0;;
Guapirama;De 10.000 ha e mais;0;0;0;0;0;0;0;0;0;0;0;0;0;0;0;0;;
Guapirama;Produtor sem área;0;0;0;0;0;0;0;0;0;0;0;0;0;0;0;0;;
Guaporema;Mais de 0 a menos de 0,1 ha;0;0;0;0;0;0;0;0;0;0;0;0;0;0;0;0;;
Guaporema;De 0,1 a menos de 0,2 ha;1;0;1;0;0;0;0;1;0;1;0;0;0;1;0;0;;
Guaporema;De 0,2 a menos de 0,5 ha;3;0;0;3;0;0;0;3;0;0;0;3;0;0;0;3;;
Guaporema;De 0,5 a menos de 1 ha;54;28;28;26;14;14;18;36;12;16;6;20;0;15;0;18;;
Guaporema;De 1 a menos de 2 ha;3;4;3;0;4;0;0;3;0;3;0;0;0;3;0;0;;
Guaporema;De 2 a menos de 3 ha;5;12;2;3;0;0;0;5;0;2;0;3;0;2;0;3;;
Guaporema;De 3 a menos de 4 ha;5;18;1;4;0;0;3;2;1;0;2;2;0;0;0;2;;
Guaporema;De 4 a menos de 5 ha;7;32;3;4;14;18;0;7;0;3;0;4;0;3;0;3;;
Guaporema;De 5 a menos de 10 ha;16;124;7;9;56;68;5;11;2;5;3;6;0;5;0;5;;
Guaporema;De 10 a menos de 20 ha;20;299;5;15;70;228;8;12;1;4;7;8;0;3;0;5;;
Guaporema;De 20 a menos de 50 ha;33;1061;7;26;238;823;18;15;5;2;13;13;0;1;0;10;;
Guaporema;De 50 a menos de 100 ha;19;1366;3;16;257;1109;12;7;2;1;10;6;0;0;0;4;;
Guaporema;De 100 a menos de 200 ha;20;2913;20;0;2913;0;12;8;12;8;0;0;0;4;0;0;;
Guaporema;De 200 a menos de 500 ha;10;2735;10;0;2735;0;7;3;7;3;0;0;0;3;0;0;;
Guaporema;De 500 a menos de 1.000 ha;2;0;2;0;0;0;0;2;0;2;0;0;0;1;0;0;;
Guaporema;De 1.000 a menos de 2.500 ha;0;0;0;0;0;0;0;0;0;0;0;0;0;0;0;0;;
Guaporema;De 2.500 a menos de 10.000 ha;1;0;1;0;0;0;1;0;1;0;0;0;0;0;0;0;;
Guaporema;De 10.000 ha e mais;0;0;0;0;0;0;0;0;0;0;0;0;0;0;0;0;;
Guaporema;Produtor sem área;1;0;0;1;0;0;0;0;0;0;0;0;0;0;0;0;;
Guaraci;Mais de 0 a menos de 0,1 ha;2;0;1;1;0;0;0;2;0;1;0;1;0;1;0;1;;
Guaraci;De 0,1 a menos de 0,2 ha;0;0;0;0;0;0;0;0;0;0;0;0;0;0;0;0;;
Guaraci;De 0,2 a menos de 0,5 ha;0;0;0;0;0;0;0;0;0;0;0;0;0;0;0;0;;
Guaraci;De 0,5 a menos de 1 ha;36;18;6;30;3;15;6;30;0;6;6;24;2;3;8;8;;
Guaraci;De 1 a menos de 2 ha;1;0;0;1;0;0;0;1;0;0;0;1;0;0;0;1;;
Guaraci;De 2 a menos de 3 ha;16;39;5;11;12;27;1;15;0;5;1;10;0;5;2;8;;
Guaraci;De 3 a menos de 4 ha;9;31;1;8;0;0;0;9;0;1;0;8;0;1;1;7;;
Guaraci;De 4 a menos de 5 ha;9;44;4;5;19;24;0;9;0;4;0;5;0;3;0;4;;
Guaraci;De 5 a menos de 10 ha;33;261;6;27;44;217;4;29;1;5;3;24;1;3;1;18;;
Guaraci;De 10 a menos de 20 ha;31;449;9;22;129;320;4;27;2;7;2;20;0;6;1;16;;
Guaraci;De 20 a menos de 50 ha;34;1012;10;24;279;732;2;32;0;10;2;22;1;8;0;17;;
Guaraci;De 50 a menos de 100 ha;18;1330;14;4;0;0;2;16;2;12;0;4;0;6;0;3;;
Guaraci;De 100 a menos de 200 ha;7;882;7;0;882;0;4;3;4;3;0;0;0;2;0;0;;
Guaraci;De 200 a menos de 500 ha;13;3958;13;0;3958;0;7;6;7;6;0;0;0;5;0;0;;
Guaraci;De 500 a menos de 1.000 ha;1;0;1;0;0;0;1;0;1;0;0;0;0;0;0;0;;
Guaraci;De 1.000 a menos de 2.500 ha;5;6386;5;0;6386;0;4;1;4;1;0;0;0;1;0;0;;
Guaraci;De 2.500 a menos de 10.000 ha;1;0;1;0;0;0;1;0;1;0;0;0;0;0;0;0;;
Guaraci;De 10.000 ha e mais;0;0;0;0;0;0;0;0;0;0;0;0;0;0;0;0;;
Guaraci;Produtor sem área;0;0;0;0;0;0;0;0;0;0;0;0;0;0;0;0;;
Guaraniaçu;Mais de 0 a menos de 0,1 ha;7;0;3;4;0;0;3;4;2;1;1;3;0;1;0;3;;
Guaraniaçu;De 0,1 a menos de 0,2 ha;11;2;7;4;1;1;2;9;1;6;1;3;1;5;0;2;;
Guaraniaçu;De 0,2 a menos de 0,5 ha;30;9;10;20;3;6;7;23;2;8;5;15;0;6;0;11;;
Guaraniaçu;De 0,5 a menos de 1 ha;38;26;14;24;10;16;11;27;2;12;9;15;0;12;0;11;;
Guaraniaçu;De 1 a menos de 2 ha;70;88;25;45;32;56;23;47;9;16;14;31;1;12;0;24;;
Guaraniaçu;De 2 a menos de 3 ha;116;278;35;81;83;195;52;64;16;19;36;45;0;17;1;37;;
Guaraniaçu;De 3 a menos de 4 ha;71;252;16;55;57;194;28;43;3;13;25;30;0;11;0;23;;
Guaraniaçu;De 4 a menos de 5 ha;110;526;31;79;150;376;52;58;12;19;40;39;0;17;0;36;;
Guaraniaçu;De 5 a menos de 10 ha;272;2121;57;215;439;1682;160;112;27;30;133;82;0;27;5;58;;
Guaraniaçu;De 10 a menos de 20 ha;308;4393;51;257;727;3666;204;104;22;29;182;75;0;26;2;61;;
Guaraniaçu;De 20 a menos de 50 ha;271;8528;37;234;1214;7314;212;59;20;17;192;42;0;17;0;38;;
Guaraniaçu;De 50 a menos de 100 ha;146;9994;46;100;3740;6255;119;27;37;9;82;18;0;8;0;15;;
Guaraniaçu;De 100 a menos de 200 ha;81;11252;81;0;11252;0;68;13;68;13;0;0;0;11;0;0;;
Guaraniaçu;De 200 a menos de 500 ha;75;23845;75;0;23845;0;57;18;57;18;0;0;0;18;0;0;;
Guaraniaçu;De 500 a menos de 1.000 ha;32;22203;32;0;22203;0;31;1;31;1;0;0;0;1;0;0;;
Guaraniaçu;De 1.000 a menos de 2.500 ha;17;22071;17;0;22071;0;13;4;13;4;0;0;0;3;0;0;;
Guaraniaçu;De 2.500 a menos de 10.000 ha;3;0;3;0;0;0;2;1;2;1;0;0;0;1;0;0;;
Guaraniaçu;De 10.000 ha e mais;0;0;0;0;0;0;0;0;0;0;0;0;0;0;0;0;;
Guaraniaçu;Produtor sem área;0;0;0;0;0;0;0;0;0;0;0;0;0;0;0;0;;
Guarapuava;Mais de 0 a menos de 0,1 ha;23;1;6;17;0;1;1;22;0;6;1;16;2;3;1;12;;
Guarapuava;De 0,1 a menos de 0,2 ha;8;0;3;5;0;1;3;5;1;2;2;3;0;2;0;3;;
Guarapuava;De 0,2 a menos de 0,5 ha;50;21;23;27;11;11;9;41;5;18;4;23;1;9;1;13;;
Guarapuava;De 0,5 a menos de 1 ha;39;26;18;21;12;14;7;32;2;16;5;16;2;10;1;9;;
Guarapuava;De 1 a menos de 2 ha;78;96;31;47;37;59;19;59;6;25;13;34;2;17;1;29;;
Guarapuava;De 2 a menos de 3 ha;121;290;44;77;107;183;28;93;13;31;15;62;4;11;3;40;;
Guarapuava;De 3 a menos de 4 ha;78;265;28;50;97;168;22;56;7;21;15;35;0;18;3;21;;
Guarapuava;De 4 a menos de 5 ha;104;484;34;70;159;325;33;71;12;22;21;49;1;16;8;28;;
Guarapuava;De 5 a menos de 10 ha;283;2144;83;200;610;1534;114;169;33;50;81;119;6;35;12;76;;
Guarapuava;De 10 a menos de 20 ha;535;7992;101;434;1477;6514;323;212;52;49;271;163;4;30;19;76;;
Guarapuava;De 20 a menos de 50 ha;362;11066;88;274;2687;8379;175;187;35;53;140;134;8;29;17;73;;
Guarapuava;De 50 a menos de 100 ha;144;10019;76;68;5852;4167;103;41;52;24;51;17;3;15;2;9;;
Guarapuava;De 100 a menos de 200 ha;89;12765;87;2;0;0;64;25;63;24;1;1;0;16;0;1;;
Guarapuava;De 200 a menos de 500 ha;128;40331;127;1;0;0;106;22;105;22;1;0;0;18;0;0;;
Guarapuava;De 500 a menos de 1.000 ha;51;34824;51;0;34824;0;48;3;48;3;0;0;0;3;0;0;;
Guarapuava;De 1.000 a menos de 2.500 ha;29;42993;28;1;0;0;23;6;22;6;1;0;0;4;0;0;;
Guarapuava;De 2.500 a menos de 10.000 ha;10;44241;9;1;0;0;8;2;8;1;0;1;0;1;0;1;;
Guarapuava;De 10.000 ha e mais;0;0;0;0;0;0;0;0;0;0;0;0;0;0;0;0;;
Guarapuava;Produtor sem área;2;0;0;2;0;0;1;1;0;0;1;1;0;0;0;1;;
Guaraqueçaba;Mais de 0 a menos de 0,1 ha;63;4;7;56;0;3;0;63;0;7;0;56;0;7;0;55;;
Guaraqueçaba;De 0,1 a menos de 0,2 ha;35;5;3;32;0;4;1;34;0;3;1;31;0;2;0;31;;
Guaraqueçaba;De 0,2 a menos de 0,5 ha;23;6;5;18;1;5;2;21;2;3;0;18;0;3;0;17;;
Guaraqueçaba;De 0,5 a menos de 1 ha;22;14;3;19;2;12;3;19;1;2;2;17;0;1;0;16;;
Guaraqueçaba;De 1 a menos de 2 ha;32;38;7;25;9;29;2;30;1;6;1;24;0;3;0;20;;
Guaraqueçaba;De 2 a menos de 3 ha;40;96;14;26;34;62;5;35;3;11;2;24;0;9;0;16;;
Guaraqueçaba;De 3 a menos de 4 ha;12;42;3;9;10;31;0;12;0;3;0;9;0;1;0;8;;
Guaraqueçaba;De 4 a menos de 5 ha;30;140;3;27;15;125;0;30;0;3;0;27;0;1;0;20;;
Guaraqueçaba;De 5 a menos de 10 ha;53;383;16;37;121;263;7;46;4;12;3;34;0;4;0;23;;
Guaraqueçaba;De 10 a menos de 20 ha;53;764;13;40;172;592;7;46;2;11;5;35;0;8;0;20;;
Guaraqueçaba;De 20 a menos de 50 ha;77;2418;16;61;472;1946;15;62;3;13;12;49;0;7;1;25;;
Guaraqueçaba;De 50 a menos de 100 ha;25;1779;10;15;779;1000;5;20;0;10;5;10;0;3;0;3;;
Guaraqueçaba;De 100 a menos de 200 ha;12;1722;12;0;1722;0;3;9;3;9;0;0;0;1;0;0;;
Guaraqueçaba;De 200 a menos de 500 ha;7;2136;7;0;2136;0;1;6;1;6;0;0;0;3;0;0;;
Guaraqueçaba;De 500 a menos de 1.000 ha;4;2842;4;0;2842;0;0;4;0;4;0;0;0;3;0;0;;
Guaraqueçaba;De 1.000 a menos de 2.500 ha;5;7750;5;0;7750;0;1;4;1;4;0;0;0;2;0;0;;
Guaraqueçaba;De 2.500 a menos de 10.000 ha;0;0;0;0;0;0;0;0;0;0;0;0;0;0;0;0;;
Guaraqueçaba;De 10.000 ha e mais;0;0;0;0;0;0;0;0;0;0;0;0;0;0;0;0;;
Guaraqueçaba;Produtor sem área;0;0;0;0;0;0;0;0;0;0;0;0;0;0;0;0;;
Guaratuba;Mais de 0 a menos de 0,1 ha;8;0;2;6;0;0;0;8;0;2;0;6;0;1;0;4;;
Guaratuba;De 0,1 a menos de 0,2 ha;1;0;1;0;0;0;0;1;0;1;0;0;0;1;0;0;;
Guaratuba;De 0,2 a menos de 0,5 ha;19;6;10;9;3;2;2;17;1;9;1;8;0;8;0;4;;
Guaratuba;De 0,5 a menos de 1 ha;12;8;6;6;0;0;4;8;2;4;2;4;0;2;0;3;;
Guaratuba;De 1 a menos de 2 ha;25;31;10;15;12;19;8;17;3;7;5;10;0;2;0;7;;
Guaratuba;De 2 a menos de 3 ha;38;89;13;25;29;60;11;27;1;12;10;15;0;9;0;11;;
Guaratuba;De 3 a menos de 4 ha;12;40;3;9;10;30;6;6;1;2;5;4;0;2;0;4;;
Guaratuba;De 4 a menos de 5 ha;32;151;6;26;28;123;22;10;3;3;19;7;0;2;0;5;;
Guaratuba;De 5 a menos de 10 ha;61;436;8;53;52;383;49;12;4;4;45;8;0;4;0;5;;
Guaratuba;De 10 a menos de 20 ha;68;968;16;52;228;740;43;25;10;6;33;19;0;3;0;14;;
Guaratuba;De 20 a menos de 50 ha;56;1751;13;43;417;1334;42;14;9;4;33;10;0;4;0;5;;
Guaratuba;De 50 a menos de 100 ha;23;1509;12;11;860;648;15;8;8;4;7;4;0;2;0;3;;
Guaratuba;De 100 a menos de 200 ha;10;1233;10;0;1233;0;7;3;7;3;0;0;0;2;0;0;;
Guaratuba;De 200 a menos de 500 ha;4;1306;4;0;1306;0;3;1;3;1;0;0;0;0;0;0;;
Guaratuba;De 500 a menos de 1.000 ha;3;1960;3;0;1960;0;1;2;1;2;0;0;0;0;0;0;;
Guaratuba;De 1.000 a menos de 2.500 ha;1;0;1;0;0;0;1;0;1;0;0;0;0;0;0;0;;
Guaratuba;De 2.500 a menos de 10.000 ha;3;0;3;0;0;0;1;2;1;2;0;0;0;2;0;0;;
Guaratuba;De 10.000 ha e mais;0;0;0;0;0;0;0;0;0;0;0;0;0;0;0;0;;
Guaratuba;Produtor sem área;0;0;0;0;0;0;0;0;0;0;0;0;0;0;0;0;;
Honório Serpa;Mais de 0 a menos de 0,1 ha;0;0;0;0;0;0;0;0;0;0;0;0;0;0;0;0;;
Honório Serpa;De 0,1 a menos de 0,2 ha;0;0;0;0;0;0;0;0;0;0;0;0;0;0;0;0;;
Honório Serpa;De 0,2 a menos de 0,5 ha;1;0;0;1;0;0;0;1;0;0;0;1;0;0;0;1;;
Honório Serpa;De 0,5 a menos de 1 ha;1;0;1;0;0;0;0;1;0;1;0;0;1;0;0;0;;
Honório Serpa;De 1 a menos de 2 ha;8;10;3;5;4;6;2;6;0;3;2;3;2;0;0;2;;
Honório Serpa;De 2 a menos de 3 ha;12;29;7;5;17;12;8;4;5;2;3;2;0;1;0;2;;
Honório Serpa;De 3 a menos de 4 ha;6;21;2;4;0;0;2;4;1;1;1;3;0;1;1;2;;
Honório Serpa;De 4 a menos de 5 ha;26;124;7;19;33;90;17;9;7;0;10;9;0;0;1;8;;
Honório Serpa;De 5 a menos de 10 ha;58;438;11;47;81;357;49;9;8;3;41;6;0;2;1;5;;
Honório Serpa;De 10 a menos de 20 ha;223;3385;11;212;149;3236;186;37;7;4;179;33;1;2;1;17;;
Honório Serpa;De 20 a menos de 50 ha;300;8054;14;286;381;7673;277;23;14;0;263;23;0;0;2;10;;
Honório Serpa;De 50 a menos de 100 ha;33;2341;9;24;795;1546;29;4;8;1;21;3;1;0;0;3;;
Honório Serpa;De 100 a menos de 200 ha;24;3464;24;0;3464;0;23;1;23;1;0;0;0;0;0;0;;
Honório Serpa;De 200 a menos de 500 ha;23;7459;23;0;7459;0;21;2;21;2;0;0;0;2;0;0;;
Honório Serpa;De 500 a menos de 1.000 ha;8;5518;8;0;5518;0;7;1;7;1;0;0;0;0;0;0;;
Honório Serpa;De 1.000 a menos de 2.500 ha;9;15744;9;0;15744;0;7;2;7;2;0;0;0;1;0;0;;
Honório Serpa;De 2.500 a menos de 10.000 ha;1;0;1;0;0;0;1;0;1;0;0;0;0;0;0;0;;
Honório Serpa;De 10.000 ha e mais;0;0;0;0;0;0;0;0;0;0;0;0;0;0;0;0;;
Honório Serpa;Produtor sem área;0;0;0;0;0;0;0;0;0;0;0;0;0;0;0;0;;
Ibaiti;Mais de 0 a menos de 0,1 ha;6;0;2;4;0;0;0;6;0;2;0;4;0;2;0;3;;
Ibaiti;De 0,1 a menos de 0,2 ha;7;1;3;4;0;0;0;7;0;3;0;4;0;3;1;2;;
Ibaiti;De 0,2 a menos de 0,5 ha;8;2;3;5;1;1;4;4;1;2;3;2;0;2;0;2;;
Ibaiti;De 0,5 a menos de 1 ha;91;51;20;71;12;39;27;64;5;15;22;49;0;9;0;24;;
Ibaiti;De 1 a menos de 2 ha;40;56;13;27;18;38;20;20;4;9;16;11;0;8;0;6;;
Ibaiti;De 2 a menos de 3 ha;66;163;17;49;43;120;26;40;6;11;20;29;1;6;0;18;;
Ibaiti;De 3 a menos de 4 ha;74;254;20;54;67;187;43;31;9;11;34;20;0;8;0;8;;
Ibaiti;De 4 a menos de 5 ha;77;363;11;66;52;311;35;42;5;6;30;36;0;5;0;21;;
Ibaiti;De 5 a menos de 10 ha;276;2052;55;221;395;1657;152;124;22;33;130;91;0;28;2;51;;
Ibaiti;De 10 a menos de 20 ha;417;6005;79;338;1118;4887;206;211;32;47;174;164;0;31;3;100;;
Ibaiti;De 20 a menos de 50 ha;203;6177;44;159;1391;4786;105;98;23;21;82;77;0;18;0;56;;
Ibaiti;De 50 a menos de 100 ha;63;4416;36;27;2817;1599;26;37;16;20;10;17;0;15;2;12;;
Ibaiti;De 100 a menos de 200 ha;46;6913;46;0;6913;0;19;27;19;27;0;0;1;21;0;0;;
Ibaiti;De 200 a menos de 500 ha;54;16940;54;0;16940;0;30;24;30;24;0;0;1;19;0;0;;
Ibaiti;De 500 a menos de 1.000 ha;17;12160;17;0;12160;0;10;7;10;7;0;0;2;5;0;0;;
Ibaiti;De 1.000 a menos de 2.500 ha;6;0;6;0;0;0;3;3;3;3;0;0;0;2;0;0;;
Ibaiti;De 2.500 a menos de 10.000 ha;2;0;2;0;0;0;1;1;1;1;0;0;0;1;0;0;;
Ibaiti;De 10.000 ha e mais;0;0;0;0;0;0;0;0;0;0;0;0;0;0;0;0;;
Ibaiti;Produtor sem área;0;0;0;0;0;0;0;0;0;0;0;0;0;0;0;0;;
Ibema;Mais de 0 a menos de 0,1 ha;51;3;21;30;1;2;2;49;0;21;2;28;0;21;0;27;;
Ibema;De 0,1 a menos de 0,2 ha;26;3;13;13;2;2;1;25;1;12;0;13;0;10;0;12;;
Ibema;De 0,2 a menos de 0,5 ha;4;1;1;3;0;0;0;4;0;1;0;3;0;1;0;2;;
Ibema;De 0,5 a menos de 1 ha;25;13;10;15;5;8;13;12;7;3;6;9;0;0;0;1;;
Ibema;De 1 a menos de 2 ha;7;9;2;5;0;0;4;3;1;1;3;2;0;1;0;0;;
Ibema;De 2 a menos de 3 ha;7;19;2;5;0;0;6;1;2;0;4;1;0;0;0;0;;
Ibema;De 3 a menos de 4 ha;17;61;8;9;29;32;8;9;2;6;6;3;0;3;0;2;;
Ibema;De 4 a menos de 5 ha;14;68;7;7;34;34;9;5;4;3;5;2;0;2;0;2;;
Ibema;De 5 a menos de 10 ha;53;394;14;39;105;289;31;22;4;10;27;12;0;8;0;9;;
Ibema;De 10 a menos de 20 ha;124;1856;14;110;203;1652;108;16;10;4;98;12;0;2;0;6;;
Ibema;De 20 a menos de 50 ha;29;932;3;26;82;850;26;3;1;2;25;1;0;1;0;1;;
Ibema;De 50 a menos de 100 ha;18;1290;10;8;808;482;17;1;9;1;8;0;0;0;0;0;;
Ibema;De 100 a menos de 200 ha;7;968;7;0;968;0;4;3;4;3;0;0;0;1;0;0;;
Ibema;De 200 a menos de 500 ha;8;2481;8;0;2481;0;8;0;8;0;0;0;0;0;0;0;;
Ibema;De 500 a menos de 1.000 ha;2;0;2;0;0;0;2;0;2;0;0;0;0;0;0;0;;
Ibema;De 1.000 a menos de 2.500 ha;3;6461;3;0;6461;0;3;0;3;0;0;0;0;0;0;0;;
Ibema;De 2.500 a menos de 10.000 ha;0;0;0;0;0;0;0;0;0;0;0;0;0;0;0;0;;
Ibema;De 10.000 ha e mais;0;0;0;0;0;0;0;0;0;0;0;0;0;0;0;0;;
Ibema;Produtor sem área;3;0;3;0;0;0;0;1;0;1;0;0;0;1;0;0;;
Ibiporã;Mais de 0 a menos de 0,1 ha;2;0;1;1;0;0;1;1;0;1;1;0;0;1;0;0;;
Ibiporã;De 0,1 a menos de 0,2 ha;12;2;5;7;0;0;1;11;0;5;1;6;1;4;1;4;;
Ibiporã;De 0,2 a menos de 0,5 ha;23;7;9;14;3;4;10;13;4;5;6;8;2;3;2;5;;
Ibiporã;De 0,5 a menos de 1 ha;21;13;6;15;4;9;5;16;2;4;3;12;0;4;3;4;;
Ibiporã;De 1 a menos de 2 ha;25;30;9;16;10;20;12;13;2;7;10;6;1;4;0;5;;
Ibiporã;De 2 a menos de 3 ha;68;154;13;55;30;124;30;38;6;7;24;31;2;4;3;20;;
Ibiporã;De 3 a menos de 4 ha;35;118;8;27;26;92;19;16;6;2;13;14;0;2;3;7;;
Ibiporã;De 4 a menos de 5 ha;26;121;5;21;23;98;18;8;3;2;15;6;0;1;2;3;;
Ibiporã;De 5 a menos de 10 ha;46;344;8;38;63;282;29;17;2;6;27;11;2;4;0;10;;
Ibiporã;De 10 a menos de 20 ha;53;749;7;46;102;647;35;18;1;6;34;12;0;4;2;8;;
Ibiporã;De 20 a menos de 50 ha;74;2503;27;47;1093;1410;57;17;18;9;39;8;1;8;0;7;;
Ibiporã;De 50 a menos de 100 ha;50;3507;50;0;3507;0;44;6;44;6;0;0;0;6;0;0;;
Ibiporã;De 100 a menos de 200 ha;27;3739;27;0;3739;0;25;2;25;2;0;0;0;2;0;0;;
Ibiporã;De 200 a menos de 500 ha;16;5693;16;0;5693;0;15;1;15;1;0;0;0;1;0;0;;
Ibiporã;De 500 a menos de 1.000 ha;4;0;4;0;0;0;4;0;4;0;0;0;0;0;0;0;;
Ibiporã;De 1.000 a menos de 2.500 ha;0;0;0;0;0;0;0;0;0;0;0;0;0;0;0;0;;
Ibiporã;De 2.500 a menos de 10.000 ha;0;0;0;0;0;0;0;0;0;0;0;0;0;0;0;0;;
Ibiporã;De 10.000 ha e mais;0;0;0;0;0;0;0;0;0;0;0;0;0;0;0;0;;
Ibiporã;Produtor sem área;0;0;0;0;0;0;0;0;0;0;0;0;0;0;0;0;;
Icaraíma;Mais de 0 a menos de 0,1 ha;15;1;5;10;0;0;2;13;0;5;2;8;0;5;0;8;;
Icaraíma;De 0,1 a menos de 0,2 ha;2;0;0;2;0;0;1;1;0;0;1;1;0;0;0;1;;
Icaraíma;De 0,2 a menos de 0,5 ha;0;0;0;0;0;0;0;0;0;0;0;0;0;0;0;0;;
Icaraíma;De 0,5 a menos de 1 ha;22;11;11;11;6;6;7;15;2;9;5;6;0;7;0;4;;
Icaraíma;De 1 a menos de 2 ha;5;0;2;3;0;0;1;4;0;2;1;2;0;2;0;1;;
Icaraíma;De 2 a menos de 3 ha;24;58;6;18;15;44;4;20;1;5;3;15;0;5;0;12;;
Icaraíma;De 3 a menos de 4 ha;26;89;2;24;0;0;5;21;1;1;4;20;0;1;0;12;;
Icaraíma;De 4 a menos de 5 ha;40;193;8;32;39;154;7;33;0;8;7;25;0;6;0;14;;
Icaraíma;De 5 a menos de 10 ha;89;657;10;79;74;583;24;65;2;8;22;57;0;4;2;38;;
Icaraíma;De 10 a menos de 20 ha;162;2308;14;148;179;2129;57;105;5;9;52;96;0;5;4;60;;
Icaraíma;De 20 a menos de 50 ha;106;3477;5;101;161;3315;36;70;4;1;32;69;0;0;2;35;;
Icaraíma;De 50 a menos de 100 ha;45;3228;17;28;1402;1826;21;24;10;7;11;17;0;5;2;11;;
Icaraíma;De 100 a menos de 200 ha;28;3965;28;0;3965;0;10;18;10;18;0;0;0;16;0;0;;
Icaraíma;De 200 a menos de 500 ha;37;11455;37;0;11455;0;9;28;9;28;0;0;0;16;0;0;;
Icaraíma;De 500 a menos de 1.000 ha;11;7725;11;0;7725;0;5;6;5;6;0;0;0;6;0;0;;
Icaraíma;De 1.000 a menos de 2.500 ha;8;11849;8;0;11849;0;2;6;2;6;0;0;0;3;0;0;;
Icaraíma;De 2.500 a menos de 10.000 ha;0;0;0;0;0;0;0;0;0;0;0;0;0;0;0;0;;
Icaraíma;De 10.000 ha e mais;1;0;1;0;0;0;1;0;1;0;0;0;0;0;0;0;;
Icaraíma;Produtor sem área;9;0;1;8;0;0;0;0;0;0;0;0;0;0;0;0;;
Iguaraçu;Mais de 0 a menos de 0,1 ha;0;0;0;0;0;0;0;0;0;0;0;0;0;0;0;0;;
Iguaraçu;De 0,1 a menos de 0,2 ha;0;0;0;0;0;0;0;0;0;0;0;0;0;0;0;0;;
Iguaraçu;De 0,2 a menos de 0,5 ha;10;3;2;8;0;0;0;10;0;2;0;8;2;0;5;2;;
Iguaraçu;De 0,5 a menos de 1 ha;48;26;1;47;0;0;15;33;1;0;14;33;0;0;16;8;;
Iguaraçu;De 1 a menos de 2 ha;10;14;0;10;0;14;3;7;0;0;3;7;0;0;5;1;;
Iguaraçu;De 2 a menos de 3 ha;5;12;1;4;0;0;1;4;0;1;1;3;0;1;3;0;;
Iguaraçu;De 3 a menos de 4 ha;20;65;4;16;13;52;3;17;1;3;2;14;2;1;7;2;;
Iguaraçu;De 4 a menos de 5 ha;5;24;1;4;0;0;3;2;1;0;2;2;0;0;2;0;;
Iguaraçu;De 5 a menos de 10 ha;29;207;4;25;27;180;9;20;1;3;8;17;2;1;11;4;;
Iguaraçu;De 10 a menos de 20 ha;24;328;5;19;68;260;8;16;0;5;8;11;3;1;9;0;;
Iguaraçu;De 20 a menos de 50 ha;22;650;2;20;0;0;14;8;1;1;13;7;0;0;3;1;;
Iguaraçu;De 50 a menos de 100 ha;20;1560;17;3;1382;179;17;3;14;3;3;0;2;0;0;0;;
Iguaraçu;De 100 a menos de 200 ha;4;0;4;0;0;0;4;0;4;0;0;0;0;0;0;0;;
Iguaraçu;De 200 a menos de 500 ha;19;5818;19;0;5818;0;17;2;17;2;0;0;0;2;0;0;;
Iguaraçu;De 500 a menos de 1.000 ha;6;3954;6;0;3954;0;6;0;6;0;0;0;0;0;0;0;;
Iguaraçu;De 1.000 a menos de 2.500 ha;1;0;1;0;0;0;1;0;1;0;0;0;0;0;0;0;;
Iguaraçu;De 2.500 a menos de 10.000 ha;0;0;0;0;0;0;0;0;0;0;0;0;0;0;0;0;;
Iguaraçu;De 10.000 ha e mais;0;0;0;0;0;0;0;0;0;0;0;0;0;0;0;0;;
Iguaraçu;Produtor sem área;0;0;0;0;0;0;0;0;0;0;0;0;0;0;0;0;;
Iguatu;Mais de 0 a menos de 0,1 ha;2;0;1;1;0;0;2;0;1;0;1;0;0;0;0;0;;
Iguatu;De 0,1 a menos de 0,2 ha;1;0;1;0;0;0;1;0;1;0;0;0;0;0;0;0;;
Iguatu;De 0,2 a menos de 0,5 ha;2;0;1;1;0;0;1;1;1;0;0;1;0;0;0;1;;
Iguatu;De 0,5 a menos de 1 ha;25;15;10;15;6;9;9;16;3;7;6;9;0;1;0;1;;
Iguatu;De 1 a menos de 2 ha;12;15;4;8;5;10;5;7;2;2;3;5;0;0;0;0;;
Iguatu;De 2 a menos de 3 ha;23;56;6;17;15;41;12;11;2;4;10;7;1;0;0;2;;
Iguatu;De 3 a menos de 4 ha;17;59;3;14;11;49;11;6;1;2;10;4;0;0;0;1;;
Iguatu;De 4 a menos de 5 ha;35;169;6;29;29;140;15;20;2;4;13;16;0;1;0;2;;
Iguatu;De 5 a menos de 10 ha;44;344;9;35;70;274;31;13;5;4;26;9;0;0;0;2;;
Iguatu;De 10 a menos de 20 ha;31;434;2;29;0;0;21;10;0;2;21;8;0;1;0;3;;
Iguatu;De 20 a menos de 50 ha;34;1143;2;32;0;0;30;4;2;0;28;4;0;0;0;0;;
Iguatu;De 50 a menos de 100 ha;13;857;9;4;0;0;12;1;8;1;4;0;0;1;0;0;;
Iguatu;De 100 a menos de 200 ha;13;1809;13;0;1809;0;13;0;13;0;0;0;0;0;0;0;;
Iguatu;De 200 a menos de 500 ha;7;2175;7;0;2175;0;6;1;6;1;0;0;0;0;0;0;;
Iguatu;De 500 a menos de 1.000 ha;3;1900;3;0;1900;0;2;1;2;1;0;0;0;0;0;0;;
Iguatu;De 1.000 a menos de 2.500 ha;0;0;0;0;0;0;0;0;0;0;0;0;0;0;0;0;;
Iguatu;De 2.500 a menos de 10.000 ha;0;0;0;0;0;0;0;0;0;0;0;0;0;0;0;0;;
Iguatu;De 10.000 ha e mais;0;0;0;0;0;0;0;0;0;0;0;0;0;0;0;0;;
Iguatu;Produtor sem área;3;0;1;2;0;0;0;1;0;0;0;1;0;0;0;1;;
Imbaú;Mais de 0 a menos de 0,1 ha;10;1;4;6;0;0;3;7;0;4;3;3;0;3;0;2;;
Imbaú;De 0,1 a menos de 0,2 ha;13;2;5;8;1;1;1;12;1;4;0;8;1;2;0;6;;
Imbaú;De 0,2 a menos de 0,5 ha;45;19;15;30;6;13;2;43;1;14;1;29;0;4;2;9;;
Imbaú;De 0,5 a menos de 1 ha;28;19;11;17;8;11;4;24;2;9;2;15;1;7;1;8;;
Imbaú;De 1 a menos de 2 ha;50;67;16;34;20;47;14;36;5;11;9;25;0;10;2;13;;
Imbaú;De 2 a menos de 3 ha;61;146;28;33;67;79;17;44;5;23;12;21;2;15;1;12;;
Imbaú;De 3 a menos de 4 ha;26;90;13;13;45;45;8;18;4;9;4;9;0;6;0;5;;
Imbaú;De 4 a menos de 5 ha;63;300;27;36;128;172;18;45;7;20;11;25;1;13;1;19;;
Imbaú;De 5 a menos de 10 ha;80;590;28;52;215;376;25;55;6;22;19;33;0;16;0;23;;
Imbaú;De 10 a menos de 20 ha;82;1197;25;57;366;830;38;44;4;21;34;23;1;16;0;13;;
Imbaú;De 20 a menos de 50 ha;74;2053;13;61;398;1655;38;36;2;11;36;25;1;7;4;15;;
Imbaú;De 50 a menos de 100 ha;22;1661;15;7;0;0;10;12;6;9;4;3;0;9;0;1;;
Imbaú;De 100 a menos de 200 ha;7;881;7;0;881;0;2;5;2;5;0;0;0;4;0;0;;
Imbaú;De 200 a menos de 500 ha;12;4087;12;0;4087;0;7;5;7;5;0;0;0;2;0;0;;
Imbaú;De 500 a menos de 1.000 ha;5;0;5;0;0;0;4;1;4;1;0;0;0;1;0;0;;
Imbaú;De 1.000 a menos de 2.500 ha;1;0;1;0;0;0;1;0;1;0;0;0;0;0;0;0;;
Imbaú;De 2.500 a menos de 10.000 ha;1;0;1;0;0;0;1;0;1;0;0;0;0;0;0;0;;
Imbaú;De 10.000 ha e mais;0;0;0;0;0;0;0;0;0;0;0;0;0;0;0;0;;
Imbaú;Produtor sem área;0;0;0;0;0;0;0;0;0;0;0;0;0;0;0;0;;
Imbituva;Mais de 0 a menos de 0,1 ha;26;2;1;25;0;0;0;26;0;1;0;25;1;0;7;13;;
Imbituva;De 0,1 a menos de 0,2 ha;20;3;0;20;0;3;6;14;0;0;6;14;0;0;2;4;;
Imbituva;De 0,2 a menos de 0,5 ha;25;9;0;25;0;9;4;21;0;0;4;21;0;0;4;10;;
Imbituva;De 0,5 a menos de 1 ha;27;20;4;23;3;17;11;16;2;2;9;14;0;2;3;8;;
Imbituva;De 1 a menos de 2 ha;78;113;7;71;10;104;48;30;3;4;45;26;0;4;4;15;;
Imbituva;De 2 a menos de 3 ha;124;308;1;123;0;0;99;25;1;0;98;25;0;0;4;15;;
Imbituva;De 3 a menos de 4 ha;132;464;4;128;14;450;115;17;3;1;112;16;0;1;4;6;;
Imbituva;De 4 a menos de 5 ha;148;699;4;144;19;680;127;21;3;1;124;20;0;1;3;10;;
Imbituva;De 5 a menos de 10 ha;380;2859;9;371;65;2794;337;43;7;2;330;41;1;1;8;25;;
Imbituva;De 10 a menos de 20 ha;294;4251;3;291;33;4218;275;19;1;2;274;17;0;2;1;12;;
Imbituva;De 20 a menos de 50 ha;202;6344;7;195;222;6123;183;19;5;2;178;17;0;2;1;13;;
Imbituva;De 50 a menos de 100 ha;79;5213;38;41;2927;2286;69;10;32;6;37;4;1;3;0;4;;
Imbituva;De 100 a menos de 200 ha;32;4764;32;0;4764;0;29;3;29;3;0;0;0;2;0;0;;
Imbituva;De 200 a menos de 500 ha;18;5701;18;0;5701;0;18;0;18;0;0;0;0;0;0;0;;
Imbituva;De 500 a menos de 1.000 ha;8;5475;8;0;5475;0;8;0;8;0;0;0;0;0;0;0;;
Imbituva;De 1.000 a menos de 2.500 ha;5;0;5;0;0;0;4;1;4;1;0;0;0;0;0;0;;
Imbituva;De 2.500 a menos de 10.000 ha;1;0;1;0;0;0;1;0;1;0;0;0;0;0;0;0;;
Imbituva;De 10.000 ha e mais;0;0;0;0;0;0;0;0;0;0;0;0;0;0;0;0;;
Imbituva;Produtor sem área;0;0;0;0;0;0;0;0;0;0;0;0;0;0;0;0;;
Inácio Martins;Mais de 0 a menos de 0,1 ha;0;0;0;0;0;0;0;0;0;0;0;0;0;0;0;0;;
Inácio Martins;De 0,1 a menos de 0,2 ha;30;5;15;15;2;2;0;30;0;15;0;15;2;11;0;15;;
Inácio Martins;De 0,2 a menos de 0,5 ha;27;9;9;18;3;6;2;25;0;9;2;16;0;8;1;15;;
Inácio Martins;De 0,5 a menos de 1 ha;27;19;10;17;6;12;4;23;0;10;4;13;0;9;0;11;;
Inácio Martins;De 1 a menos de 2 ha;42;53;15;27;18;35;1;41;1;14;0;27;0;9;1;21;;
Inácio Martins;De 2 a menos de 3 ha;43;106;18;25;44;61;5;38;2;16;3;22;2;10;1;19;;
Inácio Martins;De 3 a menos de 4 ha;21;73;7;14;25;48;5;16;1;6;4;10;0;6;1;8;;
Inácio Martins;De 4 a menos de 5 ha;32;152;9;23;43;109;2;30;0;9;2;21;0;7;2;16;;
Inácio Martins;De 5 a menos de 10 ha;88;656;32;56;229;427;13;75;2;30;11;45;5;18;3;33;;
Inácio Martins;De 10 a menos de 20 ha;193;3119;53;140;834;2285;52;141;11;42;41;99;8;29;5;74;;
Inácio Martins;De 20 a menos de 50 ha;173;5215;34;139;1037;4178;50;123;6;28;44;95;5;20;7;63;;
Inácio Martins;De 50 a menos de 100 ha;52;3629;17;35;1325;2303;15;37;0;17;15;20;5;11;5;11;;
Inácio Martins;De 100 a menos de 200 ha;32;4538;29;3;4151;387;12;20;12;17;0;3;0;13;1;2;;
Inácio Martins;De 200 a menos de 500 ha;16;4682;15;1;0;0;4;12;4;11;0;1;1;9;0;1;;
Inácio Martins;De 500 a menos de 1.000 ha;5;3534;5;0;3534;0;2;3;2;3;0;0;0;3;0;0;;
Inácio Martins;De 1.000 a menos de 2.500 ha;7;10239;5;2;0;0;3;4;3;2;0;2;0;2;0;2;;
Inácio Martins;De 2.500 a menos de 10.000 ha;6;25185;6;0;25185;0;3;3;3;3;0;0;1;1;0;0;;
Inácio Martins;De 10.000 ha e mais;0;0;0;0;0;0;0;0;0;0;0;0;0;0;0;0;;
Inácio Martins;Produtor sem área;0;0;0;0;0;0;0;0;0;0;0;0;0;0;0;0;;
Inajá;Mais de 0 a menos de 0,1 ha;0;0;0;0;0;0;0;0;0;0;0;0;0;0;0;0;;
Inajá;De 0,1 a menos de 0,2 ha;0;0;0;0;0;0;0;0;0;0;0;0;0;0;0;0;;
Inajá;De 0,2 a menos de 0,5 ha;1;0;0;1;0;0;0;1;0;0;0;1;0;0;0;1;;
Inajá;De 0,5 a menos de 1 ha;40;20;23;17;12;9;1;39;1;22;0;17;2;18;1;13;;
Inajá;De 1 a menos de 2 ha;1;0;0;1;0;0;0;1;0;0;0;1;0;0;0;1;;
Inajá;De 2 a menos de 3 ha;11;27;5;6;12;15;0;11;0;5;0;6;0;3;0;6;;
Inajá;De 3 a menos de 4 ha;1;0;1;0;0;0;0;1;0;1;0;0;0;1;0;0;;
Inajá;De 4 a menos de 5 ha;2;0;1;1;0;0;1;1;1;0;0;1;0;0;0;1;;
Inajá;De 5 a menos de 10 ha;12;101;6;6;50;51;1;11;1;5;0;6;0;4;0;4;;
Inajá;De 10 a menos de 20 ha;12;169;7;5;100;69;1;11;1;6;0;5;0;5;0;3;;
Inajá;De 20 a menos de 50 ha;15;445;6;9;169;276;1;14;0;6;1;8;0;4;0;4;;
Inajá;De 50 a menos de 100 ha;10;774;3;7;273;501;3;7;2;1;1;6;0;0;0;5;;
Inajá;De 100 a menos de 200 ha;3;393;3;0;393;0;2;1;2;1;0;0;0;0;0;0;;
Inajá;De 200 a menos de 500 ha;9;2524;9;0;2524;0;4;5;4;5;0;0;0;4;0;0;;
Inajá;De 500 a menos de 1.000 ha;1;0;1;0;0;0;0;1;0;1;0;0;0;1;0;0;;
Inajá;De 1.000 a menos de 2.500 ha;1;0;1;0;0;0;0;1;0;1;0;0;0;1;0;0;;
Inajá;De 2.500 a menos de 10.000 ha;1;0;1;0;0;0;1;0;1;0;0;0;0;0;0;0;;
Inajá;De 10.000 ha e mais;0;0;0;0;0;0;0;0;0;0;0;0;0;0;0;0;;
Inajá;Produtor sem área;0;0;0;0;0;0;0;0;0;0;0;0;0;0;0;0;;
Indianópolis;Mais de 0 a menos de 0,1 ha;2;0;1;1;0;0;1;1;1;0;0;1;0;0;0;1;;
Indianópolis;De 0,1 a menos de 0,2 ha;1;0;0;1;0;0;0;1;0;0;0;1;0;0;0;1;;
Indianópolis;De 0,2 a menos de 0,5 ha;6;2;2;4;0;0;1;5;0;2;1;3;0;2;0;3;;
Indianópolis;De 0,5 a menos de 1 ha;8;5;3;5;0;0;2;6;1;2;1;4;0;1;0;4;;
Indianópolis;De 1 a menos de 2 ha;24;31;3;21;5;27;8;16;2;1;6;15;0;0;0;12;;
Indianópolis;De 2 a menos de 3 ha;31;76;8;23;20;56;8;23;0;8;8;15;0;7;0;12;;
Indianópolis;De 3 a menos de 4 ha;45;153;17;28;57;96;13;32;4;13;9;19;0;10;0;14;;
Indianópolis;De 4 a menos de 5 ha;51;238;13;38;61;177;19;32;4;9;15;23;0;8;0;17;;
Indianópolis;De 5 a menos de 10 ha;104;778;29;75;230;548;46;58;12;17;34;41;0;15;0;34;;
Indianópolis;De 10 a menos de 20 ha;57;808;12;45;169;639;27;30;3;9;24;21;0;2;0;10;;
Indianópolis;De 20 a menos de 50 ha;43;1297;11;32;357;940;23;20;3;8;20;12;0;4;0;7;;
Indianópolis;De 50 a menos de 100 ha;13;982;4;9;324;657;10;3;4;0;6;3;0;0;0;1;;
Indianópolis;De 100 a menos de 200 ha;10;1552;10;0;1552;0;8;2;8;2;0;0;0;1;0;0;;
Indianópolis;De 200 a menos de 500 ha;2;0;2;0;0;0;2;0;2;0;0;0;0;0;0;0;;
Indianópolis;De 500 a menos de 1.000 ha;0;0;0;0;0;0;0;0;0;0;0;0;0;0;0;0;;
Indianópolis;De 1.000 a menos de 2.500 ha;0;0;0;0;0;0;0;0;0;0;0;0;0;0;0;0;;
Indianópolis;De 2.500 a menos de 10.000 ha;1;0;1;0;0;0;1;0;1;0;0;0;0;0;0;0;;
Indianópolis;De 10.000 ha e mais;0;0;0;0;0;0;0;0;0;0;0;0;0;0;0;0;;
Indianópolis;Produtor sem área;0;0;0;0;0;0;0;0;0;0;0;0;0;0;0;0;;
Ipiranga;Mais de 0 a menos de 0,1 ha;1;0;0;1;0;0;0;1;0;0;0;1;0;0;0;1;;
Ipiranga;De 0,1 a menos de 0,2 ha;3;0;0;3;0;0;0;3;0;0;0;3;0;0;0;3;;
Ipiranga;De 0,2 a menos de 0,5 ha;39;17;2;37;0;0;15;24;0;2;15;22;0;1;3;15;;
Ipiranga;De 0,5 a menos de 1 ha;19;12;1;18;0;0;14;5;0;1;14;4;0;1;0;2;;
Ipiranga;De 1 a menos de 2 ha;48;69;6;42;8;62;33;15;1;5;32;10;1;2;1;7;;
Ipiranga;De 2 a menos de 3 ha;140;341;12;128;27;314;118;22;7;5;111;17;0;3;0;11;;
Ipiranga;De 3 a menos de 4 ha;202;719;8;194;29;690;192;10;6;2;186;8;0;1;0;5;;
Ipiranga;De 4 a menos de 5 ha;198;939;14;184;67;873;186;12;10;4;176;8;0;4;0;7;;
Ipiranga;De 5 a menos de 10 ha;422;3206;20;402;151;3056;382;40;14;6;368;34;1;4;4;21;;
Ipiranga;De 10 a menos de 20 ha;333;4776;13;320;197;4579;310;23;8;5;302;18;2;3;0;10;;
Ipiranga;De 20 a menos de 50 ha;214;6708;12;202;369;6339;192;22;9;3;183;19;0;1;0;14;;
Ipiranga;De 50 a menos de 100 ha;53;3733;18;35;1500;2234;46;7;16;2;30;5;0;2;1;4;;
Ipiranga;De 100 a menos de 200 ha;44;6157;44;0;6157;0;38;6;38;6;0;0;0;5;0;0;;
Ipiranga;De 200 a menos de 500 ha;32;10056;32;0;10056;0;28;4;28;4;0;0;0;4;0;0;;
Ipiranga;De 500 a menos de 1.000 ha;10;7105;10;0;7105;0;5;5;5;5;0;0;0;5;0;0;;
Ipiranga;De 1.000 a menos de 2.500 ha;8;13270;8;0;13270;0;7;1;7;1;0;0;0;0;0;0;;
Ipiranga;De 2.500 a menos de 10.000 ha;0;0;0;0;0;0;0;0;0;0;0;0;0;0;0;0;;
Ipiranga;De 10.000 ha e mais;0;0;0;0;0;0;0;0;0;0;0;0;0;0;0;0;;
Ipiranga;Produtor sem área;0;0;0;0;0;0;0;0;0;0;0;0;0;0;0;0;;
Iporã;Mais de 0 a menos de 0,1 ha;56;3;11;45;1;3;4;52;0;11;4;41;0;10;2;34;;
Iporã;De 0,1 a menos de 0,2 ha;21;3;8;13;0;0;4;17;1;7;3;10;0;7;1;9;;
Iporã;De 0,2 a menos de 0,5 ha;22;7;5;17;2;5;7;15;2;3;5;12;0;2;0;11;;
Iporã;De 0,5 a menos de 1 ha;102;53;40;62;20;32;15;87;5;35;10;52;2;28;0;43;;
Iporã;De 1 a menos de 2 ha;20;26;2;18;0;0;2;18;0;2;2;16;0;1;0;13;;
Iporã;De 2 a menos de 3 ha;40;99;6;34;15;84;3;37;0;6;3;31;0;6;0;25;;
Iporã;De 3 a menos de 4 ha;44;157;7;37;25;132;2;42;0;7;2;35;0;7;0;26;;
Iporã;De 4 a menos de 5 ha;61;287;9;52;42;244;13;48;5;4;8;44;0;2;0;30;;
Iporã;De 5 a menos de 10 ha;138;1035;12;126;89;946;17;121;1;11;16;110;0;8;0;68;;
Iporã;De 10 a menos de 20 ha;238;3282;15;223;198;3084;61;177;3;12;58;165;0;8;1;102;;
Iporã;De 20 a menos de 50 ha;282;9243;25;257;773;8469;78;204;10;15;68;189;0;10;1;120;;
Iporã;De 50 a menos de 100 ha;107;7602;35;72;3002;4599;30;77;9;26;21;51;0;12;1;28;;
Iporã;De 100 a menos de 200 ha;72;10214;72;0;10214;0;36;36;36;36;0;0;0;18;0;0;;
Iporã;De 200 a menos de 500 ha;43;11893;43;0;11893;0;29;14;29;14;0;0;0;4;0;0;;
Iporã;De 500 a menos de 1.000 ha;14;9705;14;0;9705;0;11;3;11;3;0;0;0;2;0;0;;
Iporã;De 1.000 a menos de 2.500 ha;2;0;2;0;0;0;2;0;2;0;0;0;0;0;0;0;;
Iporã;De 2.500 a menos de 10.000 ha;1;0;1;0;0;0;1;0;1;0;0;0;0;0;0;0;;
Iporã;De 10.000 ha e mais;0;0;0;0;0;0;0;0;0;0;0;0;0;0;0;0;;
Iporã;Produtor sem área;0;0;0;0;0;0;0;0;0;0;0;0;0;0;0;0;;
Iracema do Oeste;Mais de 0 a menos de 0,1 ha;2;0;0;2;0;0;0;2;0;0;0;2;0;0;0;2;;
Iracema do Oeste;De 0,1 a menos de 0,2 ha;0;0;0;0;0;0;0;0;0;0;0;0;0;0;0;0;;
Iracema do Oeste;De 0,2 a menos de 0,5 ha;0;0;0;0;0;0;0;0;0;0;0;0;0;0;0;0;;
Iracema do Oeste;De 0,5 a menos de 1 ha;0;0;0;0;0;0;0;0;0;0;0;0;0;0;0;0;;
Iracema do Oeste;De 1 a menos de 2 ha;15;18;1;14;0;0;8;7;0;1;8;6;0;1;1;5;;
Iracema do Oeste;De 2 a menos de 3 ha;17;42;2;15;0;0;13;4;2;0;11;4;0;0;0;3;;
Iracema do Oeste;De 3 a menos de 4 ha;7;25;0;7;0;25;3;4;0;0;3;4;0;0;0;3;;
Iracema do Oeste;De 4 a menos de 5 ha;12;56;1;11;0;0;10;2;0;1;10;1;0;0;0;1;;
Iracema do Oeste;De 5 a menos de 10 ha;29;197;3;26;21;176;26;3;2;1;24;2;0;1;0;2;;
Iracema do Oeste;De 10 a menos de 20 ha;31;444;1;30;0;0;30;1;1;0;29;1;0;0;1;0;;
Iracema do Oeste;De 20 a menos de 50 ha;40;1223;7;33;224;999;37;3;6;1;31;2;0;1;0;2;;
Iracema do Oeste;De 50 a menos de 100 ha;16;1178;9;7;774;404;15;1;9;0;6;1;0;0;0;1;;
Iracema do Oeste;De 100 a menos de 200 ha;13;1736;13;0;1736;0;12;1;12;1;0;0;0;0;0;0;;
Iracema do Oeste;De 200 a menos de 500 ha;5;1653;5;0;1653;0;5;0;5;0;0;0;0;0;0;0;;
Iracema do Oeste;De 500 a menos de 1.000 ha;2;0;2;0;0;0;2;0;2;0;0;0;0;0;0;0;;
Iracema do Oeste;De 1.000 a menos de 2.500 ha;0;0;0;0;0;0;0;0;0;0;0;0;0;0;0;0;;
Iracema do Oeste;De 2.500 a menos de 10.000 ha;0;0;0;0;0;0;0;0;0;0;0;0;0;0;0;0;;
Iracema do Oeste;De 10.000 ha e mais;0;0;0;0;0;0;0;0;0;0;0;0;0;0;0;0;;
Iracema do Oeste;Produtor sem área;5;0;1;4;0;0;0;0;0;0;0;0;0;0;0;0;;
Irati;Mais de 0 a menos de 0,1 ha;0;0;0;0;0;0;0;0;0;0;0;0;0;0;0;0;;
Irati;De 0,1 a menos de 0,2 ha;5;1;2;3;0;0;1;4;0;2;1;2;0;2;2;0;;
Irati;De 0,2 a menos de 0,5 ha;27;10;17;10;7;3;14;13;11;6;3;7;0;3;1;5;;
Irati;De 0,5 a menos de 1 ha;22;16;6;16;4;12;11;11;4;2;7;9;0;2;2;5;;
Irati;De 1 a menos de 2 ha;51;76;13;38;19;57;31;20;6;7;25;13;1;3;1;9;;
Irati;De 2 a menos de 3 ha;109;270;11;98;29;242;74;35;9;2;65;33;0;1;2;21;;
Irati;De 3 a menos de 4 ha;111;385;12;99;40;345;85;26;9;3;76;23;1;2;0;17;;
Irati;De 4 a menos de 5 ha;141;667;6;135;27;640;116;25;2;4;114;21;0;2;3;15;;
Irati;De 5 a menos de 10 ha;464;3568;20;444;150;3418;419;45;12;8;407;37;0;7;4;26;;
Irati;De 10 a menos de 20 ha;588;8651;13;575;200;8451;538;50;8;5;530;45;1;4;4;28;;
Irati;De 20 a menos de 50 ha;615;19156;20;595;632;18525;581;34;10;10;571;24;0;9;5;13;;
Irati;De 50 a menos de 100 ha;176;11945;87;89;6917;5028;169;7;82;5;87;2;0;5;0;2;;
Irati;De 100 a menos de 200 ha;50;6942;50;0;6942;0;44;6;44;6;0;0;0;6;0;0;;
Irati;De 200 a menos de 500 ha;26;7977;26;0;7977;0;22;4;22;4;0;0;0;4;0;0;;
Irati;De 500 a menos de 1.000 ha;3;1926;3;0;1926;0;2;1;2;1;0;0;0;1;0;0;;
Irati;De 1.000 a menos de 2.500 ha;3;5985;2;1;0;0;1;2;1;1;0;1;0;1;0;1;;
Irati;De 2.500 a menos de 10.000 ha;1;0;1;0;0;0;0;1;0;1;0;0;0;1;0;0;;
Irati;De 10.000 ha e mais;0;0;0;0;0;0;0;0;0;0;0;0;0;0;0;0;;
Irati;Produtor sem área;2;0;1;1;0;0;1;0;1;0;0;0;0;0;0;0;;
Iretama;Mais de 0 a menos de 0,1 ha;8;0;1;7;0;0;2;6;0;1;2;5;0;0;0;5;;
Iretama;De 0,1 a menos de 0,2 ha;7;1;1;6;0;0;0;7;0;1;0;6;0;1;0;6;;
Iretama;De 0,2 a menos de 0,5 ha;6;2;2;4;0;0;1;5;0;2;1;3;0;1;0;1;;
Iretama;De 0,5 a menos de 1 ha;142;73;23;119;12;61;22;120;8;15;14;105;2;10;0;72;;
Iretama;De 1 a menos de 2 ha;25;33;4;21;5;27;8;17;1;3;7;14;0;1;0;13;;
Iretama;De 2 a menos de 3 ha;30;73;0;30;0;73;13;17;0;0;13;17;0;0;0;7;;
Iretama;De 3 a menos de 4 ha;24;82;6;18;21;61;9;15;2;4;7;11;0;1;0;5;;
Iretama;De 4 a menos de 5 ha;65;312;1;64;0;0;39;26;0;1;39;25;0;0;2;16;;
Iretama;De 5 a menos de 10 ha;157;1221;14;143;118;1103;81;76;10;4;71;72;1;2;3;46;;
Iretama;De 10 a menos de 20 ha;319;4524;17;302;231;4293;202;117;15;2;187;115;1;1;7;79;;
Iretama;De 20 a menos de 50 ha;253;7209;8;245;292;6917;178;75;4;4;174;71;0;3;2;45;;
Iretama;De 50 a menos de 100 ha;61;4383;28;33;2338;2045;50;11;23;5;27;6;0;5;0;4;;
Iretama;De 100 a menos de 200 ha;37;5065;37;0;5065;0;22;15;22;15;0;0;3;11;0;0;;
Iretama;De 200 a menos de 500 ha;37;11091;37;0;11091;0;30;7;30;7;0;0;1;6;0;0;;
Iretama;De 500 a menos de 1.000 ha;8;6060;8;0;6060;0;6;2;6;2;0;0;0;1;0;0;;
Iretama;De 1.000 a menos de 2.500 ha;4;5991;4;0;5991;0;3;1;3;1;0;0;0;0;0;0;;
Iretama;De 2.500 a menos de 10.000 ha;0;0;0;0;0;0;0;0;0;0;0;0;0;0;0;0;;
Iretama;De 10.000 ha e mais;0;0;0;0;0;0;0;0;0;0;0;0;0;0;0;0;;
Iretama;Produtor sem área;0;0;0;0;0;0;0;0;0;0;0;0;0;0;0;0;;
Itaguajé;Mais de 0 a menos de 0,1 ha;1;0;1;0;0;0;0;1;0;1;0;0;0;0;0;0;;
Itaguajé;De 0,1 a menos de 0,2 ha;0;0;0;0;0;0;0;0;0;0;0;0;0;0;0;0;;
Itaguajé;De 0,2 a menos de 0,5 ha;0;0;0;0;0;0;0;0;0;0;0;0;0;0;0;0;;
Itaguajé;De 0,5 a menos de 1 ha;1;0;1;0;0;0;0;1;0;1;0;0;0;1;0;0;;
Itaguajé;De 1 a menos de 2 ha;3;4;1;2;0;0;1;2;1;0;0;2;0;0;0;2;;
Itaguajé;De 2 a menos de 3 ha;3;0;0;3;0;0;0;3;0;0;0;3;0;0;0;3;;
Itaguajé;De 3 a menos de 4 ha;5;16;1;4;0;0;2;3;0;1;2;2;0;1;0;2;;
Itaguajé;De 4 a menos de 5 ha;15;72;2;13;0;0;5;10;0;2;5;8;0;2;0;6;;
Itaguajé;De 5 a menos de 10 ha;23;174;6;17;40;134;7;16;0;6;7;10;0;6;0;10;;
Itaguajé;De 10 a menos de 20 ha;158;2498;23;135;355;2144;111;47;12;11;99;36;0;10;2;29;;
Itaguajé;De 20 a menos de 50 ha;36;1026;2;34;0;0;17;19;0;2;17;17;0;1;0;14;;
Itaguajé;De 50 a menos de 100 ha;12;894;10;2;0;0;9;3;7;3;2;0;0;3;0;0;;
Itaguajé;De 100 a menos de 200 ha;8;983;8;0;983;0;6;2;6;2;0;0;0;1;0;0;;
Itaguajé;De 200 a menos de 500 ha;5;1580;5;0;1580;0;4;1;4;1;0;0;0;0;0;0;;
Itaguajé;De 500 a menos de 1.000 ha;2;0;2;0;0;0;1;1;1;1;0;0;0;0;0;0;;
Itaguajé;De 1.000 a menos de 2.500 ha;0;0;0;0;0;0;0;0;0;0;0;0;0;0;0;0;;
Itaguajé;De 2.500 a menos de 10.000 ha;1;0;1;0;0;0;1;0;1;0;0;0;0;0;0;0;;
Itaguajé;De 10.000 ha e mais;0;0;0;0;0;0;0;0;0;0;0;0;0;0;0;0;;
Itaguajé;Produtor sem área;0;0;0;0;0;0;0;0;0;0;0;0;0;0;0;0;;
Itaipulândia;Mais de 0 a menos de 0,1 ha;1;0;1;0;0;0;0;1;0;1;0;0;0;0;0;0;;
Itaipulândia;De 0,1 a menos de 0,2 ha;0;0;0;0;0;0;0;0;0;0;0;0;0;0;0;0;;
Itaipulândia;De 0,2 a menos de 0,5 ha;5;2;3;2;0;0;2;3;2;1;0;2;0;1;1;1;;
Itaipulândia;De 0,5 a menos de 1 ha;60;31;23;37;12;19;11;49;3;20;8;29;4;13;1;22;;
Itaipulândia;De 1 a menos de 2 ha;29;39;9;20;12;27;6;23;1;8;5;15;2;6;4;11;;
Itaipulândia;De 2 a menos de 3 ha;53;129;12;41;29;100;27;26;5;7;22;19;2;5;3;15;;
Itaipulândia;De 3 a menos de 4 ha;42;147;7;35;24;123;23;19;1;6;22;13;0;5;1;10;;
Itaipulândia;De 4 a menos de 5 ha;32;148;2;30;0;0;25;7;1;1;24;6;0;1;0;5;;
Itaipulândia;De 5 a menos de 10 ha;93;706;5;88;37;669;77;16;2;3;75;13;0;3;1;10;;
Itaipulândia;De 10 a menos de 20 ha;80;1126;11;69;142;985;66;14;5;6;61;8;1;5;2;5;;
Itaipulândia;De 20 a menos de 50 ha;66;1940;9;57;274;1666;62;4;5;4;57;0;0;4;0;0;;
Itaipulândia;De 50 a menos de 100 ha;22;1450;6;16;501;948;22;0;6;0;16;0;0;0;0;0;;
Itaipulândia;De 100 a menos de 200 ha;14;1967;14;0;1967;0;14;0;14;0;0;0;0;0;0;0;;
Itaipulândia;De 200 a menos de 500 ha;7;1941;7;0;1941;0;7;0;7;0;0;0;0;0;0;0;;
Itaipulândia;De 500 a menos de 1.000 ha;3;0;3;0;0;0;3;0;3;0;0;0;0;0;0;0;;
Itaipulândia;De 1.000 a menos de 2.500 ha;1;0;1;0;0;0;1;0;1;0;0;0;0;0;0;0;;
Itaipulândia;De 2.500 a menos de 10.000 ha;0;0;0;0;0;0;0;0;0;0;0;0;0;0;0;0;;
Itaipulândia;De 10.000 ha e mais;0;0;0;0;0;0;0;0;0;0;0;0;0;0;0;0;;
Itaipulândia;Produtor sem área;9;0;3;6;0;0;0;0;0;0;0;0;0;0;0;0;;
Itambaracá;Mais de 0 a menos de 0,1 ha;0;0;0;0;0;0;0;0;0;0;0;0;0;0;0;0;;
Itambaracá;De 0,1 a menos de 0,2 ha;0;0;0;0;0;0;0;0;0;0;0;0;0;0;0;0;;
Itambaracá;De 0,2 a menos de 0,5 ha;6;3;3;3;1;1;4;2;2;1;2;1;0;1;0;1;;
Itambaracá;De 0,5 a menos de 1 ha;6;4;0;6;0;4;5;1;0;0;5;1;0;0;0;0;;
Itambaracá;De 1 a menos de 2 ha;6;9;1;5;0;0;4;2;1;0;3;2;0;0;2;0;;
Itambaracá;De 2 a menos de 3 ha;4;10;1;3;0;0;3;1;0;1;3;0;0;1;0;0;;
Itambaracá;De 3 a menos de 4 ha;4;15;0;4;0;15;4;0;0;0;4;0;0;0;0;0;;
Itambaracá;De 4 a menos de 5 ha;6;29;1;5;0;0;5;1;0;1;5;0;0;1;0;0;;
Itambaracá;De 5 a menos de 10 ha;28;220;3;25;25;194;24;4;3;0;21;4;0;0;0;2;;
Itambaracá;De 10 a menos de 20 ha;30;459;6;24;89;371;25;5;3;3;22;2;0;3;0;2;;
Itambaracá;De 20 a menos de 50 ha;40;1286;4;36;115;1171;36;4;3;1;33;3;0;1;0;2;;
Itambaracá;De 50 a menos de 100 ha;25;1899;16;9;1377;523;25;0;16;0;9;0;0;0;0;0;;
Itambaracá;De 100 a menos de 200 ha;18;2714;18;0;2714;0;18;0;18;0;0;0;0;0;0;0;;
Itambaracá;De 200 a menos de 500 ha;20;6495;20;0;6495;0;20;0;20;0;0;0;0;0;0;0;;
Itambaracá;De 500 a menos de 1.000 ha;4;2928;4;0;2928;0;4;0;4;0;0;0;0;0;0;0;;
Itambaracá;De 1.000 a menos de 2.500 ha;2;0;2;0;0;0;2;0;2;0;0;0;0;0;0;0;;
Itambaracá;De 2.500 a menos de 10.000 ha;0;0;0;0;0;0;0;0;0;0;0;0;0;0;0;0;;
Itambaracá;De 10.000 ha e mais;0;0;0;0;0;0;0;0;0;0;0;0;0;0;0;0;;
Itambaracá;Produtor sem área;3;0;3;0;0;0;0;2;0;2;0;0;0;2;0;0;;
Itambé;Mais de 0 a menos de 0,1 ha;0;0;0;0;0;0;0;0;0;0;0;0;0;0;0;0;;
Itambé;De 0,1 a menos de 0,2 ha;4;0;2;2;0;0;0;4;0;2;0;2;0;2;0;2;;
Itambé;De 0,2 a menos de 0,5 ha;9;3;4;5;1;2;0;9;0;4;0;5;1;3;0;2;;
Itambé;De 0,5 a menos de 1 ha;12;7;7;5;4;3;3;9;2;5;1;4;1;3;1;3;;
Itambé;De 1 a menos de 2 ha;5;7;4;1;0;0;2;3;2;2;0;1;0;2;0;1;;
Itambé;De 2 a menos de 3 ha;6;14;1;5;0;0;4;2;0;1;4;1;1;0;0;1;;
Itambé;De 3 a menos de 4 ha;8;27;2;6;0;0;5;3;0;2;5;1;0;2;0;1;;
Itambé;De 4 a menos de 5 ha;14;67;3;11;14;53;5;9;0;3;5;6;0;3;0;5;;
Itambé;De 5 a menos de 10 ha;16;123;3;13;22;101;12;4;2;1;10;3;0;1;1;1;;
Itambé;De 10 a menos de 20 ha;33;470;1;32;0;0;32;1;1;0;31;1;0;0;0;1;;
Itambé;De 20 a menos de 50 ha;52;1621;4;48;121;1500;47;5;4;0;43;5;0;0;0;5;;
Itambé;De 50 a menos de 100 ha;27;1881;16;11;1259;621;25;2;16;0;9;2;0;0;0;2;;
Itambé;De 100 a menos de 200 ha;29;3963;29;0;3963;0;27;2;27;2;0;0;0;2;0;0;;
Itambé;De 200 a menos de 500 ha;23;7204;23;0;7204;0;22;1;22;1;0;0;0;1;0;0;;
Itambé;De 500 a menos de 1.000 ha;4;0;4;0;0;0;4;0;4;0;0;0;0;0;0;0;;
Itambé;De 1.000 a menos de 2.500 ha;1;0;1;0;0;0;1;0;1;0;0;0;0;0;0;0;;
Itambé;De 2.500 a menos de 10.000 ha;0;0;0;0;0;0;0;0;0;0;0;0;0;0;0;0;;
Itambé;De 10.000 ha e mais;0;0;0;0;0;0;0;0;0;0;0;0;0;0;0;0;;
Itambé;Produtor sem área;0;0;0;0;0;0;0;0;0;0;0;0;0;0;0;0;;
Itapejara d'Oeste;Mais de 0 a menos de 0,1 ha;0;0;0;0;0;0;0;0;0;0;0;0;0;0;0;0;;
Itapejara d'Oeste;De 0,1 a menos de 0,2 ha;5;1;2;3;0;0;3;2;0;2;3;0;0;2;0;0;;
Itapejara d'Oeste;De 0,2 a menos de 0,5 ha;1;0;0;1;0;0;1;0;0;0;1;0;0;0;0;0;;
Itapejara d'Oeste;De 0,5 a menos de 1 ha;3;0;0;3;0;0;2;1;0;0;2;1;0;0;0;1;;
Itapejara d'Oeste;De 1 a menos de 2 ha;26;37;9;17;13;24;11;15;4;5;7;10;0;5;0;10;;
Itapejara d'Oeste;De 2 a menos de 3 ha;30;73;6;24;15;58;20;10;3;3;17;7;0;3;0;5;;
Itapejara d'Oeste;De 3 a menos de 4 ha;46;160;12;34;42;118;28;18;4;8;24;10;0;7;0;8;;
Itapejara d'Oeste;De 4 a menos de 5 ha;65;310;11;54;53;257;51;14;4;7;47;7;0;7;0;7;;
Itapejara d'Oeste;De 5 a menos de 10 ha;128;969;16;112;124;845;109;19;10;6;99;13;0;6;0;11;;
Itapejara d'Oeste;De 10 a menos de 20 ha;164;2400;13;151;192;2208;147;17;8;5;139;12;0;4;1;9;;
Itapejara d'Oeste;De 20 a menos de 50 ha;136;4104;11;125;307;3796;131;5;8;3;123;2;0;3;0;1;;
Itapejara d'Oeste;De 50 a menos de 100 ha;59;3909;9;50;784;3125;59;0;9;0;50;0;0;0;0;0;;
Itapejara d'Oeste;De 100 a menos de 200 ha;28;3734;28;0;3734;0;28;0;28;0;0;0;0;0;0;0;;
Itapejara d'Oeste;De 200 a menos de 500 ha;15;4300;15;0;4300;0;14;1;14;1;0;0;0;0;0;0;;
Itapejara d'Oeste;De 500 a menos de 1.000 ha;2;0;2;0;0;0;2;0;2;0;0;0;0;0;0;0;;
Itapejara d'Oeste;De 1.000 a menos de 2.500 ha;0;0;0;0;0;0;0;0;0;0;0;0;0;0;0;0;;
Itapejara d'Oeste;De 2.500 a menos de 10.000 ha;0;0;0;0;0;0;0;0;0;0;0;0;0;0;0;0;;
Itapejara d'Oeste;De 10.000 ha e mais;0;0;0;0;0;0;0;0;0;0;0;0;0;0;0;0;;
Itapejara d'Oeste;Produtor sem área;1;0;0;1;0;0;0;0;0;0;0;0;0;0;0;0;;
Itaperuçu;Mais de 0 a menos de 0,1 ha;9;1;5;4;0;0;0;9;0;5;0;4;0;4;0;4;;
Itaperuçu;De 0,1 a menos de 0,2 ha;18;3;7;11;1;2;1;17;1;6;0;11;0;6;0;11;;
Itaperuçu;De 0,2 a menos de 0,5 ha;24;8;10;14;3;5;1;23;1;9;0;14;0;9;0;14;;
Itaperuçu;De 0,5 a menos de 1 ha;22;15;6;16;4;11;1;21;1;5;0;16;0;5;0;15;;
Itaperuçu;De 1 a menos de 2 ha;69;92;26;43;33;59;10;59;4;22;6;37;0;21;0;29;;
Itaperuçu;De 2 a menos de 3 ha;58;140;19;39;46;94;8;50;4;15;4;35;0;15;0;34;;
Itaperuçu;De 3 a menos de 4 ha;25;87;5;20;18;69;5;20;2;3;3;17;0;3;0;15;;
Itaperuçu;De 4 a menos de 5 ha;35;167;15;20;73;95;9;26;3;12;6;14;0;12;0;13;;
Itaperuçu;De 5 a menos de 10 ha;84;652;20;64;153;499;10;74;1;19;9;55;0;18;0;54;;
Itaperuçu;De 10 a menos de 20 ha;90;1333;13;77;191;1142;12;78;0;13;12;65;0;13;2;57;;
Itaperuçu;De 20 a menos de 50 ha;81;2543;20;61;617;1926;10;71;2;18;8;53;0;16;1;50;;
Itaperuçu;De 50 a menos de 100 ha;22;1600;19;3;0;0;8;14;8;11;0;3;0;11;0;3;;
Itaperuçu;De 100 a menos de 200 ha;3;418;3;0;418;0;0;3;0;3;0;0;0;2;0;0;;
Itaperuçu;De 200 a menos de 500 ha;5;1397;5;0;1397;0;2;3;2;3;0;0;0;3;0;0;;
Itaperuçu;De 500 a menos de 1.000 ha;1;0;1;0;0;0;0;1;0;1;0;0;0;1;0;0;;
Itaperuçu;De 1.000 a menos de 2.500 ha;0;0;0;0;0;0;0;0;0;0;0;0;0;0;0;0;;
Itaperuçu;De 2.500 a menos de 10.000 ha;2;0;2;0;0;0;2;0;2;0;0;0;0;0;0;0;;
Itaperuçu;De 10.000 ha e mais;0;0;0;0;0;0;0;0;0;0;0;0;0;0;0;0;;
Itaperuçu;Produtor sem área;4;0;2;2;0;0;0;4;0;2;0;2;0;2;0;1;;
Itaúna do Sul;Mais de 0 a menos de 0,1 ha;3;0;2;1;0;0;0;3;0;2;0;1;0;2;0;1;;
Itaúna do Sul;De 0,1 a menos de 0,2 ha;0;0;0;0;0;0;0;0;0;0;0;0;0;0;0;0;;
Itaúna do Sul;De 0,2 a menos de 0,5 ha;0;0;0;0;0;0;0;0;0;0;0;0;0;0;0;0;;
Itaúna do Sul;De 0,5 a menos de 1 ha;72;36;18;54;9;27;0;72;0;18;0;54;0;15;0;47;;
Itaúna do Sul;De 1 a menos de 2 ha;6;7;1;5;0;0;0;6;0;1;0;5;0;1;0;3;;
Itaúna do Sul;De 2 a menos de 3 ha;12;30;6;6;15;15;0;12;0;6;0;6;0;2;0;5;;
Itaúna do Sul;De 3 a menos de 4 ha;18;63;6;12;22;41;2;16;0;6;2;10;0;4;0;7;;
Itaúna do Sul;De 4 a menos de 5 ha;19;91;8;11;37;53;2;17;1;7;1;10;0;5;0;9;;
Itaúna do Sul;De 5 a menos de 10 ha;30;215;7;23;52;163;0;30;0;7;0;23;0;4;0;16;;
Itaúna do Sul;De 10 a menos de 20 ha;58;798;10;48;160;638;4;54;0;10;4;44;0;7;0;29;;
Itaúna do Sul;De 20 a menos de 50 ha;30;916;9;21;294;623;2;28;1;8;1;20;0;7;0;18;;
Itaúna do Sul;De 50 a menos de 100 ha;17;1300;8;9;650;650;2;15;1;7;1;8;0;7;0;6;;
Itaúna do Sul;De 100 a menos de 200 ha;13;1690;13;0;1690;0;2;11;2;11;0;0;0;9;0;0;;
Itaúna do Sul;De 200 a menos de 500 ha;8;2451;8;0;2451;0;2;6;2;6;0;0;0;3;0;0;;
Itaúna do Sul;De 500 a menos de 1.000 ha;4;2822;4;0;2822;0;2;2;2;2;0;0;0;1;0;0;;
Itaúna do Sul;De 1.000 a menos de 2.500 ha;1;0;1;0;0;0;1;0;1;0;0;0;0;0;0;0;;
Itaúna do Sul;De 2.500 a menos de 10.000 ha;0;0;0;0;0;0;0;0;0;0;0;0;0;0;0;0;;
Itaúna do Sul;De 10.000 ha e mais;0;0;0;0;0;0;0;0;0;0;0;0;0;0;0;0;;
Itaúna do Sul;Produtor sem área;1;0;0;1;0;0;0;1;0;0;0;1;0;0;0;0;;
Ivaí;Mais de 0 a menos de 0,1 ha;1;0;0;1;0;0;1;0;0;0;1;0;0;0;0;0;;
Ivaí;De 0,1 a menos de 0,2 ha;4;1;2;2;0;0;1;3;1;1;0;2;0;1;0;2;;
Ivaí;De 0,2 a menos de 0,5 ha;42;17;13;29;5;12;18;24;6;7;12;17;0;5;2;5;;
Ivaí;De 0,5 a menos de 1 ha;21;16;4;17;3;13;11;10;3;1;8;9;0;0;1;5;;
Ivaí;De 1 a menos de 2 ha;80;119;14;66;22;97;60;20;10;4;50;16;0;4;0;9;;
Ivaí;De 2 a menos de 3 ha;120;303;14;106;35;269;102;18;11;3;91;15;0;2;1;9;;
Ivaí;De 3 a menos de 4 ha;119;410;10;109;36;375;110;9;8;2;102;7;0;2;0;4;;
Ivaí;De 4 a menos de 5 ha;112;528;7;105;32;496;104;8;5;2;99;6;0;0;1;1;;
Ivaí;De 5 a menos de 10 ha;312;2319;24;288;177;2141;292;20;17;7;275;13;1;5;1;9;;
Ivaí;De 10 a menos de 20 ha;367;5360;12;355;167;5194;347;20;6;6;341;14;0;4;0;13;;
Ivaí;De 20 a menos de 50 ha;340;10725;17;323;558;10167;324;16;12;5;312;11;0;4;1;9;;
Ivaí;De 50 a menos de 100 ha;105;7419;25;80;2197;5222;103;2;25;0;78;2;0;0;0;2;;
Ivaí;De 100 a menos de 200 ha;38;5236;38;0;5236;0;35;3;35;3;0;0;0;2;0;0;;
Ivaí;De 200 a menos de 500 ha;20;5815;20;0;5815;0;20;0;20;0;0;0;0;0;0;0;;
Ivaí;De 500 a menos de 1.000 ha;2;0;2;0;0;0;2;0;2;0;0;0;0;0;0;0;;
Ivaí;De 1.000 a menos de 2.500 ha;0;0;0;0;0;0;0;0;0;0;0;0;0;0;0;0;;
Ivaí;De 2.500 a menos de 10.000 ha;0;0;0;0;0;0;0;0;0;0;0;0;0;0;0;0;;
Ivaí;De 10.000 ha e mais;0;0;0;0;0;0;0;0;0;0;0;0;0;0;0;0;;
Ivaí;Produtor sem área;0;0;0;0;0;0;0;0;0;0;0;0;0;0;0;0;;
Ivaiporã;Mais de 0 a menos de 0,1 ha;5;0;3;2;0;0;0;5;0;3;0;2;0;3;0;1;;
Ivaiporã;De 0,1 a menos de 0,2 ha;7;1;1;6;0;0;0;7;0;1;0;6;0;1;0;5;;
Ivaiporã;De 0,2 a menos de 0,5 ha;13;5;1;12;0;0;0;13;0;1;0;12;0;1;0;10;;
Ivaiporã;De 0,5 a menos de 1 ha;71;41;22;49;13;28;36;35;7;15;29;20;0;10;0;8;;
Ivaiporã;De 1 a menos de 2 ha;43;61;9;34;13;48;21;22;4;5;17;17;0;4;0;9;;
Ivaiporã;De 2 a menos de 3 ha;78;189;13;65;32;158;47;31;9;4;38;27;0;4;0;24;;
Ivaiporã;De 3 a menos de 4 ha;61;216;12;49;42;175;37;24;6;6;31;18;0;3;0;12;;
Ivaiporã;De 4 a menos de 5 ha;83;397;13;70;62;335;53;30;4;9;49;21;0;7;0;15;;
Ivaiporã;De 5 a menos de 10 ha;207;1523;26;181;201;1321;146;61;10;16;136;45;0;16;0;31;;
Ivaiporã;De 10 a menos de 20 ha;246;3537;17;229;225;3313;194;52;4;13;190;39;0;12;0;28;;
Ivaiporã;De 20 a menos de 50 ha;191;6074;12;179;371;5703;159;32;5;7;154;25;0;6;0;22;;
Ivaiporã;De 50 a menos de 100 ha;85;5953;39;46;3217;2736;75;10;35;4;40;6;0;4;0;6;;
Ivaiporã;De 100 a menos de 200 ha;34;4875;34;0;4875;0;28;6;28;6;0;0;0;6;0;0;;
Ivaiporã;De 200 a menos de 500 ha;24;6378;24;0;6378;0;20;4;20;4;0;0;0;4;0;0;;
Ivaiporã;De 500 a menos de 1.000 ha;5;0;5;0;0;0;5;0;5;0;0;0;0;0;0;0;;
Ivaiporã;De 1.000 a menos de 2.500 ha;2;0;2;0;0;0;2;0;2;0;0;0;0;0;0;0;;
Ivaiporã;De 2.500 a menos de 10.000 ha;0;0;0;0;0;0;0;0;0;0;0;0;0;0;0;0;;
Ivaiporã;De 10.000 ha e mais;0;0;0;0;0;0;0;0;0;0;0;0;0;0;0;0;;
Ivaiporã;Produtor sem área;6;0;1;5;0;0;4;0;1;0;3;0;0;0;0;0;;
Ivaté;Mais de 0 a menos de 0,1 ha;10;0;3;7;0;0;2;8;0;3;2;5;0;3;0;5;;
Ivaté;De 0,1 a menos de 0,2 ha;1;0;0;1;0;0;0;1;0;0;0;1;0;0;0;1;;
Ivaté;De 0,2 a menos de 0,5 ha;2;0;0;2;0;0;0;2;0;0;0;2;0;0;0;1;;
Ivaté;De 0,5 a menos de 1 ha;135;70;30;105;15;54;16;119;1;29;15;90;0;27;0;87;;
Ivaté;De 1 a menos de 2 ha;6;8;2;4;0;0;1;5;0;2;1;3;0;2;0;3;;
Ivaté;De 2 a menos de 3 ha;37;89;10;27;24;65;2;35;1;9;1;26;0;7;4;19;;
Ivaté;De 3 a menos de 4 ha;16;57;2;14;0;0;3;13;0;2;3;11;0;2;0;9;;
Ivaté;De 4 a menos de 5 ha;89;428;31;58;149;279;8;81;4;27;4;54;3;20;4;40;;
Ivaté;De 5 a menos de 10 ha;81;615;24;57;183;432;14;67;5;19;9;48;1;12;5;31;;
Ivaté;De 10 a menos de 20 ha;63;882;6;57;77;806;11;52;0;6;11;46;0;5;3;33;;
Ivaté;De 20 a menos de 50 ha;47;1376;6;41;180;1195;11;36;2;4;9;32;0;2;1;27;;
Ivaté;De 50 a menos de 100 ha;17;1272;8;9;638;634;4;13;1;7;3;6;0;4;0;5;;
Ivaté;De 100 a menos de 200 ha;6;963;6;0;963;0;3;3;3;3;0;0;1;2;0;0;;
Ivaté;De 200 a menos de 500 ha;8;2614;8;0;2614;0;3;5;3;5;0;0;0;4;0;0;;
Ivaté;De 500 a menos de 1.000 ha;5;3462;5;0;3462;0;3;2;3;2;0;0;1;1;0;0;;
Ivaté;De 1.000 a menos de 2.500 ha;2;0;2;0;0;0;0;2;0;2;0;0;0;2;0;0;;
Ivaté;De 2.500 a menos de 10.000 ha;1;0;1;0;0;0;0;1;0;1;0;0;0;1;0;0;;
Ivaté;De 10.000 ha e mais;1;0;1;0;0;0;1;0;1;0;0;0;0;0;0;0;;
Ivaté;Produtor sem área;4;0;1;3;0;0;0;3;0;1;0;2;0;1;0;2;;
Ivatuba;Mais de 0 a menos de 0,1 ha;0;0;0;0;0;0;0;0;0;0;0;0;0;0;0;0;;
Ivatuba;De 0,1 a menos de 0,2 ha;0;0;0;0;0;0;0;0;0;0;0;0;0;0;0;0;;
Ivatuba;De 0,2 a menos de 0,5 ha;0;0;0;0;0;0;0;0;0;0;0;0;0;0;0;0;;
Ivatuba;De 0,5 a menos de 1 ha;2;0;0;2;0;0;1;1;0;0;1;1;0;0;0;0;;
Ivatuba;De 1 a menos de 2 ha;1;0;0;1;0;0;1;0;0;0;1;0;0;0;0;0;;
Ivatuba;De 2 a menos de 3 ha;0;0;0;0;0;0;0;0;0;0;0;0;0;0;0;0;;
Ivatuba;De 3 a menos de 4 ha;2;0;0;2;0;0;0;2;0;0;0;2;0;0;0;1;;
Ivatuba;De 4 a menos de 5 ha;4;19;0;4;0;19;4;0;0;0;4;0;0;0;0;0;;
Ivatuba;De 5 a menos de 10 ha;4;0;0;4;0;0;4;0;0;0;4;0;0;0;0;0;;
Ivatuba;De 10 a menos de 20 ha;7;96;0;7;0;96;7;0;0;0;7;0;0;0;0;0;;
Ivatuba;De 20 a menos de 50 ha;22;753;4;18;0;0;22;0;4;0;18;0;0;0;0;0;;
Ivatuba;De 50 a menos de 100 ha;20;1601;17;3;0;0;20;0;17;0;3;0;0;0;0;0;;
Ivatuba;De 100 a menos de 200 ha;17;2313;17;0;2313;0;17;0;17;0;0;0;0;0;0;0;;
Ivatuba;De 200 a menos de 500 ha;7;2065;7;0;2065;0;7;0;7;0;0;0;0;0;0;0;;
Ivatuba;De 500 a menos de 1.000 ha;2;0;2;0;0;0;2;0;2;0;0;0;0;0;0;0;;
Ivatuba;De 1.000 a menos de 2.500 ha;0;0;0;0;0;0;0;0;0;0;0;0;0;0;0;0;;
Ivatuba;De 2.500 a menos de 10.000 ha;0;0;0;0;0;0;0;0;0;0;0;0;0;0;0;0;;
Ivatuba;De 10.000 ha e mais;0;0;0;0;0;0;0;0;0;0;0;0;0;0;0;0;;
Ivatuba;Produtor sem área;0;0;0;0;0;0;0;0;0;0;0;0;0;0;0;0;;
Jaboti;Mais de 0 a menos de 0,1 ha;24;2;2;22;0;0;15;9;1;1;14;8;0;1;1;5;;
Jaboti;De 0,1 a menos de 0,2 ha;21;3;5;16;1;2;14;7;1;4;13;3;3;1;1;2;;
Jaboti;De 0,2 a menos de 0,5 ha;26;8;5;21;2;6;17;9;1;4;16;5;0;3;1;3;;
Jaboti;De 0,5 a menos de 1 ha;59;34;18;41;10;24;27;32;4;14;23;18;0;6;0;9;;
Jaboti;De 1 a menos de 2 ha;51;66;10;41;12;54;32;19;5;5;27;14;0;3;2;9;;
Jaboti;De 2 a menos de 3 ha;54;132;12;42;30;102;26;28;4;8;22;20;0;8;3;9;;
Jaboti;De 3 a menos de 4 ha;55;195;11;44;39;156;33;22;2;9;31;13;1;5;0;7;;
Jaboti;De 4 a menos de 5 ha;61;291;9;52;43;248;36;25;5;4;31;21;1;2;0;10;;
Jaboti;De 5 a menos de 10 ha;114;871;16;98;121;750;55;59;9;7;46;52;0;5;7;22;;
Jaboti;De 10 a menos de 20 ha;72;996;15;57;214;782;30;42;6;9;24;33;0;7;0;19;;
Jaboti;De 20 a menos de 50 ha;63;2009;12;51;369;1639;19;44;7;5;12;39;1;1;5;19;;
Jaboti;De 50 a menos de 100 ha;28;1930;16;12;0;0;8;20;4;12;4;8;2;5;0;5;;
Jaboti;De 100 a menos de 200 ha;5;611;5;0;611;0;2;3;2;3;0;0;0;3;0;0;;
Jaboti;De 200 a menos de 500 ha;4;0;4;0;0;0;0;4;0;4;0;0;0;2;0;0;;
Jaboti;De 500 a menos de 1.000 ha;1;0;1;0;0;0;1;0;1;0;0;0;0;0;0;0;;
Jaboti;De 1.000 a menos de 2.500 ha;0;0;0;0;0;0;0;0;0;0;0;0;0;0;0;0;;
Jaboti;De 2.500 a menos de 10.000 ha;0;0;0;0;0;0;0;0;0;0;0;0;0;0;0;0;;
Jaboti;De 10.000 ha e mais;0;0;0;0;0;0;0;0;0;0;0;0;0;0;0;0;;
Jaboti;Produtor sem área;0;0;0;0;0;0;0;0;0;0;0;0;0;0;0;0;;
Jacarezinho;Mais de 0 a menos de 0,1 ha;8;1;1;7;0;0;0;8;0;1;0;7;0;1;0;7;;
Jacarezinho;De 0,1 a menos de 0,2 ha;15;2;1;14;0;0;0;15;0;1;0;14;0;1;0;13;;
Jacarezinho;De 0,2 a menos de 0,5 ha;22;7;2;20;0;0;1;21;0;2;1;19;0;2;3;14;;
Jacarezinho;De 0,5 a menos de 1 ha;32;18;5;27;3;15;3;29;0;5;3;24;1;2;3;19;;
Jacarezinho;De 1 a menos de 2 ha;19;24;2;17;0;0;1;18;0;2;1;16;1;1;1;14;;
Jacarezinho;De 2 a menos de 3 ha;31;76;11;20;27;48;0;31;0;11;0;20;0;11;1;16;;
Jacarezinho;De 3 a menos de 4 ha;67;230;18;49;61;169;3;64;0;18;3;46;1;15;1;42;;
Jacarezinho;De 4 a menos de 5 ha;55;261;13;42;61;200;3;52;1;12;2;40;1;10;2;36;;
Jacarezinho;De 5 a menos de 10 ha;195;1440;50;145;360;1079;20;175;4;46;16;129;3;40;15;94;;
Jacarezinho;De 10 a menos de 20 ha;163;2153;31;132;437;1717;36;127;6;25;30;102;0;21;27;56;;
Jacarezinho;De 20 a menos de 50 ha;93;2942;26;67;808;2134;25;68;4;22;21;46;0;19;5;38;;
Jacarezinho;De 50 a menos de 100 ha;39;2721;21;18;1614;1107;12;27;8;13;4;14;0;10;2;8;;
Jacarezinho;De 100 a menos de 200 ha;35;4807;35;0;4807;0;10;25;10;25;0;0;5;15;0;0;;
Jacarezinho;De 200 a menos de 500 ha;21;6597;21;0;6597;0;9;12;9;12;0;0;0;9;0;0;;
Jacarezinho;De 500 a menos de 1.000 ha;8;5619;8;0;5619;0;5;3;5;3;0;0;0;2;0;0;;
Jacarezinho;De 1.000 a menos de 2.500 ha;6;0;6;0;0;0;5;1;5;1;0;0;0;1;0;0;;
Jacarezinho;De 2.500 a menos de 10.000 ha;1;0;1;0;0;0;1;0;1;0;0;0;0;0;0;0;;
Jacarezinho;De 10.000 ha e mais;1;0;1;0;0;0;1;0;1;0;0;0;0;0;0;0;;
Jacarezinho;Produtor sem área;0;0;0;0;0;0;0;0;0;0;0;0;0;0;0;0;;
Jaguapitã;Mais de 0 a menos de 0,1 ha;2;0;0;2;0;0;0;2;0;0;0;2;0;0;0;1;;
Jaguapitã;De 0,1 a menos de 0,2 ha;0;0;0;0;0;0;0;0;0;0;0;0;0;0;0;0;;
Jaguapitã;De 0,2 a menos de 0,5 ha;2;0;0;2;0;0;0;2;0;0;0;2;0;0;0;2;;
Jaguapitã;De 0,5 a menos de 1 ha;28;15;0;28;0;15;1;27;0;0;1;27;0;0;0;25;;
Jaguapitã;De 1 a menos de 2 ha;5;7;1;4;0;0;0;5;0;1;0;4;0;1;0;3;;
Jaguapitã;De 2 a menos de 3 ha;12;28;0;12;0;28;1;11;0;0;1;11;0;0;0;11;;
Jaguapitã;De 3 a menos de 4 ha;25;87;1;24;0;0;1;24;0;1;1;23;0;1;0;20;;
Jaguapitã;De 4 a menos de 5 ha;23;109;1;22;0;0;6;17;0;1;6;16;0;1;1;13;;
Jaguapitã;De 5 a menos de 10 ha;47;376;2;45;0;0;10;37;0;2;10;35;0;2;0;29;;
Jaguapitã;De 10 a menos de 20 ha;86;1237;6;80;80;1157;19;67;1;5;18;62;0;5;0;45;;
Jaguapitã;De 20 a menos de 50 ha;84;2732;8;76;289;2443;41;43;3;5;38;38;0;3;0;25;;
Jaguapitã;De 50 a menos de 100 ha;35;2384;21;14;1592;792;17;18;11;10;6;8;1;7;0;8;;
Jaguapitã;De 100 a menos de 200 ha;25;3479;25;0;3479;0;20;5;20;5;0;0;0;3;0;0;;
Jaguapitã;De 200 a menos de 500 ha;23;6824;23;0;6824;0;16;7;16;7;0;0;0;4;0;0;;
Jaguapitã;De 500 a menos de 1.000 ha;5;2909;5;0;2909;0;4;1;4;1;0;0;0;1;0;0;;
Jaguapitã;De 1.000 a menos de 2.500 ha;3;4596;3;0;4596;0;3;0;3;0;0;0;0;0;0;0;;
Jaguapitã;De 2.500 a menos de 10.000 ha;3;0;3;0;0;0;3;0;3;0;0;0;0;0;0;0;;
Jaguapitã;De 10.000 ha e mais;0;0;0;0;0;0;0;0;0;0;0;0;0;0;0;0;;
Jaguapitã;Produtor sem área;1;0;1;0;0;0;0;1;0;1;0;0;0;1;0;0;;
Jaguariaíva;Mais de 0 a menos de 0,1 ha;43;3;35;8;2;1;2;41;2;33;0;8;0;32;0;8;;
Jaguariaíva;De 0,1 a menos de 0,2 ha;29;5;14;15;2;2;9;20;3;11;6;9;0;6;0;7;;
Jaguariaíva;De 0,2 a menos de 0,5 ha;39;14;24;15;9;5;11;28;8;16;3;12;0;11;0;10;;
Jaguariaíva;De 0,5 a menos de 1 ha;34;25;19;15;14;11;14;20;11;8;3;12;0;6;0;7;;
Jaguariaíva;De 1 a menos de 2 ha;100;127;50;50;66;62;35;65;18;32;17;33;0;29;0;26;;
Jaguariaíva;De 2 a menos de 3 ha;91;212;41;50;93;119;18;73;8;33;10;40;1;23;4;30;;
Jaguariaíva;De 3 a menos de 4 ha;46;157;23;23;79;78;12;34;6;17;6;17;1;15;1;11;;
Jaguariaíva;De 4 a menos de 5 ha;58;271;25;33;118;153;10;48;1;24;9;24;0;20;0;22;;
Jaguariaíva;De 5 a menos de 10 ha;150;1170;51;99;383;787;40;110;9;42;31;68;1;30;0;58;;
Jaguariaíva;De 10 a menos de 20 ha;108;1564;31;77;440;1124;35;73;7;24;28;49;0;18;0;41;;
Jaguariaíva;De 20 a menos de 50 ha;131;3972;38;93;1133;2839;41;90;13;25;28;65;0;20;2;51;;
Jaguariaíva;De 50 a menos de 100 ha;64;4517;32;32;2461;2056;28;36;12;20;16;16;1;15;0;11;;
Jaguariaíva;De 100 a menos de 200 ha;33;4544;33;0;4544;0;24;9;24;9;0;0;0;9;0;0;;
Jaguariaíva;De 200 a menos de 500 ha;47;15641;47;0;15641;0;27;20;27;20;0;0;0;17;0;0;;
Jaguariaíva;De 500 a menos de 1.000 ha;20;13650;20;0;13650;0;13;7;13;7;0;0;0;6;0;0;;
Jaguariaíva;De 1.000 a menos de 2.500 ha;15;21462;15;0;21462;0;14;1;14;1;0;0;0;1;0;0;;
Jaguariaíva;De 2.500 a menos de 10.000 ha;3;0;3;0;0;0;1;2;1;2;0;0;0;2;0;0;;
Jaguariaíva;De 10.000 ha e mais;2;0;2;0;0;0;1;1;1;1;0;0;0;1;0;0;;
Jaguariaíva;Produtor sem área;1;0;1;0;0;0;0;0;0;0;0;0;0;0;0;0;;
Jandaia do Sul;Mais de 0 a menos de 0,1 ha;1;0;1;0;0;0;0;1;0;1;0;0;0;0;0;0;;
Jandaia do Sul;De 0,1 a menos de 0,2 ha;1;0;0;1;0;0;0;1;0;0;0;1;0;0;0;1;;
Jandaia do Sul;De 0,2 a menos de 0,5 ha;9;3;4;5;0;0;2;7;0;4;2;3;0;2;0;2;;
Jandaia do Sul;De 0,5 a menos de 1 ha;76;40;34;42;18;22;22;54;14;20;8;34;0;11;0;23;;
Jandaia do Sul;De 1 a menos de 2 ha;20;29;3;17;4;25;6;14;2;1;4;13;0;0;1;11;;
Jandaia do Sul;De 2 a menos de 3 ha;35;86;6;29;15;71;24;11;3;3;21;8;0;2;0;8;;
Jandaia do Sul;De 3 a menos de 4 ha;26;91;5;21;18;73;18;8;3;2;15;6;0;1;0;4;;
Jandaia do Sul;De 4 a menos de 5 ha;34;162;5;29;24;138;24;10;4;1;20;9;0;0;0;9;;
Jandaia do Sul;De 5 a menos de 10 ha;78;572;10;68;75;497;48;30;6;4;42;26;0;4;0;19;;
Jandaia do Sul;De 10 a menos de 20 ha;77;1096;13;64;178;918;45;32;5;8;40;24;0;4;1;22;;
Jandaia do Sul;De 20 a menos de 50 ha;69;2279;11;58;353;1926;54;15;10;1;44;14;0;1;0;11;;
Jandaia do Sul;De 50 a menos de 100 ha;25;1776;17;8;1324;451;20;5;13;4;7;1;0;4;0;1;;
Jandaia do Sul;De 100 a menos de 200 ha;12;1711;12;0;1711;0;12;0;12;0;0;0;0;0;0;0;;
Jandaia do Sul;De 200 a menos de 500 ha;3;0;3;0;0;0;3;0;3;0;0;0;0;0;0;0;;
Jandaia do Sul;De 500 a menos de 1.000 ha;2;0;2;0;0;0;2;0;2;0;0;0;0;0;0;0;;
Jandaia do Sul;De 1.000 a menos de 2.500 ha;1;0;1;0;0;0;1;0;1;0;0;0;0;0;0;0;;
Jandaia do Sul;De 2.500 a menos de 10.000 ha;0;0;0;0;0;0;0;0;0;0;0;0;0;0;0;0;;
Jandaia do Sul;De 10.000 ha e mais;0;0;0;0;0;0;0;0;0;0;0;0;0;0;0;0;;
Jandaia do Sul;Produtor sem área;0;0;0;0;0;0;0;0;0;0;0;0;0;0;0;0;;
Janiópolis;Mais de 0 a menos de 0,1 ha;0;0;0;0;0;0;0;0;0;0;0;0;0;0;0;0;;
Janiópolis;De 0,1 a menos de 0,2 ha;1;0;1;0;0;0;1;0;1;0;0;0;0;0;0;0;;
Janiópolis;De 0,2 a menos de 0,5 ha;2;0;2;0;0;0;2;0;2;0;0;0;0;0;0;0;;
Janiópolis;De 0,5 a menos de 1 ha;35;18;14;21;8;11;9;26;5;9;4;17;0;5;0;13;;
Janiópolis;De 1 a menos de 2 ha;19;26;7;12;0;0;4;15;1;6;3;9;0;4;0;7;;
Janiópolis;De 2 a menos de 3 ha;15;38;2;13;0;0;8;7;0;2;8;5;0;2;0;1;;
Janiópolis;De 3 a menos de 4 ha;25;89;4;21;15;74;11;14;1;3;10;11;0;2;0;6;;
Janiópolis;De 4 a menos de 5 ha;34;161;3;31;14;147;15;19;0;3;15;16;0;3;0;10;;
Janiópolis;De 5 a menos de 10 ha;73;552;4;69;25;528;39;34;0;4;39;30;0;4;2;11;;
Janiópolis;De 10 a menos de 20 ha;80;1150;3;77;44;1107;60;20;2;1;58;19;0;1;0;6;;
Janiópolis;De 20 a menos de 50 ha;65;2008;5;60;146;1861;49;16;1;4;48;12;0;2;0;8;;
Janiópolis;De 50 a menos de 100 ha;55;4033;19;36;1702;2331;42;13;11;8;31;5;0;5;0;2;;
Janiópolis;De 100 a menos de 200 ha;34;4917;34;0;4917;0;28;6;28;6;0;0;0;4;0;0;;
Janiópolis;De 200 a menos de 500 ha;24;7623;24;0;7623;0;23;1;23;1;0;0;0;0;0;0;;
Janiópolis;De 500 a menos de 1.000 ha;10;6842;10;0;6842;0;10;0;10;0;0;0;0;0;0;0;;
Janiópolis;De 1.000 a menos de 2.500 ha;0;0;0;0;0;0;0;0;0;0;0;0;0;0;0;0;;
Janiópolis;De 2.500 a menos de 10.000 ha;0;0;0;0;0;0;0;0;0;0;0;0;0;0;0;0;;
Janiópolis;De 10.000 ha e mais;0;0;0;0;0;0;0;0;0;0;0;0;0;0;0;0;;
Janiópolis;Produtor sem área;0;0;0;0;0;0;0;0;0;0;0;0;0;0;0;0;;
Japira;Mais de 0 a menos de 0,1 ha;1;0;0;1;0;0;0;1;0;0;0;1;0;0;0;1;;
Japira;De 0,1 a menos de 0,2 ha;0;0;0;0;0;0;0;0;0;0;0;0;0;0;0;0;;
Japira;De 0,2 a menos de 0,5 ha;1;0;0;1;0;0;0;1;0;0;0;1;0;0;0;1;;
Japira;De 0,5 a menos de 1 ha;52;29;20;32;11;19;29;23;8;12;21;11;0;5;0;6;;
Japira;De 1 a menos de 2 ha;40;55;13;27;18;38;29;11;9;4;20;7;0;3;0;4;;
Japira;De 2 a menos de 3 ha;44;108;13;31;32;76;23;21;3;10;20;11;0;7;0;6;;
Japira;De 3 a menos de 4 ha;66;227;22;44;77;149;39;27;12;10;27;17;0;9;0;9;;
Japira;De 4 a menos de 5 ha;61;288;22;39;103;184;35;26;15;7;20;19;0;3;0;12;;
Japira;De 5 a menos de 10 ha;119;908;33;86;244;664;77;42;16;17;61;25;0;10;1;15;;
Japira;De 10 a menos de 20 ha;108;1644;25;83;403;1241;62;46;14;11;48;35;1;6;0;21;;
Japira;De 20 a menos de 50 ha;44;1310;16;28;455;855;21;23;9;7;12;16;0;5;1;13;;
Japira;De 50 a menos de 100 ha;14;911;6;8;0;0;8;6;4;2;4;4;0;2;0;3;;
Japira;De 100 a menos de 200 ha;10;1492;10;0;1492;0;5;5;5;5;0;0;0;4;0;0;;
Japira;De 200 a menos de 500 ha;11;3647;11;0;3647;0;7;4;7;4;0;0;0;3;0;0;;
Japira;De 500 a menos de 1.000 ha;3;0;3;0;0;0;2;1;2;1;0;0;0;0;0;0;;
Japira;De 1.000 a menos de 2.500 ha;3;0;3;0;0;0;2;1;2;1;0;0;0;1;0;0;;
Japira;De 2.500 a menos de 10.000 ha;0;0;0;0;0;0;0;0;0;0;0;0;0;0;0;0;;
Japira;De 10.000 ha e mais;0;0;0;0;0;0;0;0;0;0;0;0;0;0;0;0;;
Japira;Produtor sem área;0;0;0;0;0;0;0;0;0;0;0;0;0;0;0;0;;
Japurá;Mais de 0 a menos de 0,1 ha;1;0;0;1;0;0;0;1;0;0;0;1;0;0;0;0;;
Japurá;De 0,1 a menos de 0,2 ha;4;0;2;2;0;0;0;4;0;2;0;2;0;1;0;2;;
Japurá;De 0,2 a menos de 0,5 ha;10;5;7;3;0;0;5;5;2;5;3;0;0;3;0;0;;
Japurá;De 0,5 a menos de 1 ha;6;3;2;4;0;0;3;3;1;1;2;2;0;0;0;1;;
Japurá;De 1 a menos de 2 ha;15;20;2;13;0;0;8;7;1;1;7;6;0;1;0;3;;
Japurá;De 2 a menos de 3 ha;18;44;6;12;15;29;11;7;4;2;7;5;0;2;0;4;;
Japurá;De 3 a menos de 4 ha;22;75;9;13;31;44;12;10;2;7;10;3;0;4;0;2;;
Japurá;De 4 a menos de 5 ha;33;157;3;30;15;142;23;10;1;2;22;8;0;1;0;5;;
Japurá;De 5 a menos de 10 ha;60;450;10;50;80;370;43;17;6;4;37;13;0;3;0;11;;
Japurá;De 10 a menos de 20 ha;63;883;6;57;73;810;52;11;2;4;50;7;0;3;0;6;;
Japurá;De 20 a menos de 50 ha;78;2484;11;67;343;2141;67;11;7;4;60;7;0;3;0;4;;
Japurá;De 50 a menos de 100 ha;57;4071;16;41;1386;2684;55;2;16;0;39;2;0;0;0;2;;
Japurá;De 100 a menos de 200 ha;22;3011;22;0;3011;0;22;0;22;0;0;0;0;0;0;0;;
Japurá;De 200 a menos de 500 ha;11;3124;11;0;3124;0;11;0;11;0;0;0;0;0;0;0;;
Japurá;De 500 a menos de 1.000 ha;1;0;1;0;0;0;1;0;1;0;0;0;0;0;0;0;;
Japurá;De 1.000 a menos de 2.500 ha;1;0;1;0;0;0;1;0;1;0;0;0;0;0;0;0;;
Japurá;De 2.500 a menos de 10.000 ha;0;0;0;0;0;0;0;0;0;0;0;0;0;0;0;0;;
Japurá;De 10.000 ha e mais;0;0;0;0;0;0;0;0;0;0;0;0;0;0;0;0;;
Japurá;Produtor sem área;3;0;0;3;0;0;1;2;0;0;1;2;0;0;0;2;;
Jardim Alegre;Mais de 0 a menos de 0,1 ha;1;0;1;0;0;0;1;0;1;0;0;0;0;0;0;0;;
Jardim Alegre;De 0,1 a menos de 0,2 ha;2;0;0;2;0;0;1;1;0;0;1;1;0;0;0;1;;
Jardim Alegre;De 0,2 a menos de 0,5 ha;6;2;2;4;0;0;4;2;1;1;3;1;0;1;0;1;;
Jardim Alegre;De 0,5 a menos de 1 ha;26;14;3;23;2;12;12;14;2;1;10;13;0;1;0;7;;
Jardim Alegre;De 1 a menos de 2 ha;13;17;2;11;0;0;8;5;1;1;7;4;0;0;0;4;;
Jardim Alegre;De 2 a menos de 3 ha;15;37;2;13;0;0;6;9;0;2;6;7;0;1;0;4;;
Jardim Alegre;De 3 a menos de 4 ha;35;123;2;33;0;0;22;13;1;1;21;12;0;1;0;10;;
Jardim Alegre;De 4 a menos de 5 ha;48;229;8;40;38;191;27;21;2;6;25;15;0;5;0;13;;
Jardim Alegre;De 5 a menos de 10 ha;157;1162;8;149;59;1103;98;59;5;3;93;56;0;2;0;40;;
Jardim Alegre;De 10 a menos de 20 ha;583;8796;14;569;181;8615;484;99;10;4;474;95;0;4;1;76;;
Jardim Alegre;De 20 a menos de 50 ha;237;6769;10;227;382;6387;191;46;5;5;186;41;0;5;0;37;;
Jardim Alegre;De 50 a menos de 100 ha;50;3394;20;30;1568;1827;40;10;13;7;27;3;0;7;0;3;;
Jardim Alegre;De 100 a menos de 200 ha;29;4174;29;0;4174;0;23;6;23;6;0;0;0;6;0;0;;
Jardim Alegre;De 200 a menos de 500 ha;23;7122;23;0;7122;0;21;2;21;2;0;0;0;2;0;0;;
Jardim Alegre;De 500 a menos de 1.000 ha;6;4763;6;0;4763;0;4;2;4;2;0;0;0;2;0;0;;
Jardim Alegre;De 1.000 a menos de 2.500 ha;1;0;1;0;0;0;0;1;0;1;0;0;0;1;0;0;;
Jardim Alegre;De 2.500 a menos de 10.000 ha;0;0;0;0;0;0;0;0;0;0;0;0;0;0;0;0;;
Jardim Alegre;De 10.000 ha e mais;0;0;0;0;0;0;0;0;0;0;0;0;0;0;0;0;;
Jardim Alegre;Produtor sem área;0;0;0;0;0;0;0;0;0;0;0;0;0;0;0;0;;
Jardim Olinda;Mais de 0 a menos de 0,1 ha;0;0;0;0;0;0;0;0;0;0;0;0;0;0;0;0;;
Jardim Olinda;De 0,1 a menos de 0,2 ha;0;0;0;0;0;0;0;0;0;0;0;0;0;0;0;0;;
Jardim Olinda;De 0,2 a menos de 0,5 ha;1;0;0;1;0;0;0;1;0;0;0;1;0;0;0;1;;
Jardim Olinda;De 0,5 a menos de 1 ha;0;0;0;0;0;0;0;0;0;0;0;0;0;0;0;0;;
Jardim Olinda;De 1 a menos de 2 ha;1;0;1;0;0;0;0;1;0;1;0;0;0;1;0;0;;
Jardim Olinda;De 2 a menos de 3 ha;0;0;0;0;0;0;0;0;0;0;0;0;0;0;0;0;;
Jardim Olinda;De 3 a menos de 4 ha;0;0;0;0;0;0;0;0;0;0;0;0;0;0;0;0;;
Jardim Olinda;De 4 a menos de 5 ha;0;0;0;0;0;0;0;0;0;0;0;0;0;0;0;0;;
Jardim Olinda;De 5 a menos de 10 ha;1;0;0;1;0;0;0;1;0;0;0;1;0;0;0;1;;
Jardim Olinda;De 10 a menos de 20 ha;48;800;1;47;0;0;39;9;0;1;39;8;0;1;0;7;;
Jardim Olinda;De 20 a menos de 50 ha;7;188;0;7;0;188;5;2;0;0;5;2;0;0;0;2;;
Jardim Olinda;De 50 a menos de 100 ha;4;321;3;1;0;0;4;0;3;0;1;0;0;0;0;0;;
Jardim Olinda;De 100 a menos de 200 ha;3;375;3;0;375;0;1;2;1;2;0;0;0;2;0;0;;
Jardim Olinda;De 200 a menos de 500 ha;5;1611;5;0;1611;0;3;2;3;2;0;0;0;1;0;0;;
Jardim Olinda;De 500 a menos de 1.000 ha;4;2587;4;0;2587;0;3;1;3;1;0;0;0;1;0;0;;
Jardim Olinda;De 1.000 a menos de 2.500 ha;1;0;1;0;0;0;0;1;0;1;0;0;0;0;0;0;;
Jardim Olinda;De 2.500 a menos de 10.000 ha;1;0;1;0;0;0;1;0;1;0;0;0;0;0;0;0;;
Jardim Olinda;De 10.000 ha e mais;0;0;0;0;0;0;0;0;0;0;0;0;0;0;0;0;;
Jardim Olinda;Produtor sem área;0;0;0;0;0;0;0;0;0;0;0;0;0;0;0;0;;
Jataizinho;Mais de 0 a menos de 0,1 ha;0;0;0;0;0;0;0;0;0;0;0;0;0;0;0;0;;
Jataizinho;De 0,1 a menos de 0,2 ha;0;0;0;0;0;0;0;0;0;0;0;0;0;0;0;0;;
Jataizinho;De 0,2 a menos de 0,5 ha;0;0;0;0;0;0;0;0;0;0;0;0;0;0;0;0;;
Jataizinho;De 0,5 a menos de 1 ha;0;0;0;0;0;0;0;0;0;0;0;0;0;0;0;0;;
Jataizinho;De 1 a menos de 2 ha;5;0;0;5;0;0;1;4;0;0;1;4;0;0;0;4;;
Jataizinho;De 2 a menos de 3 ha;10;24;0;10;0;24;4;6;0;0;4;6;0;0;2;4;;
Jataizinho;De 3 a menos de 4 ha;22;77;0;22;0;77;8;14;0;0;8;14;0;0;2;12;;
Jataizinho;De 4 a menos de 5 ha;24;114;2;22;0;0;8;16;1;1;7;15;1;0;0;12;;
Jataizinho;De 5 a menos de 10 ha;28;211;2;26;0;0;11;17;0;2;11;15;0;1;4;10;;
Jataizinho;De 10 a menos de 20 ha;35;503;2;33;0;0;18;17;1;1;17;16;0;1;2;13;;
Jataizinho;De 20 a menos de 50 ha;55;1790;4;51;119;1671;41;14;2;2;39;12;0;2;1;10;;
Jataizinho;De 50 a menos de 100 ha;20;1404;13;7;984;420;17;3;10;3;7;0;0;3;0;0;;
Jataizinho;De 100 a menos de 200 ha;14;2119;14;0;2119;0;9;5;9;5;0;0;0;4;0;0;;
Jataizinho;De 200 a menos de 500 ha;4;1016;4;0;1016;0;2;2;2;2;0;0;0;2;0;0;;
Jataizinho;De 500 a menos de 1.000 ha;3;0;3;0;0;0;2;1;2;1;0;0;0;1;0;0;;
Jataizinho;De 1.000 a menos de 2.500 ha;1;0;1;0;0;0;1;0;1;0;0;0;0;0;0;0;;
Jataizinho;De 2.500 a menos de 10.000 ha;1;0;1;0;0;0;0;1;0;1;0;0;0;1;0;0;;
Jataizinho;De 10.000 ha e mais;0;0;0;0;0;0;0;0;0;0;0;0;0;0;0;0;;
Jataizinho;Produtor sem área;0;0;0;0;0;0;0;0;0;0;0;0;0;0;0;0;;
Jesuítas;Mais de 0 a menos de 0,1 ha;2;0;0;2;0;0;1;1;0;0;1;1;0;0;0;1;;
Jesuítas;De 0,1 a menos de 0,2 ha;3;0;1;2;0;0;1;2;0;1;1;1;0;1;0;1;;
Jesuítas;De 0,2 a menos de 0,5 ha;1;0;0;1;0;0;0;1;0;0;0;1;0;0;0;1;;
Jesuítas;De 0,5 a menos de 1 ha;29;15;9;20;5;10;21;8;7;2;14;6;0;2;0;4;;
Jesuítas;De 1 a menos de 2 ha;29;38;6;23;8;30;4;25;1;5;3;20;0;5;0;17;;
Jesuítas;De 2 a menos de 3 ha;42;103;13;29;31;71;22;20;6;7;16;13;0;7;0;12;;
Jesuítas;De 3 a menos de 4 ha;41;143;5;36;17;126;24;17;2;3;22;14;0;3;0;12;;
Jesuítas;De 4 a menos de 5 ha;75;358;5;70;24;334;51;24;1;4;50;20;0;4;0;17;;
Jesuítas;De 5 a menos de 10 ha;160;1266;17;143;132;1134;126;34;9;8;117;26;0;8;0;18;;
Jesuítas;De 10 a menos de 20 ha;136;1925;11;125;154;1772;109;27;3;8;106;19;0;8;0;17;;
Jesuítas;De 20 a menos de 50 ha;143;4451;4;139;117;4334;131;12;1;3;130;9;0;3;0;9;;
Jesuítas;De 50 a menos de 100 ha;51;3559;25;26;2038;1521;47;4;23;2;24;2;0;2;0;1;;
Jesuítas;De 100 a menos de 200 ha;33;4538;33;0;4538;0;30;3;30;3;0;0;0;3;0;0;;
Jesuítas;De 200 a menos de 500 ha;6;1822;6;0;1822;0;6;0;6;0;0;0;0;0;0;0;;
Jesuítas;De 500 a menos de 1.000 ha;1;0;1;0;0;0;1;0;1;0;0;0;0;0;0;0;;
Jesuítas;De 1.000 a menos de 2.500 ha;0;0;0;0;0;0;0;0;0;0;0;0;0;0;0;0;;
Jesuítas;De 2.500 a menos de 10.000 ha;0;0;0;0;0;0;0;0;0;0;0;0;0;0;0;0;;
Jesuítas;De 10.000 ha e mais;0;0;0;0;0;0;0;0;0;0;0;0;0;0;0;0;;
Jesuítas;Produtor sem área;2;0;1;1;0;0;0;1;0;0;0;1;0;0;0;1;;
Joaquim Távora;Mais de 0 a menos de 0,1 ha;5;0;4;1;0;0;1;4;1;3;0;1;0;3;0;1;;
Joaquim Távora;De 0,1 a menos de 0,2 ha;0;0;0;0;0;0;0;0;0;0;0;0;0;0;0;0;;
Joaquim Távora;De 0,2 a menos de 0,5 ha;5;2;2;3;0;0;1;4;1;1;0;3;0;1;0;3;;
Joaquim Távora;De 0,5 a menos de 1 ha;30;17;7;23;5;12;0;30;0;7;0;23;0;7;1;16;;
Joaquim Távora;De 1 a menos de 2 ha;31;40;12;19;15;25;3;28;0;12;3;16;0;11;3;13;;
Joaquim Távora;De 2 a menos de 3 ha;53;128;19;34;46;82;11;42;5;14;6;28;1;12;1;22;;
Joaquim Távora;De 3 a menos de 4 ha;41;144;13;28;45;99;9;32;2;11;7;21;1;8;2;14;;
Joaquim Távora;De 4 a menos de 5 ha;38;181;17;21;80;101;10;28;3;14;7;14;0;13;0;12;;
Joaquim Távora;De 5 a menos de 10 ha;134;1045;51;83;396;648;28;106;3;48;25;58;1;44;1;42;;
Joaquim Távora;De 10 a menos de 20 ha;130;1909;31;99;445;1464;30;100;5;26;25;74;2;23;2;57;;
Joaquim Távora;De 20 a menos de 50 ha;114;3684;29;85;978;2706;31;83;6;23;25;60;0;21;4;40;;
Joaquim Távora;De 50 a menos de 100 ha;44;3094;29;15;2173;921;10;34;7;22;3;12;2;17;0;9;;
Joaquim Távora;De 100 a menos de 200 ha;17;2356;17;0;2356;0;9;8;9;8;0;0;0;8;0;0;;
Joaquim Távora;De 200 a menos de 500 ha;16;5236;16;0;5236;0;5;11;5;11;0;0;0;10;0;0;;
Joaquim Távora;De 500 a menos de 1.000 ha;4;2595;4;0;2595;0;2;2;2;2;0;0;0;2;0;0;;
Joaquim Távora;De 1.000 a menos de 2.500 ha;2;0;2;0;0;0;2;0;2;0;0;0;0;0;0;0;;
Joaquim Távora;De 2.500 a menos de 10.000 ha;1;0;1;0;0;0;1;0;1;0;0;0;0;0;0;0;;
Joaquim Távora;De 10.000 ha e mais;0;0;0;0;0;0;0;0;0;0;0;0;0;0;0;0;;
Joaquim Távora;Produtor sem área;0;0;0;0;0;0;0;0;0;0;0;0;0;0;0;0;;
Jundiaí do Sul;Mais de 0 a menos de 0,1 ha;0;0;0;0;0;0;0;0;0;0;0;0;0;0;0;0;;
Jundiaí do Sul;De 0,1 a menos de 0,2 ha;3;0;3;0;0;0;1;2;1;2;0;0;1;1;0;0;;
Jundiaí do Sul;De 0,2 a menos de 0,5 ha;2;0;0;2;0;0;0;2;0;0;0;2;0;0;0;2;;
Jundiaí do Sul;De 0,5 a menos de 1 ha;32;16;5;27;3;14;0;32;0;5;0;27;0;5;0;22;;
Jundiaí do Sul;De 1 a menos de 2 ha;2;0;0;2;0;0;0;2;0;0;0;2;0;0;0;2;;
Jundiaí do Sul;De 2 a menos de 3 ha;4;10;2;2;0;0;0;4;0;2;0;2;0;2;0;1;;
Jundiaí do Sul;De 3 a menos de 4 ha;6;21;2;4;0;0;3;3;1;1;2;2;0;1;0;1;;
Jundiaí do Sul;De 4 a menos de 5 ha;5;24;1;4;0;0;0;5;0;1;0;4;0;1;0;4;;
Jundiaí do Sul;De 5 a menos de 10 ha;78;667;3;75;23;644;25;53;1;2;24;51;0;2;1;39;;
Jundiaí do Sul;De 10 a menos de 20 ha;96;1507;5;91;64;1443;40;56;0;5;40;51;0;4;0;47;;
Jundiaí do Sul;De 20 a menos de 50 ha;34;975;13;21;437;537;10;24;2;11;8;13;0;11;0;9;;
Jundiaí do Sul;De 50 a menos de 100 ha;9;598;4;5;293;305;2;7;0;4;2;3;0;3;0;3;;
Jundiaí do Sul;De 100 a menos de 200 ha;15;2221;15;0;2221;0;4;11;4;11;0;0;0;9;0;0;;
Jundiaí do Sul;De 200 a menos de 500 ha;22;6567;22;0;6567;0;10;12;10;12;0;0;0;11;0;0;;
Jundiaí do Sul;De 500 a menos de 1.000 ha;7;5182;7;0;5182;0;4;3;4;3;0;0;0;3;0;0;;
Jundiaí do Sul;De 1.000 a menos de 2.500 ha;9;12607;9;0;12607;0;5;4;5;4;0;0;0;3;0;0;;
Jundiaí do Sul;De 2.500 a menos de 10.000 ha;0;0;0;0;0;0;0;0;0;0;0;0;0;0;0;0;;
Jundiaí do Sul;De 10.000 ha e mais;0;0;0;0;0;0;0;0;0;0;0;0;0;0;0;0;;
Jundiaí do Sul;Produtor sem área;0;0;0;0;0;0;0;0;0;0;0;0;0;0;0;0;;
Juranda;Mais de 0 a menos de 0,1 ha;0;0;0;0;0;0;0;0;0;0;0;0;0;0;0;0;;
Juranda;De 0,1 a menos de 0,2 ha;2;0;0;2;0;0;1;1;0;0;1;1;0;0;1;0;;
Juranda;De 0,2 a menos de 0,5 ha;2;0;1;1;0;0;1;1;0;1;1;0;0;0;0;0;;
Juranda;De 0,5 a menos de 1 ha;7;4;1;6;0;0;1;6;0;1;1;5;1;0;2;0;;
Juranda;De 1 a menos de 2 ha;9;13;0;9;0;13;7;2;0;0;7;2;0;0;0;1;;
Juranda;De 2 a menos de 3 ha;8;20;3;5;8;12;6;2;2;1;4;1;1;0;0;0;;
Juranda;De 3 a menos de 4 ha;7;25;0;7;0;25;6;1;0;0;6;1;0;0;0;0;;
Juranda;De 4 a menos de 5 ha;17;80;4;13;19;61;10;7;2;2;8;5;1;1;0;4;;
Juranda;De 5 a menos de 10 ha;50;385;1;49;0;0;47;3;0;1;47;2;0;1;0;1;;
Juranda;De 10 a menos de 20 ha;105;1504;2;103;0;0;102;3;2;0;100;3;0;0;1;2;;
Juranda;De 20 a menos de 50 ha;90;2969;1;89;0;0;89;1;1;0;88;1;0;0;0;1;;
Juranda;De 50 a menos de 100 ha;57;4079;20;37;1779;2300;56;1;20;0;36;1;0;0;0;1;;
Juranda;De 100 a menos de 200 ha;46;6421;46;0;6421;0;46;0;46;0;0;0;0;0;0;0;;
Juranda;De 200 a menos de 500 ha;35;11050;35;0;11050;0;35;0;35;0;0;0;0;0;0;0;;
Juranda;De 500 a menos de 1.000 ha;5;0;5;0;0;0;5;0;5;0;0;0;0;0;0;0;;
Juranda;De 1.000 a menos de 2.500 ha;0;0;0;0;0;0;0;0;0;0;0;0;0;0;0;0;;
Juranda;De 2.500 a menos de 10.000 ha;0;0;0;0;0;0;0;0;0;0;0;0;0;0;0;0;;
Juranda;De 10.000 ha e mais;0;0;0;0;0;0;0;0;0;0;0;0;0;0;0;0;;
Juranda;Produtor sem área;0;0;0;0;0;0;0;0;0;0;0;0;0;0;0;0;;
Jussara;Mais de 0 a menos de 0,1 ha;2;0;0;2;0;0;0;2;0;0;0;2;0;0;0;2;;
Jussara;De 0,1 a menos de 0,2 ha;1;0;1;0;0;0;0;1;0;1;0;0;0;1;0;0;;
Jussara;De 0,2 a menos de 0,5 ha;0;0;0;0;0;0;0;0;0;0;0;0;0;0;0;0;;
Jussara;De 0,5 a menos de 1 ha;51;26;18;33;9;17;4;47;1;17;3;30;0;14;1;27;;
Jussara;De 1 a menos de 2 ha;9;9;4;5;4;5;1;8;0;4;1;4;0;4;0;4;;
Jussara;De 2 a menos de 3 ha;10;25;4;6;10;15;2;8;0;4;2;4;0;4;0;4;;
Jussara;De 3 a menos de 4 ha;3;11;2;1;0;0;2;1;1;1;1;0;0;0;0;0;;
Jussara;De 4 a menos de 5 ha;4;19;2;2;0;0;0;4;0;2;0;2;0;2;0;2;;
Jussara;De 5 a menos de 10 ha;18;143;7;11;51;92;10;8;2;5;8;3;0;4;1;2;;
Jussara;De 10 a menos de 20 ha;28;390;5;23;58;332;25;3;3;2;22;1;0;2;0;1;;
Jussara;De 20 a menos de 50 ha;41;1299;4;37;150;1149;39;2;4;0;35;2;0;0;0;1;;
Jussara;De 50 a menos de 100 ha;24;1923;9;15;854;1068;24;0;9;0;15;0;0;0;0;0;;
Jussara;De 100 a menos de 200 ha;18;2444;18;0;2444;0;16;2;16;2;0;0;0;0;0;0;;
Jussara;De 200 a menos de 500 ha;14;3908;14;0;3908;0;14;0;14;0;0;0;0;0;0;0;;
Jussara;De 500 a menos de 1.000 ha;3;2001;3;0;2001;0;3;0;3;0;0;0;0;0;0;0;;
Jussara;De 1.000 a menos de 2.500 ha;0;0;0;0;0;0;0;0;0;0;0;0;0;0;0;0;;
Jussara;De 2.500 a menos de 10.000 ha;1;0;1;0;0;0;1;0;1;0;0;0;0;0;0;0;;
Jussara;De 10.000 ha e mais;0;0;0;0;0;0;0;0;0;0;0;0;0;0;0;0;;
Jussara;Produtor sem área;0;0;0;0;0;0;0;0;0;0;0;0;0;0;0;0;;
Kaloré;Mais de 0 a menos de 0,1 ha;1;0;0;1;0;0;0;1;0;0;0;1;0;0;0;1;;
Kaloré;De 0,1 a menos de 0,2 ha;2;0;0;2;0;0;0;2;0;0;0;2;0;0;1;1;;
Kaloré;De 0,2 a menos de 0,5 ha;7;2;2;5;0;0;3;4;1;1;2;3;0;1;0;3;;
Kaloré;De 0,5 a menos de 1 ha;6;4;3;3;2;2;5;1;2;1;3;0;1;0;0;0;;
Kaloré;De 1 a menos de 2 ha;15;20;4;11;5;15;6;9;1;3;5;6;1;2;1;5;;
Kaloré;De 2 a menos de 3 ha;13;31;6;7;0;0;6;7;0;6;6;1;1;5;0;1;;
Kaloré;De 3 a menos de 4 ha;29;101;15;14;52;49;19;10;10;5;9;5;0;4;0;5;;
Kaloré;De 4 a menos de 5 ha;19;90;4;15;18;72;11;8;4;0;7;8;0;0;0;8;;
Kaloré;De 5 a menos de 10 ha;93;697;24;69;173;524;72;21;11;13;61;8;1;11;0;8;;
Kaloré;De 10 a menos de 20 ha;88;1274;11;77;144;1130;81;7;9;2;72;5;0;2;0;3;;
Kaloré;De 20 a menos de 50 ha;92;3072;11;81;341;2731;89;3;10;1;79;2;0;1;0;2;;
Kaloré;De 50 a menos de 100 ha;37;2538;17;20;1376;1162;36;1;16;1;20;0;0;1;0;0;;
Kaloré;De 100 a menos de 200 ha;22;3238;22;0;3238;0;20;2;20;2;0;0;0;2;0;0;;
Kaloré;De 200 a menos de 500 ha;14;4568;14;0;4568;0;14;0;14;0;0;0;0;0;0;0;;
Kaloré;De 500 a menos de 1.000 ha;3;0;3;0;0;0;3;0;3;0;0;0;0;0;0;0;;
Kaloré;De 1.000 a menos de 2.500 ha;0;0;0;0;0;0;0;0;0;0;0;0;0;0;0;0;;
Kaloré;De 2.500 a menos de 10.000 ha;0;0;0;0;0;0;0;0;0;0;0;0;0;0;0;0;;
Kaloré;De 10.000 ha e mais;0;0;0;0;0;0;0;0;0;0;0;0;0;0;0;0;;
Kaloré;Produtor sem área;0;0;0;0;0;0;0;0;0;0;0;0;0;0;0;0;;
Lapa;Mais de 0 a menos de 0,1 ha;14;1;3;11;0;0;5;9;0;3;5;6;0;3;0;5;;
Lapa;De 0,1 a menos de 0,2 ha;17;3;1;16;0;0;2;15;0;1;2;14;0;1;0;13;;
Lapa;De 0,2 a menos de 0,5 ha;46;16;11;35;4;12;10;36;0;11;10;25;0;11;3;15;;
Lapa;De 0,5 a menos de 1 ha;32;22;11;21;7;15;10;22;2;9;8;13;1;7;2;7;;
Lapa;De 1 a menos de 2 ha;102;138;22;80;31;107;49;53;12;10;37;43;1;8;6;23;;
Lapa;De 2 a menos de 3 ha;151;366;28;123;67;299;82;69;16;12;66;57;1;10;8;37;;
Lapa;De 3 a menos de 4 ha;95;334;12;83;43;291;67;28;9;3;58;25;0;3;1;16;;
Lapa;De 4 a menos de 5 ha;161;770;28;133;135;635;105;56;15;13;90;43;1;9;3;31;;
Lapa;De 5 a menos de 10 ha;386;2997;46;340;351;2647;280;106;22;24;258;82;4;17;10;50;;
Lapa;De 10 a menos de 20 ha;419;5972;38;381;539;5433;310;109;19;19;291;90;4;13;21;41;;
Lapa;De 20 a menos de 50 ha;454;14499;30;424;937;13562;386;68;23;7;363;61;1;5;8;43;;
Lapa;De 50 a menos de 100 ha;208;14194;117;91;9018;5176;185;23;105;12;80;11;1;10;0;8;;
Lapa;De 100 a menos de 200 ha;97;13754;97;0;13754;0;76;21;76;21;0;0;1;9;0;0;;
Lapa;De 200 a menos de 500 ha;74;23868;74;0;23868;0;61;13;61;13;0;0;0;8;0;0;;
Lapa;De 500 a menos de 1.000 ha;18;13002;18;0;13002;0;14;4;14;4;0;0;0;2;0;0;;
Lapa;De 1.000 a menos de 2.500 ha;11;16315;11;0;16315;0;9;2;9;2;0;0;0;2;0;0;;
Lapa;De 2.500 a menos de 10.000 ha;3;0;3;0;0;0;2;1;2;1;0;0;0;1;0;0;;
Lapa;De 10.000 ha e mais;0;0;0;0;0;0;0;0;0;0;0;0;0;0;0;0;;
Lapa;Produtor sem área;2;0;0;2;0;0;0;1;0;0;0;1;0;0;0;1;;
Laranjal;Mais de 0 a menos de 0,1 ha;3;0;0;3;0;0;0;3;0;0;0;3;0;0;0;3;;
Laranjal;De 0,1 a menos de 0,2 ha;1;0;0;1;0;0;0;1;0;0;0;1;0;0;0;1;;
Laranjal;De 0,2 a menos de 0,5 ha;15;7;3;12;0;0;1;14;0;3;1;11;0;2;0;7;;
Laranjal;De 0,5 a menos de 1 ha;12;9;2;10;0;0;3;9;1;1;2;8;0;0;0;7;;
Laranjal;De 1 a menos de 2 ha;7;10;1;6;0;0;1;6;0;1;1;5;0;1;0;4;;
Laranjal;De 2 a menos de 3 ha;14;34;2;12;0;0;3;11;0;2;3;9;1;1;1;8;;
Laranjal;De 3 a menos de 4 ha;13;46;0;13;0;46;4;9;0;0;4;9;0;0;0;7;;
Laranjal;De 4 a menos de 5 ha;42;203;1;41;0;0;8;34;0;1;8;33;0;1;1;29;;
Laranjal;De 5 a menos de 10 ha;89;712;4;85;30;682;32;57;3;1;29;56;0;1;3;48;;
Laranjal;De 10 a menos de 20 ha;357;5778;15;342;240;5538;198;159;6;9;192;150;1;7;7;122;;
Laranjal;De 20 a menos de 50 ha;142;4199;3;139;80;4119;59;83;3;0;56;83;0;0;3;66;;
Laranjal;De 50 a menos de 100 ha;39;2777;12;27;1054;1723;15;24;6;6;9;18;0;6;1;9;;
Laranjal;De 100 a menos de 200 ha;43;6503;43;0;6503;0;10;33;10;33;0;0;0;27;0;0;;
Laranjal;De 200 a menos de 500 ha;17;6135;17;0;6135;0;8;9;8;9;0;0;0;9;0;0;;
Laranjal;De 500 a menos de 1.000 ha;12;8495;12;0;8495;0;6;6;6;6;0;0;0;4;0;0;;
Laranjal;De 1.000 a menos de 2.500 ha;5;7144;5;0;7144;0;1;4;1;4;0;0;0;3;0;0;;
Laranjal;De 2.500 a menos de 10.000 ha;2;0;2;0;0;0;0;2;0;2;0;0;0;2;0;0;;
Laranjal;De 10.000 ha e mais;0;0;0;0;0;0;0;0;0;0;0;0;0;0;0;0;;
Laranjal;Produtor sem área;1;0;1;0;0;0;0;1;0;1;0;0;0;1;0;0;;
Laranjeiras do Sul;Mais de 0 a menos de 0,1 ha;2;0;1;1;0;0;0;2;0;1;0;1;0;1;0;1;;
Laranjeiras do Sul;De 0,1 a menos de 0,2 ha;10;2;4;6;0;1;5;5;2;2;3;3;0;2;0;1;;
Laranjeiras do Sul;De 0,2 a menos de 0,5 ha;23;7;9;14;3;4;6;17;4;5;2;12;0;5;1;6;;
Laranjeiras do Sul;De 0,5 a menos de 1 ha;45;29;8;37;6;23;20;25;8;0;12;25;0;0;2;15;;
Laranjeiras do Sul;De 1 a menos de 2 ha;48;61;13;35;18;44;20;28;5;8;15;20;1;5;1;12;;
Laranjeiras do Sul;De 2 a menos de 3 ha;56;134;14;42;33;101;25;31;4;10;21;21;1;7;1;13;;
Laranjeiras do Sul;De 3 a menos de 4 ha;59;203;17;42;58;145;34;25;10;7;24;18;1;5;1;10;;
Laranjeiras do Sul;De 4 a menos de 5 ha;64;302;8;56;36;266;38;26;4;4;34;22;0;3;0;14;;
Laranjeiras do Sul;De 5 a menos de 10 ha;188;1427;25;163;182;1245;130;58;13;12;117;46;1;8;2;28;;
Laranjeiras do Sul;De 10 a menos de 20 ha;329;4733;30;299;444;4289;263;66;15;15;248;51;3;8;12;27;;
Laranjeiras do Sul;De 20 a menos de 50 ha;293;9230;32;261;1083;8148;258;35;22;10;236;25;1;6;1;14;;
Laranjeiras do Sul;De 50 a menos de 100 ha;107;7498;57;50;4493;3005;99;8;52;5;47;3;0;4;0;3;;
Laranjeiras do Sul;De 100 a menos de 200 ha;62;8951;62;0;8951;0;53;9;53;9;0;0;1;6;0;0;;
Laranjeiras do Sul;De 200 a menos de 500 ha;41;12428;40;1;0;0;34;7;33;7;1;0;0;6;0;0;;
Laranjeiras do Sul;De 500 a menos de 1.000 ha;13;8606;13;0;8606;0;10;3;10;3;0;0;0;3;0;0;;
Laranjeiras do Sul;De 1.000 a menos de 2.500 ha;3;0;3;0;0;0;3;0;3;0;0;0;0;0;0;0;;
Laranjeiras do Sul;De 2.500 a menos de 10.000 ha;0;0;0;0;0;0;0;0;0;0;0;0;0;0;0;0;;
Laranjeiras do Sul;De 10.000 ha e mais;0;0;0;0;0;0;0;0;0;0;0;0;0;0;0;0;;
Laranjeiras do Sul;Produtor sem área;2;0;0;2;0;0;0;0;0;0;0;0;0;0;0;0;;
Leópolis;Mais de 0 a menos de 0,1 ha;1;0;0;1;0;0;1;0;0;0;1;0;0;0;0;0;;
Leópolis;De 0,1 a menos de 0,2 ha;2;0;0;2;0;0;0;2;0;0;0;2;0;0;0;1;;
Leópolis;De 0,2 a menos de 0,5 ha;1;0;0;1;0;0;0;1;0;0;0;1;0;0;0;1;;
Leópolis;De 0,5 a menos de 1 ha;28;14;1;27;0;0;9;19;1;0;8;19;0;0;0;16;;
Leópolis;De 1 a menos de 2 ha;4;5;0;4;0;5;3;1;0;0;3;1;0;0;0;0;;
Leópolis;De 2 a menos de 3 ha;7;17;0;7;0;17;4;3;0;0;4;3;0;0;0;2;;
Leópolis;De 3 a menos de 4 ha;13;45;0;13;0;45;4;9;0;0;4;9;0;0;1;6;;
Leópolis;De 4 a menos de 5 ha;17;81;2;15;0;0;6;11;0;2;6;9;0;2;0;6;;
Leópolis;De 5 a menos de 10 ha;40;318;2;38;0;0;16;24;0;2;16;22;0;2;0;15;;
Leópolis;De 10 a menos de 20 ha;47;670;2;45;0;0;20;27;1;1;19;26;0;1;0;21;;
Leópolis;De 20 a menos de 50 ha;52;1766;6;46;218;1548;28;24;6;0;22;24;0;0;0;21;;
Leópolis;De 50 a menos de 100 ha;28;2051;16;12;1322;730;15;13;10;6;5;7;0;4;0;5;;
Leópolis;De 100 a menos de 200 ha;29;4207;29;0;4207;0;20;9;20;9;0;0;0;6;0;0;;
Leópolis;De 200 a menos de 500 ha;22;6727;22;0;6727;0;20;2;20;2;0;0;0;2;0;0;;
Leópolis;De 500 a menos de 1.000 ha;5;3579;5;0;3579;0;4;1;4;1;0;0;0;1;0;0;;
Leópolis;De 1.000 a menos de 2.500 ha;3;0;3;0;0;0;3;0;3;0;0;0;0;0;0;0;;
Leópolis;De 2.500 a menos de 10.000 ha;1;0;1;0;0;0;1;0;1;0;0;0;0;0;0;0;;
Leópolis;De 10.000 ha e mais;0;0;0;0;0;0;0;0;0;0;0;0;0;0;0;0;;
Leópolis;Produtor sem área;0;0;0;0;0;0;0;0;0;0;0;0;0;0;0;0;;
Lidianópolis;Mais de 0 a menos de 0,1 ha;0;0;0;0;0;0;0;0;0;0;0;0;0;0;0;0;;
Lidianópolis;De 0,1 a menos de 0,2 ha;2;0;0;2;0;0;2;0;0;0;2;0;0;0;0;0;;
Lidianópolis;De 0,2 a menos de 0,5 ha;8;0;0;8;0;0;1;7;0;0;1;7;0;0;0;7;;
Lidianópolis;De 0,5 a menos de 1 ha;49;28;6;43;3;25;32;17;0;6;32;11;0;5;0;9;;
Lidianópolis;De 1 a menos de 2 ha;24;34;0;24;0;34;16;8;0;0;16;8;0;0;0;8;;
Lidianópolis;De 2 a menos de 3 ha;14;33;2;12;0;0;10;4;1;1;9;3;0;0;0;3;;
Lidianópolis;De 3 a menos de 4 ha;23;83;1;22;0;0;16;7;1;0;15;7;0;0;0;7;;
Lidianópolis;De 4 a menos de 5 ha;19;91;0;19;0;91;16;3;0;0;16;3;0;0;0;2;;
Lidianópolis;De 5 a menos de 10 ha;69;528;5;64;46;481;57;12;4;1;53;11;0;1;0;7;;
Lidianópolis;De 10 a menos de 20 ha;54;768;4;50;52;717;46;8;3;1;43;7;0;1;0;5;;
Lidianópolis;De 20 a menos de 50 ha;48;1434;2;46;0;0;47;1;2;0;45;1;0;0;0;1;;
Lidianópolis;De 50 a menos de 100 ha;16;1148;8;8;0;0;15;1;8;0;7;1;0;0;0;1;;
Lidianópolis;De 100 a menos de 200 ha;9;1246;9;0;1246;0;9;0;9;0;0;0;0;0;0;0;;
Lidianópolis;De 200 a menos de 500 ha;7;2093;7;0;2093;0;7;0;7;0;0;0;0;0;0;0;;
Lidianópolis;De 500 a menos de 1.000 ha;2;0;2;0;0;0;2;0;2;0;0;0;0;0;0;0;;
Lidianópolis;De 1.000 a menos de 2.500 ha;1;0;1;0;0;0;1;0;1;0;0;0;0;0;0;0;;
Lidianópolis;De 2.500 a menos de 10.000 ha;0;0;0;0;0;0;0;0;0;0;0;0;0;0;0;0;;
Lidianópolis;De 10.000 ha e mais;0;0;0;0;0;0;0;0;0;0;0;0;0;0;0;0;;
Lidianópolis;Produtor sem área;0;0;0;0;0;0;0;0;0;0;0;0;0;0;0;0;;
Lindoeste;Mais de 0 a menos de 0,1 ha;2;0;1;1;0;0;0;2;0;1;0;1;0;1;0;0;;
Lindoeste;De 0,1 a menos de 0,2 ha;1;0;0;1;0;0;0;1;0;0;0;1;0;0;0;1;;
Lindoeste;De 0,2 a menos de 0,5 ha;12;4;9;3;0;0;4;8;4;5;0;3;1;3;1;2;;
Lindoeste;De 0,5 a menos de 1 ha;42;26;9;33;5;20;11;31;0;9;11;22;0;4;2;3;;
Lindoeste;De 1 a menos de 2 ha;23;32;10;13;14;18;9;14;3;7;6;7;0;5;1;2;;
Lindoeste;De 2 a menos de 3 ha;28;67;8;20;19;49;11;17;1;7;10;10;1;4;1;4;;
Lindoeste;De 3 a menos de 4 ha;26;92;7;19;25;68;17;9;5;2;12;7;0;2;1;1;;
Lindoeste;De 4 a menos de 5 ha;48;224;7;41;34;191;21;27;3;4;18;23;0;4;0;6;;
Lindoeste;De 5 a menos de 10 ha;157;1210;21;136;170;1040;90;67;13;8;77;59;0;5;3;12;;
Lindoeste;De 10 a menos de 20 ha;261;3630;25;236;346;3284;165;96;14;11;151;85;0;10;9;24;;
Lindoeste;De 20 a menos de 50 ha;88;2660;11;77;347;2314;64;24;7;4;57;20;0;2;1;1;;
Lindoeste;De 50 a menos de 100 ha;30;2059;12;18;980;1079;20;10;7;5;13;5;0;0;0;0;;
Lindoeste;De 100 a menos de 200 ha;16;2150;16;0;2150;0;12;4;12;4;0;0;0;1;0;0;;
Lindoeste;De 200 a menos de 500 ha;26;8285;26;0;8285;0;24;2;24;2;0;0;0;0;0;0;;
Lindoeste;De 500 a menos de 1.000 ha;6;0;6;0;0;0;5;1;5;1;0;0;0;1;0;0;;
Lindoeste;De 1.000 a menos de 2.500 ha;4;0;4;0;0;0;4;0;4;0;0;0;0;0;0;0;;
Lindoeste;De 2.500 a menos de 10.000 ha;0;0;0;0;0;0;0;0;0;0;0;0;0;0;0;0;;
Lindoeste;De 10.000 ha e mais;0;0;0;0;0;0;0;0;0;0;0;0;0;0;0;0;;
Lindoeste;Produtor sem área;0;0;0;0;0;0;0;0;0;0;0;0;0;0;0;0;;
Loanda;Mais de 0 a menos de 0,1 ha;1;0;0;1;0;0;0;1;0;0;0;1;0;0;0;1;;
Loanda;De 0,1 a menos de 0,2 ha;0;0;0;0;0;0;0;0;0;0;0;0;0;0;0;0;;
Loanda;De 0,2 a menos de 0,5 ha;5;2;1;4;0;0;0;5;0;1;0;4;0;0;0;3;;
Loanda;De 0,5 a menos de 1 ha;1;0;0;1;0;0;0;1;0;0;0;1;0;0;1;0;;
Loanda;De 1 a menos de 2 ha;3;4;1;2;0;0;0;3;0;1;0;2;0;1;0;1;;
Loanda;De 2 a menos de 3 ha;7;17;3;4;0;0;0;7;0;3;0;4;0;3;0;3;;
Loanda;De 3 a menos de 4 ha;8;28;2;6;0;0;2;6;1;1;1;5;0;1;0;4;;
Loanda;De 4 a menos de 5 ha;14;67;6;8;28;38;1;13;1;5;0;8;0;5;0;6;;
Loanda;De 5 a menos de 10 ha;65;517;22;43;177;340;7;58;3;19;4;39;0;18;2;30;;
Loanda;De 10 a menos de 20 ha;70;1005;26;44;380;625;9;61;5;21;4;40;1;15;0;28;;
Loanda;De 20 a menos de 50 ha;72;2354;18;54;587;1767;13;59;2;16;11;43;0;15;1;31;;
Loanda;De 50 a menos de 100 ha;46;3391;16;30;1211;2181;14;32;5;11;9;21;0;11;0;17;;
Loanda;De 100 a menos de 200 ha;58;7926;58;0;7926;0;11;47;11;47;0;0;0;37;0;0;;
Loanda;De 200 a menos de 500 ha;44;13618;44;0;13618;0;17;27;17;27;0;0;0;18;0;0;;
Loanda;De 500 a menos de 1.000 ha;16;11031;16;0;11031;0;6;10;6;10;0;0;0;4;0;0;;
Loanda;De 1.000 a menos de 2.500 ha;8;10662;8;0;10662;0;5;3;5;3;0;0;0;1;0;0;;
Loanda;De 2.500 a menos de 10.000 ha;3;0;3;0;0;0;2;1;2;1;0;0;0;1;0;0;;
Loanda;De 10.000 ha e mais;0;0;0;0;0;0;0;0;0;0;0;0;0;0;0;0;;
Loanda;Produtor sem área;0;0;0;0;0;0;0;0;0;0;0;0;0;0;0;0;;
Lobato;Mais de 0 a menos de 0,1 ha;0;0;0;0;0;0;0;0;0;0;0;0;0;0;0;0;;
Lobato;De 0,1 a menos de 0,2 ha;0;0;0;0;0;0;0;0;0;0;0;0;0;0;0;0;;
Lobato;De 0,2 a menos de 0,5 ha;2;0;0;2;0;0;1;1;0;0;1;1;0;0;0;1;;
Lobato;De 0,5 a menos de 1 ha;1;0;0;1;0;0;1;0;0;0;1;0;0;0;0;0;;
Lobato;De 1 a menos de 2 ha;1;0;0;1;0;0;1;0;0;0;1;0;0;0;0;0;;
Lobato;De 2 a menos de 3 ha;4;11;0;4;0;11;1;3;0;0;1;3;0;0;0;1;;
Lobato;De 3 a menos de 4 ha;12;43;2;10;0;0;7;5;1;1;6;4;0;0;0;2;;
Lobato;De 4 a menos de 5 ha;5;24;1;4;0;0;1;4;0;1;1;3;0;0;0;1;;
Lobato;De 5 a menos de 10 ha;24;187;2;22;0;0;7;17;0;2;7;15;0;1;1;7;;
Lobato;De 10 a menos de 20 ha;19;276;3;16;42;234;4;15;0;3;4;12;0;1;0;8;;
Lobato;De 20 a menos de 50 ha;34;1174;5;29;187;987;25;9;5;0;20;9;0;0;0;5;;
Lobato;De 50 a menos de 100 ha;23;1707;17;6;1354;352;14;9;11;6;3;3;0;3;0;3;;
Lobato;De 100 a menos de 200 ha;13;1763;13;0;1763;0;12;1;12;1;0;0;0;0;0;0;;
Lobato;De 200 a menos de 500 ha;16;5208;16;0;5208;0;15;1;15;1;0;0;0;0;0;0;;
Lobato;De 500 a menos de 1.000 ha;3;2268;3;0;2268;0;3;0;3;0;0;0;0;0;0;0;;
Lobato;De 1.000 a menos de 2.500 ha;0;0;0;0;0;0;0;0;0;0;0;0;0;0;0;0;;
Lobato;De 2.500 a menos de 10.000 ha;0;0;0;0;0;0;0;0;0;0;0;0;0;0;0;0;;
Lobato;De 10.000 ha e mais;1;0;1;0;0;0;1;0;1;0;0;0;0;0;0;0;;
Lobato;Produtor sem área;0;0;0;0;0;0;0;0;0;0;0;0;0;0;0;0;;
Londrina;Mais de 0 a menos de 0,1 ha;3;0;0;3;0;0;1;2;0;0;1;2;0;0;0;2;;
Londrina;De 0,1 a menos de 0,2 ha;4;0;1;3;0;0;0;4;0;1;0;3;0;1;1;2;;
Londrina;De 0,2 a menos de 0,5 ha;31;10;8;23;2;8;3;28;1;7;2;21;1;5;2;10;;
Londrina;De 0,5 a menos de 1 ha;166;91;67;99;37;55;52;114;24;43;28;71;5;28;9;45;;
Londrina;De 1 a menos de 2 ha;84;109;34;50;41;68;21;63;10;24;11;39;3;17;10;18;;
Londrina;De 2 a menos de 3 ha;177;416;45;132;105;311;77;100;15;30;62;70;6;18;16;31;;
Londrina;De 3 a menos de 4 ha;104;366;23;81;80;287;54;50;12;11;42;39;1;6;4;16;;
Londrina;De 4 a menos de 5 ha;99;467;21;78;101;366;44;55;6;15;38;40;0;10;6;21;;
Londrina;De 5 a menos de 10 ha;534;4348;74;460;584;3764;360;174;42;32;318;142;6;23;22;82;;
Londrina;De 10 a menos de 20 ha;423;5728;74;349;1008;4721;316;107;50;24;266;83;5;17;15;50;;
Londrina;De 20 a menos de 50 ha;225;7219;62;163;2307;4912;184;41;44;18;140;23;3;9;1;15;;
Londrina;De 50 a menos de 100 ha;133;9723;133;0;9723;0;109;24;109;24;0;0;0;19;0;0;;
Londrina;De 100 a menos de 200 ha;96;13777;96;0;13777;0;78;18;78;18;0;0;0;16;0;0;;
Londrina;De 200 a menos de 500 ha;77;25187;77;0;25187;0;73;4;73;4;0;0;0;3;0;0;;
Londrina;De 500 a menos de 1.000 ha;28;18805;28;0;18805;0;27;1;27;1;0;0;0;0;0;0;;
Londrina;De 1.000 a menos de 2.500 ha;16;22058;16;0;22058;0;16;0;16;0;0;0;0;0;0;0;;
Londrina;De 2.500 a menos de 10.000 ha;2;0;2;0;0;0;2;0;2;0;0;0;0;0;0;0;;
Londrina;De 10.000 ha e mais;0;0;0;0;0;0;0;0;0;0;0;0;0;0;0;0;;
Londrina;Produtor sem área;3;0;2;1;0;0;1;0;0;0;1;0;0;0;0;0;;
Luiziana;Mais de 0 a menos de 0,1 ha;1;0;0;1;0;0;0;1;0;0;0;1;0;0;0;1;;
Luiziana;De 0,1 a menos de 0,2 ha;1;0;0;1;0;0;0;1;0;0;0;1;0;0;0;1;;
Luiziana;De 0,2 a menos de 0,5 ha;1;0;0;1;0;0;0;1;0;0;0;1;0;0;0;1;;
Luiziana;De 0,5 a menos de 1 ha;33;19;5;28;3;16;5;28;0;5;5;23;0;5;0;14;;
Luiziana;De 1 a menos de 2 ha;4;5;0;4;0;5;0;4;0;0;0;4;0;0;0;3;;
Luiziana;De 2 a menos de 3 ha;6;14;1;5;0;0;2;4;1;0;1;4;0;0;0;2;;
Luiziana;De 3 a menos de 4 ha;10;35;2;8;0;0;3;7;1;1;2;6;0;1;1;3;;
Luiziana;De 4 a menos de 5 ha;11;53;2;9;0;0;3;8;0;2;3;6;0;2;0;6;;
Luiziana;De 5 a menos de 10 ha;34;265;4;30;27;238;20;14;1;3;19;11;0;2;0;9;;
Luiziana;De 10 a menos de 20 ha;64;870;4;60;58;812;48;16;1;3;47;13;0;3;0;13;;
Luiziana;De 20 a menos de 50 ha;65;2153;5;60;177;1976;46;19;4;1;42;18;0;1;0;16;;
Luiziana;De 50 a menos de 100 ha;41;3002;26;15;2092;909;32;9;21;5;11;4;0;5;0;4;;
Luiziana;De 100 a menos de 200 ha;43;6314;43;0;6314;0;39;4;39;4;0;0;0;4;0;0;;
Luiziana;De 200 a menos de 500 ha;65;22134;65;0;22134;0;57;8;57;8;0;0;0;8;0;0;;
Luiziana;De 500 a menos de 1.000 ha;32;21571;32;0;21571;0;30;2;30;2;0;0;0;2;0;0;;
Luiziana;De 1.000 a menos de 2.500 ha;11;15782;11;0;15782;0;11;0;11;0;0;0;0;0;0;0;;
Luiziana;De 2.500 a menos de 10.000 ha;2;0;2;0;0;0;2;0;2;0;0;0;0;0;0;0;;
Luiziana;De 10.000 ha e mais;0;0;0;0;0;0;0;0;0;0;0;0;0;0;0;0;;
Luiziana;Produtor sem área;5;0;2;3;0;0;1;0;1;0;0;0;0;0;0;0;;
Lunardelli;Mais de 0 a menos de 0,1 ha;2;0;2;0;0;0;0;2;0;2;0;0;0;2;0;0;;
Lunardelli;De 0,1 a menos de 0,2 ha;3;0;1;2;0;0;0;3;0;1;0;2;0;1;0;2;;
Lunardelli;De 0,2 a menos de 0,5 ha;5;2;1;4;0;0;1;4;0;1;1;3;0;1;1;2;;
Lunardelli;De 0,5 a menos de 1 ha;65;35;21;44;11;24;45;20;14;7;31;13;2;5;3;5;;
Lunardelli;De 1 a menos de 2 ha;28;36;8;20;9;26;10;18;0;8;10;10;0;7;0;10;;
Lunardelli;De 2 a menos de 3 ha;16;39;4;12;9;29;11;5;4;0;7;5;0;0;2;1;;
Lunardelli;De 3 a menos de 4 ha;16;56;0;16;0;56;12;4;0;0;12;4;0;0;1;3;;
Lunardelli;De 4 a menos de 5 ha;22;105;5;17;24;81;14;8;3;2;11;6;0;2;0;4;;
Lunardelli;De 5 a menos de 10 ha;48;371;3;45;0;0;37;11;3;0;34;11;0;0;0;9;;
Lunardelli;De 10 a menos de 20 ha;55;814;2;53;0;0;47;8;1;1;46;7;0;1;0;4;;
Lunardelli;De 20 a menos de 50 ha;57;1827;7;50;222;1606;44;13;6;1;38;12;0;1;0;10;;
Lunardelli;De 50 a menos de 100 ha;27;1951;17;10;1363;588;26;1;17;0;9;1;0;0;0;1;;
Lunardelli;De 100 a menos de 200 ha;12;1737;12;0;1737;0;10;2;10;2;0;0;0;2;0;0;;
Lunardelli;De 200 a menos de 500 ha;6;2190;6;0;2190;0;6;0;6;0;0;0;0;0;0;0;;
Lunardelli;De 500 a menos de 1.000 ha;2;0;2;0;0;0;2;0;2;0;0;0;0;0;0;0;;
Lunardelli;De 1.000 a menos de 2.500 ha;5;6601;5;0;6601;0;5;0;5;0;0;0;0;0;0;0;;
Lunardelli;De 2.500 a menos de 10.000 ha;0;0;0;0;0;0;0;0;0;0;0;0;0;0;0;0;;
Lunardelli;De 10.000 ha e mais;0;0;0;0;0;0;0;0;0;0;0;0;0;0;0;0;;
Lunardelli;Produtor sem área;0;0;0;0;0;0;0;0;0;0;0;0;0;0;0;0;;
Lupionópolis;Mais de 0 a menos de 0,1 ha;0;0;0;0;0;0;0;0;0;0;0;0;0;0;0;0;;
Lupionópolis;De 0,1 a menos de 0,2 ha;1;0;0;1;0;0;0;1;0;0;0;1;0;0;0;1;;
Lupionópolis;De 0,2 a menos de 0,5 ha;1;0;0;1;0;0;0;1;0;0;0;1;0;0;0;0;;
Lupionópolis;De 0,5 a menos de 1 ha;12;6;5;7;3;4;6;6;2;3;4;3;0;3;1;1;;
Lupionópolis;De 1 a menos de 2 ha;8;10;3;5;3;7;4;4;1;2;3;2;0;2;0;1;;
Lupionópolis;De 2 a menos de 3 ha;6;14;2;4;0;0;0;6;0;2;0;4;0;2;0;2;;
Lupionópolis;De 3 a menos de 4 ha;3;11;1;2;0;0;1;2;0;1;1;1;0;0;0;0;;
Lupionópolis;De 4 a menos de 5 ha;6;29;1;5;0;0;1;5;0;1;1;4;0;1;0;1;;
Lupionópolis;De 5 a menos de 10 ha;57;457;6;51;45;412;33;24;2;4;31;20;0;2;2;7;;
Lupionópolis;De 10 a menos de 20 ha;26;398;3;23;0;0;8;18;0;3;8;15;0;1;3;3;;
Lupionópolis;De 20 a menos de 50 ha;27;814;5;22;192;622;15;12;3;2;12;10;0;1;0;3;;
Lupionópolis;De 50 a menos de 100 ha;13;942;11;2;0;0;9;4;7;4;2;0;0;3;0;0;;
Lupionópolis;De 100 a menos de 200 ha;7;806;7;0;806;0;2;5;2;5;0;0;0;0;0;0;;
Lupionópolis;De 200 a menos de 500 ha;3;819;3;0;819;0;2;1;2;1;0;0;0;1;0;0;;
Lupionópolis;De 500 a menos de 1.000 ha;1;0;1;0;0;0;1;0;1;0;0;0;0;0;0;0;;
Lupionópolis;De 1.000 a menos de 2.500 ha;1;0;1;0;0;0;1;0;1;0;0;0;0;0;0;0;;
Lupionópolis;De 2.500 a menos de 10.000 ha;1;0;1;0;0;0;1;0;1;0;0;0;0;0;0;0;;
Lupionópolis;De 10.000 ha e mais;0;0;0;0;0;0;0;0;0;0;0;0;0;0;0;0;;
Lupionópolis;Produtor sem área;0;0;0;0;0;0;0;0;0;0;0;0;0;0;0;0;;
Mallet;Mais de 0 a menos de 0,1 ha;1;0;0;1;0;0;0;1;0;0;0;1;0;0;0;1;;
Mallet;De 0,1 a menos de 0,2 ha;3;0;1;2;0;0;1;2;0;1;1;1;0;1;0;1;;
Mallet;De 0,2 a menos de 0,5 ha;6;2;4;2;0;0;2;4;1;3;1;1;0;2;0;0;;
Mallet;De 0,5 a menos de 1 ha;11;8;4;7;3;5;1;10;1;3;0;7;0;2;0;4;;
Mallet;De 1 a menos de 2 ha;36;51;16;20;23;27;16;20;10;6;6;14;0;5;0;11;;
Mallet;De 2 a menos de 3 ha;69;171;14;55;35;136;29;40;1;13;28;27;0;12;0;23;;
Mallet;De 3 a menos de 4 ha;63;222;21;42;74;148;36;27;8;13;28;14;0;10;0;11;;
Mallet;De 4 a menos de 5 ha;98;471;19;79;90;380;50;48;8;11;42;37;0;11;0;34;;
Mallet;De 5 a menos de 10 ha;256;1969;32;224;245;1723;177;79;12;20;165;59;0;18;0;47;;
Mallet;De 10 a menos de 20 ha;418;6150;42;376;613;5537;316;102;18;24;298;78;0;23;0;59;;
Mallet;De 20 a menos de 50 ha;422;12604;27;395;776;11828;366;56;11;16;355;40;0;16;0;32;;
Mallet;De 50 a menos de 100 ha;94;6428;58;36;4345;2083;79;15;46;12;33;3;0;11;0;2;;
Mallet;De 100 a menos de 200 ha;28;3750;28;0;3750;0;21;7;21;7;0;0;0;7;0;0;;
Mallet;De 200 a menos de 500 ha;12;3879;12;0;3879;0;7;5;7;5;0;0;0;5;0;0;;
Mallet;De 500 a menos de 1.000 ha;4;0;4;0;0;0;1;3;1;3;0;0;0;3;0;0;;
Mallet;De 1.000 a menos de 2.500 ha;0;0;0;0;0;0;0;0;0;0;0;0;0;0;0;0;;
Mallet;De 2.500 a menos de 10.000 ha;2;0;2;0;0;0;0;2;0;2;0;0;0;2;0;0;;
Mallet;De 10.000 ha e mais;0;0;0;0;0;0;0;0;0;0;0;0;0;0;0;0;;
Mallet;Produtor sem área;1;0;0;1;0;0;0;0;0;0;0;0;0;0;0;0;;
Mamborê;Mais de 0 a menos de 0,1 ha;0;0;0;0;0;0;0;0;0;0;0;0;0;0;0;0;;
Mamborê;De 0,1 a menos de 0,2 ha;0;0;0;0;0;0;0;0;0;0;0;0;0;0;0;0;;
Mamborê;De 0,2 a menos de 0,5 ha;1;0;1;0;0;0;0;1;0;1;0;0;0;0;0;0;;
Mamborê;De 0,5 a menos de 1 ha;2;0;0;2;0;0;1;1;0;0;1;1;0;0;0;1;;
Mamborê;De 1 a menos de 2 ha;10;14;1;9;0;0;3;7;0;1;3;6;1;0;0;5;;
Mamborê;De 2 a menos de 3 ha;9;22;5;4;0;0;3;6;1;4;2;2;0;3;1;1;;
Mamborê;De 3 a menos de 4 ha;17;58;1;16;0;0;6;11;0;1;6;10;0;1;0;7;;
Mamborê;De 4 a menos de 5 ha;27;125;2;25;0;0;15;12;1;1;14;11;1;0;1;8;;
Mamborê;De 5 a menos de 10 ha;42;308;2;40;0;0;28;14;0;2;28;12;0;1;0;8;;
Mamborê;De 10 a menos de 20 ha;70;1031;1;69;0;0;62;8;0;1;62;7;0;0;0;5;;
Mamborê;De 20 a menos de 50 ha;101;3334;5;96;165;3169;98;3;4;1;94;2;0;1;0;2;;
Mamborê;De 50 a menos de 100 ha;64;4802;32;32;2789;2013;61;3;30;2;31;1;0;1;1;0;;
Mamborê;De 100 a menos de 200 ha;68;9433;68;0;9433;0;66;2;66;2;0;0;0;1;0;0;;
Mamborê;De 200 a menos de 500 ha;68;21511;68;0;21511;0;68;0;68;0;0;0;0;0;0;0;;
Mamborê;De 500 a menos de 1.000 ha;25;16727;25;0;16727;0;25;0;25;0;0;0;0;0;0;0;;
Mamborê;De 1.000 a menos de 2.500 ha;10;13256;10;0;13256;0;10;0;10;0;0;0;0;0;0;0;;
Mamborê;De 2.500 a menos de 10.000 ha;0;0;0;0;0;0;0;0;0;0;0;0;0;0;0;0;;
Mamborê;De 10.000 ha e mais;0;0;0;0;0;0;0;0;0;0;0;0;0;0;0;0;;
Mamborê;Produtor sem área;0;0;0;0;0;0;0;0;0;0;0;0;0;0;0;0;;
Mandaguaçu;Mais de 0 a menos de 0,1 ha;0;0;0;0;0;0;0;0;0;0;0;0;0;0;0;0;;
Mandaguaçu;De 0,1 a menos de 0,2 ha;0;0;0;0;0;0;0;0;0;0;0;0;0;0;0;0;;
Mandaguaçu;De 0,2 a menos de 0,5 ha;4;0;0;4;0;0;0;4;0;0;0;4;0;0;0;3;;
Mandaguaçu;De 0,5 a menos de 1 ha;42;22;11;31;6;16;5;37;3;8;2;29;2;3;17;5;;
Mandaguaçu;De 1 a menos de 2 ha;15;22;4;11;0;0;2;13;0;4;2;9;1;3;0;7;;
Mandaguaçu;De 2 a menos de 3 ha;17;43;9;8;22;21;5;12;3;6;2;6;0;4;0;5;;
Mandaguaçu;De 3 a menos de 4 ha;24;81;11;13;37;44;1;23;0;11;1;12;1;10;0;9;;
Mandaguaçu;De 4 a menos de 5 ha;16;75;4;12;19;56;5;11;1;3;4;8;0;3;0;4;;
Mandaguaçu;De 5 a menos de 10 ha;51;379;20;31;155;224;13;38;5;15;8;23;0;14;2;17;;
Mandaguaçu;De 10 a menos de 20 ha;60;844;20;40;266;578;33;27;7;13;26;14;1;12;1;10;;
Mandaguaçu;De 20 a menos de 50 ha;58;1760;9;49;275;1485;41;17;2;7;39;10;0;6;0;6;;
Mandaguaçu;De 50 a menos de 100 ha;26;1949;23;3;0;0;24;2;21;2;3;0;1;1;0;0;;
Mandaguaçu;De 100 a menos de 200 ha;14;1915;14;0;1915;0;11;3;11;3;0;0;1;2;0;0;;
Mandaguaçu;De 200 a menos de 500 ha;14;4293;14;0;4293;0;14;0;14;0;0;0;0;0;0;0;;
Mandaguaçu;De 500 a menos de 1.000 ha;1;0;1;0;0;0;1;0;1;0;0;0;0;0;0;0;;
Mandaguaçu;De 1.000 a menos de 2.500 ha;3;0;3;0;0;0;3;0;3;0;0;0;0;0;0;0;;
Mandaguaçu;De 2.500 a menos de 10.000 ha;1;0;1;0;0;0;1;0;1;0;0;0;0;0;0;0;;
Mandaguaçu;De 10.000 ha e mais;0;0;0;0;0;0;0;0;0;0;0;0;0;0;0;0;;
Mandaguaçu;Produtor sem área;0;0;0;0;0;0;0;0;0;0;0;0;0;0;0;0;;
Mandaguari;Mais de 0 a menos de 0,1 ha;4;0;0;4;0;0;1;3;0;0;1;3;0;0;0;3;;
Mandaguari;De 0,1 a menos de 0,2 ha;7;1;2;5;0;0;3;4;0;2;3;2;1;1;0;2;;
Mandaguari;De 0,2 a menos de 0,5 ha;18;6;4;14;1;5;5;13;1;3;4;10;0;3;0;10;;
Mandaguari;De 0,5 a menos de 1 ha;30;18;8;22;4;14;13;17;1;7;12;10;1;5;2;8;;
Mandaguari;De 1 a menos de 2 ha;23;29;6;17;7;22;8;15;0;6;8;9;0;5;2;6;;
Mandaguari;De 2 a menos de 3 ha;78;185;19;59;47;139;33;45;7;12;26;33;0;8;3;24;;
Mandaguari;De 3 a menos de 4 ha;40;138;9;31;32;106;25;15;4;5;21;10;0;3;0;9;;
Mandaguari;De 4 a menos de 5 ha;64;305;16;48;76;229;42;22;9;7;33;15;0;5;0;11;;
Mandaguari;De 5 a menos de 10 ha;117;874;17;100;139;734;73;44;8;9;65;35;1;7;1;28;;
Mandaguari;De 10 a menos de 20 ha;147;2109;25;122;384;1726;99;48;12;13;87;35;0;11;1;26;;
Mandaguari;De 20 a menos de 50 ha;123;3889;23;100;783;3106;79;44;17;6;62;38;0;6;0;30;;
Mandaguari;De 50 a menos de 100 ha;42;3091;35;7;2711;380;29;13;24;11;5;2;2;8;0;2;;
Mandaguari;De 100 a menos de 200 ha;22;2816;22;0;2816;0;13;9;13;9;0;0;0;6;0;0;;
Mandaguari;De 200 a menos de 500 ha;21;6420;21;0;6420;0;16;5;16;5;0;0;0;3;0;0;;
Mandaguari;De 500 a menos de 1.000 ha;5;3435;5;0;3435;0;3;2;3;2;0;0;0;1;0;0;;
Mandaguari;De 1.000 a menos de 2.500 ha;1;0;1;0;0;0;0;1;0;1;0;0;0;0;0;0;;
Mandaguari;De 2.500 a menos de 10.000 ha;0;0;0;0;0;0;0;0;0;0;0;0;0;0;0;0;;
Mandaguari;De 10.000 ha e mais;0;0;0;0;0;0;0;0;0;0;0;0;0;0;0;0;;
Mandaguari;Produtor sem área;1;0;0;1;0;0;1;0;0;0;1;0;0;0;0;0;;
Mandirituba;Mais de 0 a menos de 0,1 ha;6;0;2;4;0;0;1;5;0;2;1;3;0;1;0;1;;
Mandirituba;De 0,1 a menos de 0,2 ha;6;1;2;4;0;0;1;5;0;2;1;3;0;1;0;2;;
Mandirituba;De 0,2 a menos de 0,5 ha;24;9;3;21;1;8;11;13;1;2;10;11;0;1;1;7;;
Mandirituba;De 0,5 a menos de 1 ha;37;25;13;24;9;16;8;29;2;11;6;18;0;7;0;15;;
Mandirituba;De 1 a menos de 2 ha;88;127;15;73;21;106;37;51;4;11;33;40;1;8;2;21;;
Mandirituba;De 2 a menos de 3 ha;91;220;17;74;40;179;46;45;7;10;39;35;0;8;2;18;;
Mandirituba;De 3 a menos de 4 ha;65;224;9;56;31;193;40;25;5;4;35;21;0;3;2;9;;
Mandirituba;De 4 a menos de 5 ha;79;369;13;66;60;309;53;26;9;4;44;22;1;3;2;10;;
Mandirituba;De 5 a menos de 10 ha;189;1416;24;165;178;1238;117;72;13;11;104;61;0;8;2;40;;
Mandirituba;De 10 a menos de 20 ha;136;1924;17;119;243;1681;101;35;5;12;96;23;0;11;1;18;;
Mandirituba;De 20 a menos de 50 ha;85;2604;27;58;972;1632;58;27;9;18;49;9;2;14;0;7;;
Mandirituba;De 50 a menos de 100 ha;18;1262;18;0;1262;0;12;6;12;6;0;0;1;5;0;0;;
Mandirituba;De 100 a menos de 200 ha;4;587;4;0;587;0;4;0;4;0;0;0;0;0;0;0;;
Mandirituba;De 200 a menos de 500 ha;0;0;0;0;0;0;0;0;0;0;0;0;0;0;0;0;;
Mandirituba;De 500 a menos de 1.000 ha;2;0;2;0;0;0;0;2;0;2;0;0;0;1;0;0;;
Mandirituba;De 1.000 a menos de 2.500 ha;2;0;2;0;0;0;1;1;1;1;0;0;0;1;0;0;;
Mandirituba;De 2.500 a menos de 10.000 ha;1;0;1;0;0;0;0;1;0;1;0;0;0;1;0;0;;
Mandirituba;De 10.000 ha e mais;0;0;0;0;0;0;0;0;0;0;0;0;0;0;0;0;;
Mandirituba;Produtor sem área;3;0;1;2;0;0;0;0;0;0;0;0;0;0;0;0;;
Manfrinópolis;Mais de 0 a menos de 0,1 ha;2;0;1;1;0;0;1;1;1;0;0;1;0;0;0;1;;
Manfrinópolis;De 0,1 a menos de 0,2 ha;2;0;0;2;0;0;1;1;0;0;1;1;0;0;0;0;;
Manfrinópolis;De 0,2 a menos de 0,5 ha;3;1;1;2;0;0;2;1;1;0;1;1;0;0;0;1;;
Manfrinópolis;De 0,5 a menos de 1 ha;6;4;3;3;2;2;3;3;1;2;2;1;0;2;0;1;;
Manfrinópolis;De 1 a menos de 2 ha;17;25;10;7;14;10;9;8;6;4;3;4;0;3;0;4;;
Manfrinópolis;De 2 a menos de 3 ha;18;44;4;14;9;35;9;9;2;2;7;7;0;2;0;6;;
Manfrinópolis;De 3 a menos de 4 ha;23;79;7;16;23;56;10;13;4;3;6;10;0;3;0;9;;
Manfrinópolis;De 4 a menos de 5 ha;23;111;2;21;0;0;15;8;2;0;13;8;0;0;0;7;;
Manfrinópolis;De 5 a menos de 10 ha;133;1026;21;112;160;866;85;48;10;11;75;37;0;10;0;28;;
Manfrinópolis;De 10 a menos de 20 ha;142;2101;18;124;283;1818;98;44;12;6;86;38;0;5;0;25;;
Manfrinópolis;De 20 a menos de 50 ha;125;3617;12;113;328;3288;95;30;6;6;89;24;0;6;0;16;;
Manfrinópolis;De 50 a menos de 100 ha;39;2494;7;32;523;1971;31;8;5;2;26;6;0;2;0;4;;
Manfrinópolis;De 100 a menos de 200 ha;11;1420;11;0;1420;0;9;2;9;2;0;0;0;2;0;0;;
Manfrinópolis;De 200 a menos de 500 ha;11;3369;11;0;3369;0;7;4;7;4;0;0;0;3;0;0;;
Manfrinópolis;De 500 a menos de 1.000 ha;5;2998;5;0;2998;0;5;0;5;0;0;0;0;0;0;0;;
Manfrinópolis;De 1.000 a menos de 2.500 ha;2;0;2;0;0;0;2;0;2;0;0;0;0;0;0;0;;
Manfrinópolis;De 2.500 a menos de 10.000 ha;0;0;0;0;0;0;0;0;0;0;0;0;0;0;0;0;;
Manfrinópolis;De 10.000 ha e mais;0;0;0;0;0;0;0;0;0;0;0;0;0;0;0;0;;
Manfrinópolis;Produtor sem área;0;0;0;0;0;0;0;0;0;0;0;0;0;0;0;0;;
Mangueirinha;Mais de 0 a menos de 0,1 ha;5;0;1;4;0;0;0;5;0;1;0;4;0;1;0;4;;
Mangueirinha;De 0,1 a menos de 0,2 ha;1;0;1;0;0;0;1;0;1;0;0;0;0;0;0;0;;
Mangueirinha;De 0,2 a menos de 0,5 ha;62;28;22;40;10;18;32;30;15;7;17;23;1;3;9;8;;
Mangueirinha;De 0,5 a menos de 1 ha;28;20;10;18;8;12;13;15;6;4;7;11;2;2;3;8;;
Mangueirinha;De 1 a menos de 2 ha;82;106;25;57;32;74;44;38;15;10;29;28;0;7;1;21;;
Mangueirinha;De 2 a menos de 3 ha;127;315;20;107;49;265;89;38;16;4;73;34;0;3;2;27;;
Mangueirinha;De 3 a menos de 4 ha;68;246;11;57;39;206;51;17;11;0;40;17;0;0;2;12;;
Mangueirinha;De 4 a menos de 5 ha;76;364;7;69;33;331;51;25;5;2;46;23;0;1;0;17;;
Mangueirinha;De 5 a menos de 10 ha;173;1344;18;155;134;1210;129;44;14;4;115;40;0;3;2;28;;
Mangueirinha;De 10 a menos de 20 ha;397;5712;31;366;443;5269;351;46;23;8;328;38;0;6;2;26;;
Mangueirinha;De 20 a menos de 50 ha;301;9021;17;284;548;8473;262;39;11;6;251;33;0;5;2;25;;
Mangueirinha;De 50 a menos de 100 ha;86;6027;16;70;1295;4732;76;10;13;3;63;7;0;2;0;7;;
Mangueirinha;De 100 a menos de 200 ha;59;8473;56;3;0;0;51;8;49;7;2;1;1;5;0;1;;
Mangueirinha;De 200 a menos de 500 ha;67;21122;67;0;21122;0;64;3;64;3;0;0;0;3;0;0;;
Mangueirinha;De 500 a menos de 1.000 ha;13;9062;13;0;9062;0;12;1;12;1;0;0;0;1;0;0;;
Mangueirinha;De 1.000 a menos de 2.500 ha;10;15207;10;0;15207;0;8;2;8;2;0;0;0;2;0;0;;
Mangueirinha;De 2.500 a menos de 10.000 ha;0;0;0;0;0;0;0;0;0;0;0;0;0;0;0;0;;
Mangueirinha;De 10.000 ha e mais;0;0;0;0;0;0;0;0;0;0;0;0;0;0;0;0;;
Mangueirinha;Produtor sem área;4;0;2;2;0;0;1;3;1;1;0;2;0;1;0;2;;
Manoel Ribas;Mais de 0 a menos de 0,1 ha;20;1;3;17;0;1;0;20;0;3;0;17;1;2;0;16;;
Manoel Ribas;De 0,1 a menos de 0,2 ha;13;2;3;10;0;1;1;12;0;3;1;9;0;3;0;9;;
Manoel Ribas;De 0,2 a menos de 0,5 ha;26;11;1;25;0;0;9;17;1;0;8;17;0;0;1;10;;
Manoel Ribas;De 0,5 a menos de 1 ha;27;16;2;25;0;0;6;21;0;2;6;19;0;2;0;18;;
Manoel Ribas;De 1 a menos de 2 ha;12;16;3;9;4;12;6;6;2;1;4;5;0;1;1;4;;
Manoel Ribas;De 2 a menos de 3 ha;24;59;4;20;10;49;10;14;0;4;10;10;1;2;4;4;;
Manoel Ribas;De 3 a menos de 4 ha;15;52;0;15;0;52;3;12;0;0;3;12;0;0;3;4;;
Manoel Ribas;De 4 a menos de 5 ha;24;113;0;24;0;113;12;12;0;0;12;12;0;0;1;6;;
Manoel Ribas;De 5 a menos de 10 ha;98;795;2;96;0;0;57;41;1;1;56;40;0;1;5;25;;
Manoel Ribas;De 10 a menos de 20 ha;321;4712;7;314;105;4607;265;56;4;3;261;53;0;2;8;28;;
Manoel Ribas;De 20 a menos de 50 ha;278;8814;2;276;0;0;234;44;2;0;232;44;0;0;6;28;;
Manoel Ribas;De 50 a menos de 100 ha;80;5624;20;60;1805;3819;73;7;20;0;53;7;0;0;1;4;;
Manoel Ribas;De 100 a menos de 200 ha;40;5586;40;0;5586;0;31;9;31;9;0;0;1;8;0;0;;
Manoel Ribas;De 200 a menos de 500 ha;28;8524;28;0;8524;0;26;2;26;2;0;0;0;1;0;0;;
Manoel Ribas;De 500 a menos de 1.000 ha;7;5093;7;0;5093;0;5;2;5;2;0;0;0;2;0;0;;
Manoel Ribas;De 1.000 a menos de 2.500 ha;2;0;2;0;0;0;1;1;1;1;0;0;0;1;0;0;;
Manoel Ribas;De 2.500 a menos de 10.000 ha;1;0;1;0;0;0;1;0;1;0;0;0;0;0;0;0;;
Manoel Ribas;De 10.000 ha e mais;0;0;0;0;0;0;0;0;0;0;0;0;0;0;0;0;;
Manoel Ribas;Produtor sem área;246;0;3;243;0;0;1;0;0;0;1;0;0;0;0;0;;
Marechal Cândido Rondon;Mais de 0 a menos de 0,1 ha;4;0;2;2;0;0;1;3;1;1;0;2;0;0;1;1;;
Marechal Cândido Rondon;De 0,1 a menos de 0,2 ha;6;1;2;4;0;0;0;6;0;2;0;4;0;1;2;2;;
Marechal Cândido Rondon;De 0,2 a menos de 0,5 ha;8;2;2;6;0;0;1;7;0;2;1;5;0;1;0;4;;
Marechal Cândido Rondon;De 0,5 a menos de 1 ha;63;34;17;46;9;25;12;51;4;13;8;38;4;6;7;26;;
Marechal Cândido Rondon;De 1 a menos de 2 ha;39;49;10;29;14;35;14;25;5;5;9;20;1;4;3;15;;
Marechal Cândido Rondon;De 2 a menos de 3 ha;114;273;35;79;85;188;43;71;11;24;32;47;4;18;5;37;;
Marechal Cândido Rondon;De 3 a menos de 4 ha;90;310;23;67;80;230;39;51;5;18;34;33;2;15;0;27;;
Marechal Cândido Rondon;De 4 a menos de 5 ha;79;370;13;66;61;309;42;37;5;8;37;29;0;7;0;27;;
Marechal Cândido Rondon;De 5 a menos de 10 ha;318;2344;40;278;303;2042;222;96;18;22;204;74;1;18;9;42;;
Marechal Cândido Rondon;De 10 a menos de 20 ha;476;6708;44;432;616;6092;413;63;27;17;386;46;2;14;4;28;;
Marechal Cândido Rondon;De 20 a menos de 50 ha;468;14882;39;429;1240;13642;441;27;32;7;409;20;0;4;2;13;;
Marechal Cândido Rondon;De 50 a menos de 100 ha;173;11908;78;95;6437;5471;169;4;77;1;92;3;0;1;0;3;;
Marechal Cândido Rondon;De 100 a menos de 200 ha;68;8823;68;0;8823;0;67;1;67;1;0;0;0;1;0;0;;
Marechal Cândido Rondon;De 200 a menos de 500 ha;18;5509;18;0;5509;0;16;2;16;2;0;0;0;2;0;0;;
Marechal Cândido Rondon;De 500 a menos de 1.000 ha;2;0;2;0;0;0;2;0;2;0;0;0;0;0;0;0;;
Marechal Cândido Rondon;De 1.000 a menos de 2.500 ha;0;0;0;0;0;0;0;0;0;0;0;0;0;0;0;0;;
Marechal Cândido Rondon;De 2.500 a menos de 10.000 ha;0;0;0;0;0;0;0;0;0;0;0;0;0;0;0;0;;
Marechal Cândido Rondon;De 10.000 ha e mais;0;0;0;0;0;0;0;0;0;0;0;0;0;0;0;0;;
Marechal Cândido Rondon;Produtor sem área;8;0;1;7;0;0;0;0;0;0;0;0;0;0;0;0;;
Maria Helena;Mais de 0 a menos de 0,1 ha;20;1;4;16;0;1;1;19;0;4;1;15;0;4;0;15;;
Maria Helena;De 0,1 a menos de 0,2 ha;13;2;0;13;0;2;0;13;0;0;0;13;0;0;0;12;;
Maria Helena;De 0,2 a menos de 0,5 ha;17;6;4;13;1;4;2;15;1;3;1;12;0;2;0;11;;
Maria Helena;De 0,5 a menos de 1 ha;39;20;18;21;9;11;17;22;7;11;10;11;1;7;0;4;;
Maria Helena;De 1 a menos de 2 ha;18;25;8;10;10;15;3;15;2;6;1;9;2;4;0;3;;
Maria Helena;De 2 a menos de 3 ha;41;98;10;31;24;74;4;37;3;7;1;30;0;5;0;20;;
Maria Helena;De 3 a menos de 4 ha;15;53;4;11;15;38;4;11;0;4;4;7;0;3;0;7;;
Maria Helena;De 4 a menos de 5 ha;44;210;9;35;43;167;12;32;1;8;11;24;0;7;0;15;;
Maria Helena;De 5 a menos de 10 ha;117;881;23;94;176;705;45;72;8;15;37;57;0;8;0;34;;
Maria Helena;De 10 a menos de 20 ha;118;1696;14;104;202;1495;39;79;6;8;33;71;0;7;1;46;;
Maria Helena;De 20 a menos de 50 ha;157;4912;17;140;544;4368;56;101;8;9;48;92;0;5;0;52;;
Maria Helena;De 50 a menos de 100 ha;70;4938;21;49;1749;3190;28;42;6;15;22;27;0;8;0;13;;
Maria Helena;De 100 a menos de 200 ha;44;6460;44;0;6460;0;24;20;24;20;0;0;0;9;0;0;;
Maria Helena;De 200 a menos de 500 ha;36;10606;36;0;10606;0;12;24;12;24;0;0;0;6;0;0;;
Maria Helena;De 500 a menos de 1.000 ha;10;7124;10;0;7124;0;5;5;5;5;0;0;0;4;0;0;;
Maria Helena;De 1.000 a menos de 2.500 ha;2;0;2;0;0;0;2;0;2;0;0;0;0;0;0;0;;
Maria Helena;De 2.500 a menos de 10.000 ha;1;0;1;0;0;0;1;0;1;0;0;0;0;0;0;0;;
Maria Helena;De 10.000 ha e mais;0;0;0;0;0;0;0;0;0;0;0;0;0;0;0;0;;
Maria Helena;Produtor sem área;1;0;1;0;0;0;0;0;0;0;0;0;0;0;0;0;;
Marialva;Mais de 0 a menos de 0,1 ha;1;0;0;1;0;0;0;1;0;0;0;1;0;0;0;1;;
Marialva;De 0,1 a menos de 0,2 ha;11;1;1;10;0;0;1;10;1;0;0;10;0;0;2;7;;
Marialva;De 0,2 a menos de 0,5 ha;62;21;8;54;3;18;34;28;5;3;29;25;2;1;7;14;;
Marialva;De 0,5 a menos de 1 ha;180;118;7;173;5;113;141;39;5;2;136;37;0;0;6;17;;
Marialva;De 1 a menos de 2 ha;186;238;11;175;16;221;148;38;10;1;138;37;0;0;3;24;;
Marialva;De 2 a menos de 3 ha;162;369;16;146;36;332;105;57;10;6;95;51;1;2;1;40;;
Marialva;De 3 a menos de 4 ha;65;225;9;56;31;194;48;17;9;0;39;17;0;0;1;10;;
Marialva;De 4 a menos de 5 ha;51;241;4;47;18;223;38;13;4;0;34;13;0;0;1;9;;
Marialva;De 5 a menos de 10 ha;105;786;16;89;118;668;88;17;14;2;74;15;0;1;2;9;;
Marialva;De 10 a menos de 20 ha;182;2580;13;169;168;2412;162;20;12;1;150;19;0;1;0;13;;
Marialva;De 20 a menos de 50 ha;180;5744;15;165;526;5218;163;17;12;3;151;14;1;0;0;9;;
Marialva;De 50 a menos de 100 ha;82;5959;69;13;5271;688;72;10;59;10;13;0;1;5;0;0;;
Marialva;De 100 a menos de 200 ha;50;7295;50;0;7295;0;46;4;46;4;0;0;0;1;0;0;;
Marialva;De 200 a menos de 500 ha;29;8336;29;0;8336;0;25;4;25;4;0;0;0;3;0;0;;
Marialva;De 500 a menos de 1.000 ha;4;0;4;0;0;0;3;1;3;1;0;0;0;1;0;0;;
Marialva;De 1.000 a menos de 2.500 ha;1;0;1;0;0;0;1;0;1;0;0;0;0;0;0;0;;
Marialva;De 2.500 a menos de 10.000 ha;0;0;0;0;0;0;0;0;0;0;0;0;0;0;0;0;;
Marialva;De 10.000 ha e mais;0;0;0;0;0;0;0;0;0;0;0;0;0;0;0;0;;
Marialva;Produtor sem área;0;0;0;0;0;0;0;0;0;0;0;0;0;0;0;0;;
Marilândia do Sul;Mais de 0 a menos de 0,1 ha;1;0;0;1;0;0;0;1;0;0;0;1;0;0;0;1;;
Marilândia do Sul;De 0,1 a menos de 0,2 ha;2;0;1;1;0;0;1;1;1;0;0;1;0;0;0;1;;
Marilândia do Sul;De 0,2 a menos de 0,5 ha;6;2;1;5;0;0;3;3;0;1;3;2;0;0;1;1;;
Marilândia do Sul;De 0,5 a menos de 1 ha;18;11;3;15;2;9;11;7;1;2;10;5;0;2;1;2;;
Marilândia do Sul;De 1 a menos de 2 ha;11;14;1;10;0;0;9;2;1;0;8;2;0;0;0;1;;
Marilândia do Sul;De 2 a menos de 3 ha;20;48;7;13;17;31;8;12;1;6;7;6;0;6;2;3;;
Marilândia do Sul;De 3 a menos de 4 ha;20;72;4;16;14;58;12;8;0;4;12;4;0;3;0;4;;
Marilândia do Sul;De 4 a menos de 5 ha;21;100;3;18;14;86;14;7;1;2;13;5;0;2;0;5;;
Marilândia do Sul;De 5 a menos de 10 ha;69;529;8;61;67;463;52;17;4;4;48;13;1;3;0;10;;
Marilândia do Sul;De 10 a menos de 20 ha;74;1064;11;63;180;884;54;20;6;5;48;15;1;4;0;12;;
Marilândia do Sul;De 20 a menos de 50 ha;84;2622;7;77;233;2389;71;13;4;3;67;10;0;3;0;10;;
Marilândia do Sul;De 50 a menos de 100 ha;38;2771;19;19;1677;1094;34;4;17;2;17;2;0;2;0;2;;
Marilândia do Sul;De 100 a menos de 200 ha;29;3976;29;0;3976;0;28;1;28;1;0;0;0;0;0;0;;
Marilândia do Sul;De 200 a menos de 500 ha;27;8871;27;0;8871;0;24;3;24;3;0;0;0;2;0;0;;
Marilândia do Sul;De 500 a menos de 1.000 ha;9;5885;9;0;5885;0;8;1;8;1;0;0;0;1;0;0;;
Marilândia do Sul;De 1.000 a menos de 2.500 ha;6;8201;6;0;8201;0;6;0;6;0;0;0;0;0;0;0;;
Marilândia do Sul;De 2.500 a menos de 10.000 ha;0;0;0;0;0;0;0;0;0;0;0;0;0;0;0;0;;
Marilândia do Sul;De 10.000 ha e mais;0;0;0;0;0;0;0;0;0;0;0;0;0;0;0;0;;
Marilândia do Sul;Produtor sem área;0;0;0;0;0;0;0;0;0;0;0;0;0;0;0;0;;
Marilena;Mais de 0 a menos de 0,1 ha;0;0;0;0;0;0;0;0;0;0;0;0;0;0;0;0;;
Marilena;De 0,1 a menos de 0,2 ha;0;0;0;0;0;0;0;0;0;0;0;0;0;0;0;0;;
Marilena;De 0,2 a menos de 0,5 ha;0;0;0;0;0;0;0;0;0;0;0;0;0;0;0;0;;
Marilena;De 0,5 a menos de 1 ha;34;17;7;27;4;14;2;32;1;6;1;26;0;4;0;14;;
Marilena;De 1 a menos de 2 ha;18;23;8;10;0;0;1;17;0;8;1;9;0;3;0;3;;
Marilena;De 2 a menos de 3 ha;47;115;18;29;44;71;10;37;2;16;8;21;0;10;0;14;;
Marilena;De 3 a menos de 4 ha;17;60;5;12;18;43;1;16;1;4;0;12;0;1;0;6;;
Marilena;De 4 a menos de 5 ha;32;151;10;22;46;106;5;27;0;10;5;17;0;9;0;13;;
Marilena;De 5 a menos de 10 ha;70;521;22;48;155;366;19;51;4;18;15;33;0;13;0;22;;
Marilena;De 10 a menos de 20 ha;128;2060;17;111;247;1813;55;73;6;11;49;62;0;6;0;27;;
Marilena;De 20 a menos de 50 ha;87;2629;14;73;461;2168;32;55;5;9;27;46;0;6;0;25;;
Marilena;De 50 a menos de 100 ha;24;1668;3;21;0;0;7;17;2;1;5;16;0;0;0;8;;
Marilena;De 100 a menos de 200 ha;18;2577;18;0;2577;0;8;10;8;10;0;0;0;7;0;0;;
Marilena;De 200 a menos de 500 ha;9;2924;9;0;2924;0;5;4;5;4;0;0;0;2;0;0;;
Marilena;De 500 a menos de 1.000 ha;4;0;4;0;0;0;3;1;3;1;0;0;0;1;0;0;;
Marilena;De 1.000 a menos de 2.500 ha;0;0;0;0;0;0;0;0;0;0;0;0;0;0;0;0;;
Marilena;De 2.500 a menos de 10.000 ha;1;0;1;0;0;0;1;0;1;0;0;0;0;0;0;0;;
Marilena;De 10.000 ha e mais;0;0;0;0;0;0;0;0;0;0;0;0;0;0;0;0;;
Marilena;Produtor sem área;0;0;0;0;0;0;0;0;0;0;0;0;0;0;0;0;;
Mariluz;Mais de 0 a menos de 0,1 ha;4;0;0;4;0;0;0;4;0;0;0;4;0;0;1;3;;
Mariluz;De 0,1 a menos de 0,2 ha;1;0;0;1;0;0;0;1;0;0;0;1;0;0;0;0;;
Mariluz;De 0,2 a menos de 0,5 ha;5;2;0;5;0;2;1;4;0;0;1;4;0;0;0;3;;
Mariluz;De 0,5 a menos de 1 ha;5;4;1;4;0;0;0;5;0;1;0;4;0;1;0;4;;
Mariluz;De 1 a menos de 2 ha;7;10;0;7;0;10;0;7;0;0;0;7;0;0;0;5;;
Mariluz;De 2 a menos de 3 ha;7;17;0;7;0;17;1;6;0;0;1;6;0;0;1;5;;
Mariluz;De 3 a menos de 4 ha;7;25;1;6;0;0;1;6;0;1;1;5;0;0;1;2;;
Mariluz;De 4 a menos de 5 ha;15;72;1;14;0;0;4;11;0;1;4;10;0;1;0;6;;
Mariluz;De 5 a menos de 10 ha;31;240;1;30;0;0;3;28;0;1;3;27;0;0;2;18;;
Mariluz;De 10 a menos de 20 ha;274;4585;3;271;41;4543;198;76;2;1;196;75;0;0;19;25;;
Mariluz;De 20 a menos de 50 ha;45;1471;4;41;158;1313;23;22;3;1;20;21;0;1;3;12;;
Mariluz;De 50 a menos de 100 ha;23;1638;9;14;753;885;12;11;4;5;8;6;2;1;0;5;;
Mariluz;De 100 a menos de 200 ha;14;2026;14;0;2026;0;10;4;10;4;0;0;0;1;0;0;;
Mariluz;De 200 a menos de 500 ha;9;3087;9;0;3087;0;8;1;8;1;0;0;0;0;0;0;;
Mariluz;De 500 a menos de 1.000 ha;6;4188;6;0;4188;0;6;0;6;0;0;0;0;0;0;0;;
Mariluz;De 1.000 a menos de 2.500 ha;2;0;2;0;0;0;2;0;2;0;0;0;0;0;0;0;;
Mariluz;De 2.500 a menos de 10.000 ha;3;13342;3;0;13342;0;3;0;3;0;0;0;0;0;0;0;;
Mariluz;De 10.000 ha e mais;0;0;0;0;0;0;0;0;0;0;0;0;0;0;0;0;;
Mariluz;Produtor sem área;0;0;0;0;0;0;0;0;0;0;0;0;0;0;0;0;;
Maringá;Mais de 0 a menos de 0,1 ha;1;0;0;1;0;0;0;1;0;0;0;1;0;0;0;1;;
Maringá;De 0,1 a menos de 0,2 ha;5;1;4;1;0;0;0;5;0;4;0;1;0;4;0;0;;
Maringá;De 0,2 a menos de 0,5 ha;25;7;13;12;4;3;3;22;1;12;2;10;1;10;1;7;;
Maringá;De 0,5 a menos de 1 ha;35;21;13;22;8;13;5;30;1;12;4;18;0;10;2;9;;
Maringá;De 1 a menos de 2 ha;53;68;18;35;23;44;11;42;4;14;7;28;2;7;4;16;;
Maringá;De 2 a menos de 3 ha;80;191;23;57;54;137;24;56;6;17;18;39;0;14;4;30;;
Maringá;De 3 a menos de 4 ha;42;145;12;30;42;103;17;25;2;10;15;15;0;9;4;10;;
Maringá;De 4 a menos de 5 ha;43;200;16;27;75;125;29;14;11;5;18;9;0;5;2;4;;
Maringá;De 5 a menos de 10 ha;82;611;23;59;166;445;36;46;7;16;29;30;2;13;0;24;;
Maringá;De 10 a menos de 20 ha;78;1118;18;60;240;879;60;18;8;10;52;8;1;6;1;3;;
Maringá;De 20 a menos de 50 ha;75;2503;7;68;220;2282;68;7;5;2;63;5;0;2;0;4;;
Maringá;De 50 a menos de 100 ha;55;3809;47;8;0;0;54;1;47;0;7;1;0;0;0;1;;
Maringá;De 100 a menos de 200 ha;42;6358;42;0;6358;0;40;2;40;2;0;0;0;0;0;0;;
Maringá;De 200 a menos de 500 ha;34;10695;34;0;10695;0;34;0;34;0;0;0;0;0;0;0;;
Maringá;De 500 a menos de 1.000 ha;3;0;3;0;0;0;3;0;3;0;0;0;0;0;0;0;;
Maringá;De 1.000 a menos de 2.500 ha;1;0;1;0;0;0;1;0;1;0;0;0;0;0;0;0;;
Maringá;De 2.500 a menos de 10.000 ha;0;0;0;0;0;0;0;0;0;0;0;0;0;0;0;0;;
Maringá;De 10.000 ha e mais;0;0;0;0;0;0;0;0;0;0;0;0;0;0;0;0;;
Maringá;Produtor sem área;0;0;0;0;0;0;0;0;0;0;0;0;0;0;0;0;;
Mariópolis;Mais de 0 a menos de 0,1 ha;0;0;0;0;0;0;0;0;0;0;0;0;0;0;0;0;;
Mariópolis;De 0,1 a menos de 0,2 ha;1;0;0;1;0;0;0;1;0;0;0;1;0;0;0;1;;
Mariópolis;De 0,2 a menos de 0,5 ha;2;0;0;2;0;0;2;0;0;0;2;0;0;0;0;0;;
Mariópolis;De 0,5 a menos de 1 ha;4;2;2;2;0;0;2;2;1;1;1;1;1;0;0;1;;
Mariópolis;De 1 a menos de 2 ha;4;6;0;4;0;6;2;2;0;0;2;2;0;0;0;1;;
Mariópolis;De 2 a menos de 3 ha;20;48;4;16;0;0;11;9;1;3;10;6;0;2;0;6;;
Mariópolis;De 3 a menos de 4 ha;15;53;2;13;0;0;14;1;2;0;12;1;0;0;0;0;;
Mariópolis;De 4 a menos de 5 ha;31;150;4;27;19;131;31;0;4;0;27;0;0;0;0;0;;
Mariópolis;De 5 a menos de 10 ha;57;437;10;47;78;359;52;5;9;1;43;4;0;1;0;4;;
Mariópolis;De 10 a menos de 20 ha;142;2089;5;137;78;2011;135;7;4;1;131;6;0;1;0;3;;
Mariópolis;De 20 a menos de 50 ha;131;4100;6;125;178;3922;126;5;4;2;122;3;0;2;0;3;;
Mariópolis;De 50 a menos de 100 ha;51;3787;24;27;2090;1697;49;2;22;2;27;0;0;2;0;0;;
Mariópolis;De 100 a menos de 200 ha;33;4314;33;0;4314;0;31;2;31;2;0;0;0;0;0;0;;
Mariópolis;De 200 a menos de 500 ha;10;2542;10;0;2542;0;10;0;10;0;0;0;0;0;0;0;;
Mariópolis;De 500 a menos de 1.000 ha;2;0;2;0;0;0;2;0;2;0;0;0;0;0;0;0;;
Mariópolis;De 1.000 a menos de 2.500 ha;1;0;1;0;0;0;1;0;1;0;0;0;0;0;0;0;;
Mariópolis;De 2.500 a menos de 10.000 ha;0;0;0;0;0;0;0;0;0;0;0;0;0;0;0;0;;
Mariópolis;De 10.000 ha e mais;0;0;0;0;0;0;0;0;0;0;0;0;0;0;0;0;;
Mariópolis;Produtor sem área;0;0;0;0;0;0;0;0;0;0;0;0;0;0;0;0;;
Maripá;Mais de 0 a menos de 0,1 ha;0;0;0;0;0;0;0;0;0;0;0;0;0;0;0;0;;
Maripá;De 0,1 a menos de 0,2 ha;0;0;0;0;0;0;0;0;0;0;0;0;0;0;0;0;;
Maripá;De 0,2 a menos de 0,5 ha;2;0;1;1;0;0;1;1;0;1;1;0;0;1;0;0;;
Maripá;De 0,5 a menos de 1 ha;2;0;0;2;0;0;0;2;0;0;0;2;0;0;0;2;;
Maripá;De 1 a menos de 2 ha;15;20;8;7;11;9;3;12;2;6;1;6;0;6;2;4;;
Maripá;De 2 a menos de 3 ha;35;89;8;27;20;69;17;18;2;6;15;12;0;4;0;9;;
Maripá;De 3 a menos de 4 ha;24;85;5;19;18;68;15;9;1;4;14;5;0;4;2;3;;
Maripá;De 4 a menos de 5 ha;41;194;3;38;14;180;19;22;0;3;19;19;1;1;0;18;;
Maripá;De 5 a menos de 10 ha;82;638;15;67;122;516;66;16;11;4;55;12;1;3;2;10;;
Maripá;De 10 a menos de 20 ha;147;2106;20;127;294;1812;139;8;15;5;124;3;0;3;0;3;;
Maripá;De 20 a menos de 50 ha;196;6103;11;185;350;5753;194;2;10;1;184;1;0;0;0;1;;
Maripá;De 50 a menos de 100 ha;70;4747;29;41;2347;2400;70;0;29;0;41;0;0;0;0;0;;
Maripá;De 100 a menos de 200 ha;33;4798;33;0;4798;0;33;0;33;0;0;0;0;0;0;0;;
Maripá;De 200 a menos de 500 ha;14;3700;14;0;3700;0;14;0;14;0;0;0;0;0;0;0;;
Maripá;De 500 a menos de 1.000 ha;2;0;2;0;0;0;2;0;2;0;0;0;0;0;0;0;;
Maripá;De 1.000 a menos de 2.500 ha;1;0;1;0;0;0;1;0;1;0;0;0;0;0;0;0;;
Maripá;De 2.500 a menos de 10.000 ha;0;0;0;0;0;0;0;0;0;0;0;0;0;0;0;0;;
Maripá;De 10.000 ha e mais;0;0;0;0;0;0;0;0;0;0;0;0;0;0;0;0;;
Maripá;Produtor sem área;1;0;1;0;0;0;0;0;0;0;0;0;0;0;0;0;;
Marmeleiro;Mais de 0 a menos de 0,1 ha;0;0;0;0;0;0;0;0;0;0;0;0;0;0;0;0;;
Marmeleiro;De 0,1 a menos de 0,2 ha;0;0;0;0;0;0;0;0;0;0;0;0;0;0;0;0;;
Marmeleiro;De 0,2 a menos de 0,5 ha;2;0;0;2;0;0;1;1;0;0;1;1;0;0;0;1;;
Marmeleiro;De 0,5 a menos de 1 ha;11;7;2;9;0;0;3;8;1;1;2;7;0;1;0;5;;
Marmeleiro;De 1 a menos de 2 ha;14;19;3;11;4;15;6;8;0;3;6;5;0;2;0;5;;
Marmeleiro;De 2 a menos de 3 ha;26;62;6;20;14;48;14;12;2;4;12;8;0;4;0;6;;
Marmeleiro;De 3 a menos de 4 ha;43;150;11;32;39;111;28;15;7;4;21;11;0;4;0;9;;
Marmeleiro;De 4 a menos de 5 ha;57;265;10;47;46;219;30;27;5;5;25;22;0;5;0;16;;
Marmeleiro;De 5 a menos de 10 ha;255;1924;30;225;212;1712;190;65;21;9;169;56;0;7;0;33;;
Marmeleiro;De 10 a menos de 20 ha;359;5026;23;336;317;4709;303;56;15;8;288;48;0;5;0;30;;
Marmeleiro;De 20 a menos de 50 ha;249;7283;10;239;269;7014;237;12;7;3;230;9;0;3;0;6;;
Marmeleiro;De 50 a menos de 100 ha;75;5006;22;53;1756;3250;66;9;16;6;50;3;0;5;0;3;;
Marmeleiro;De 100 a menos de 200 ha;40;5446;40;0;5446;0;40;0;40;0;0;0;0;0;0;0;;
Marmeleiro;De 200 a menos de 500 ha;15;4367;15;0;4367;0;14;1;14;1;0;0;0;1;0;0;;
Marmeleiro;De 500 a menos de 1.000 ha;3;0;3;0;0;0;2;1;2;1;0;0;0;1;0;0;;
Marmeleiro;De 1.000 a menos de 2.500 ha;0;0;0;0;0;0;0;0;0;0;0;0;0;0;0;0;;
Marmeleiro;De 2.500 a menos de 10.000 ha;0;0;0;0;0;0;0;0;0;0;0;0;0;0;0;0;;
Marmeleiro;De 10.000 ha e mais;0;0;0;0;0;0;0;0;0;0;0;0;0;0;0;0;;
Marmeleiro;Produtor sem área;0;0;0;0;0;0;0;0;0;0;0;0;0;0;0;0;;
Marquinho;Mais de 0 a menos de 0,1 ha;3;0;0;3;0;0;1;2;0;0;1;2;0;0;0;2;;
Marquinho;De 0,1 a menos de 0,2 ha;6;1;4;2;0;0;0;6;0;4;0;2;0;4;0;2;;
Marquinho;De 0,2 a menos de 0,5 ha;10;3;1;9;0;0;3;7;1;0;2;7;0;0;0;6;;
Marquinho;De 0,5 a menos de 1 ha;18;14;10;8;8;6;8;10;6;4;2;6;0;4;0;4;;
Marquinho;De 1 a menos de 2 ha;22;32;9;13;12;19;15;7;5;4;10;3;0;1;0;2;;
Marquinho;De 2 a menos de 3 ha;45;114;12;33;30;84;25;20;6;6;19;14;0;4;0;12;;
Marquinho;De 3 a menos de 4 ha;37;131;6;31;21;110;24;13;1;5;23;8;0;4;0;6;;
Marquinho;De 4 a menos de 5 ha;43;206;11;32;52;154;26;17;5;6;21;11;0;5;0;9;;
Marquinho;De 5 a menos de 10 ha;160;1246;12;148;86;1161;107;53;6;6;101;47;1;3;1;29;;
Marquinho;De 10 a menos de 20 ha;185;2729;17;168;253;2476;140;45;12;5;128;40;0;4;0;31;;
Marquinho;De 20 a menos de 50 ha;214;6336;11;203;307;6029;160;54;5;6;155;48;0;5;0;36;;
Marquinho;De 50 a menos de 100 ha;83;5951;39;44;3300;2651;58;25;26;13;32;12;0;11;0;8;;
Marquinho;De 100 a menos de 200 ha;63;9131;63;0;9131;0;46;17;46;17;0;0;0;10;0;0;;
Marquinho;De 200 a menos de 500 ha;23;7354;23;0;7354;0;15;8;15;8;0;0;0;6;0;0;;
Marquinho;De 500 a menos de 1.000 ha;12;8842;12;0;8842;0;10;2;10;2;0;0;0;1;0;0;;
Marquinho;De 1.000 a menos de 2.500 ha;5;7243;5;0;7243;0;4;1;4;1;0;0;0;1;0;0;;
Marquinho;De 2.500 a menos de 10.000 ha;0;0;0;0;0;0;0;0;0;0;0;0;0;0;0;0;;
Marquinho;De 10.000 ha e mais;0;0;0;0;0;0;0;0;0;0;0;0;0;0;0;0;;
Marquinho;Produtor sem área;1;0;1;0;0;0;0;0;0;0;0;0;0;0;0;0;;
Marumbi;Mais de 0 a menos de 0,1 ha;0;0;0;0;0;0;0;0;0;0;0;0;0;0;0;0;;
Marumbi;De 0,1 a menos de 0,2 ha;0;0;0;0;0;0;0;0;0;0;0;0;0;0;0;0;;
Marumbi;De 0,2 a menos de 0,5 ha;8;2;5;3;0;0;2;6;1;4;1;2;0;4;0;2;;
Marumbi;De 0,5 a menos de 1 ha;160;84;92;68;48;36;40;120;32;60;8;60;1;37;0;37;;
Marumbi;De 1 a menos de 2 ha;8;9;5;3;0;0;1;7;1;4;0;3;0;4;0;2;;
Marumbi;De 2 a menos de 3 ha;6;14;4;2;0;0;1;5;1;3;0;2;0;2;0;1;;
Marumbi;De 3 a menos de 4 ha;19;66;7;12;24;42;16;3;6;1;10;2;0;1;0;2;;
Marumbi;De 4 a menos de 5 ha;10;47;4;6;0;0;5;5;1;3;4;2;0;3;0;2;;
Marumbi;De 5 a menos de 10 ha;29;227;14;15;110;117;21;8;10;4;11;4;0;4;0;2;;
Marumbi;De 10 a menos de 20 ha;45;637;10;35;142;494;33;12;6;4;27;8;0;2;0;4;;
Marumbi;De 20 a menos de 50 ha;29;917;6;23;204;713;20;9;2;4;18;5;0;1;0;3;;
Marumbi;De 50 a menos de 100 ha;25;1859;15;10;1278;581;20;5;13;2;7;3;0;1;0;3;;
Marumbi;De 100 a menos de 200 ha;17;2304;17;0;2304;0;13;4;13;4;0;0;0;3;0;0;;
Marumbi;De 200 a menos de 500 ha;11;3977;11;0;3977;0;10;1;10;1;0;0;0;0;0;0;;
Marumbi;De 500 a menos de 1.000 ha;3;0;3;0;0;0;2;1;2;1;0;0;0;1;0;0;;
Marumbi;De 1.000 a menos de 2.500 ha;1;0;1;0;0;0;1;0;1;0;0;0;0;0;0;0;;
Marumbi;De 2.500 a menos de 10.000 ha;1;0;1;0;0;0;1;0;1;0;0;0;0;0;0;0;;
Marumbi;De 10.000 ha e mais;0;0;0;0;0;0;0;0;0;0;0;0;0;0;0;0;;
Marumbi;Produtor sem área;0;0;0;0;0;0;0;0;0;0;0;0;0;0;0;0;;
Matelândia;Mais de 0 a menos de 0,1 ha;0;0;0;0;0;0;0;0;0;0;0;0;0;0;0;0;;
Matelândia;De 0,1 a menos de 0,2 ha;0;0;0;0;0;0;0;0;0;0;0;0;0;0;0;0;;
Matelândia;De 0,2 a menos de 0,5 ha;15;6;5;10;2;4;2;13;1;4;1;9;0;4;0;9;;
Matelândia;De 0,5 a menos de 1 ha;43;23;12;31;6;17;26;17;6;6;20;11;0;3;0;9;;
Matelândia;De 1 a menos de 2 ha;28;34;8;20;10;24;7;21;2;6;5;15;0;6;0;15;;
Matelândia;De 2 a menos de 3 ha;54;133;21;33;51;82;13;41;2;19;11;22;1;18;0;22;;
Matelândia;De 3 a menos de 4 ha;34;120;8;26;27;93;17;17;4;4;13;13;0;3;0;11;;
Matelândia;De 4 a menos de 5 ha;52;248;14;38;66;181;17;35;2;12;15;23;1;11;0;20;;
Matelândia;De 5 a menos de 10 ha;192;1475;41;151;308;1167;126;66;28;13;98;53;0;13;3;43;;
Matelândia;De 10 a menos de 20 ha;203;2962;16;187;217;2745;145;58;6;10;139;48;0;10;0;40;;
Matelândia;De 20 a menos de 50 ha;206;6359;16;190;532;5827;170;36;7;9;163;27;0;9;1;24;;
Matelândia;De 50 a menos de 100 ha;73;5180;36;37;2979;2201;67;6;34;2;33;4;0;2;0;4;;
Matelândia;De 100 a menos de 200 ha;43;6026;43;0;6026;0;39;4;39;4;0;0;0;3;0;0;;
Matelândia;De 200 a menos de 500 ha;23;7351;23;0;7351;0;21;2;21;2;0;0;0;2;0;0;;
Matelândia;De 500 a menos de 1.000 ha;3;0;3;0;0;0;3;0;3;0;0;0;0;0;0;0;;
Matelândia;De 1.000 a menos de 2.500 ha;2;0;2;0;0;0;2;0;2;0;0;0;0;0;0;0;;
Matelândia;De 2.500 a menos de 10.000 ha;0;0;0;0;0;0;0;0;0;0;0;0;0;0;0;0;;
Matelândia;De 10.000 ha e mais;0;0;0;0;0;0;0;0;0;0;0;0;0;0;0;0;;
Matelândia;Produtor sem área;0;0;0;0;0;0;0;0;0;0;0;0;0;0;0;0;;
Matinhos;Mais de 0 a menos de 0,1 ha;0;0;0;0;0;0;0;0;0;0;0;0;0;0;0;0;;
Matinhos;De 0,1 a menos de 0,2 ha;1;0;0;1;0;0;1;0;0;0;1;0;0;0;0;0;;
Matinhos;De 0,2 a menos de 0,5 ha;1;0;0;1;0;0;0;1;0;0;0;1;0;0;0;1;;
Matinhos;De 0,5 a menos de 1 ha;0;0;0;0;0;0;0;0;0;0;0;0;0;0;0;0;;
Matinhos;De 1 a menos de 2 ha;0;0;0;0;0;0;0;0;0;0;0;0;0;0;0;0;;
Matinhos;De 2 a menos de 3 ha;0;0;0;0;0;0;0;0;0;0;0;0;0;0;0;0;;
Matinhos;De 3 a menos de 4 ha;1;0;1;0;0;0;0;1;0;1;0;0;0;1;0;0;;
Matinhos;De 4 a menos de 5 ha;1;0;1;0;0;0;0;1;0;1;0;0;0;1;0;0;;
Matinhos;De 5 a menos de 10 ha;0;0;0;0;0;0;0;0;0;0;0;0;0;0;0;0;;
Matinhos;De 10 a menos de 20 ha;0;0;0;0;0;0;0;0;0;0;0;0;0;0;0;0;;
Matinhos;De 20 a menos de 50 ha;1;0;1;0;0;0;0;1;0;1;0;0;0;1;0;0;;
Matinhos;De 50 a menos de 100 ha;1;0;1;0;0;0;0;1;0;1;0;0;0;1;0;0;;
Matinhos;De 100 a menos de 200 ha;0;0;0;0;0;0;0;0;0;0;0;0;0;0;0;0;;
Matinhos;De 200 a menos de 500 ha;0;0;0;0;0;0;0;0;0;0;0;0;0;0;0;0;;
Matinhos;De 500 a menos de 1.000 ha;0;0;0;0;0;0;0;0;0;0;0;0;0;0;0;0;;
Matinhos;De 1.000 a menos de 2.500 ha;0;0;0;0;0;0;0;0;0;0;0;0;0;0;0;0;;
Matinhos;De 2.500 a menos de 10.000 ha;0;0;0;0;0;0;0;0;0;0;0;0;0;0;0;0;;
Matinhos;De 10.000 ha e mais;0;0;0;0;0;0;0;0;0;0;0;0;0;0;0;0;;
Matinhos;Produtor sem área;0;0;0;0;0;0;0;0;0;0;0;0;0;0;0;0;;
Mato Rico;Mais de 0 a menos de 0,1 ha;4;0;2;2;0;0;2;2;1;1;1;1;0;0;1;0;;
Mato Rico;De 0,1 a menos de 0,2 ha;0;0;0;0;0;0;0;0;0;0;0;0;0;0;0;0;;
Mato Rico;De 0,2 a menos de 0,5 ha;12;4;3;9;1;3;3;9;1;2;2;7;1;0;1;2;;
Mato Rico;De 0,5 a menos de 1 ha;21;16;2;19;0;0;10;11;2;0;8;11;0;0;1;7;;
Mato Rico;De 1 a menos de 2 ha;26;35;2;24;0;0;16;10;1;1;15;9;1;0;1;6;;
Mato Rico;De 2 a menos de 3 ha;27;67;5;22;12;55;15;12;3;2;12;10;0;2;1;8;;
Mato Rico;De 3 a menos de 4 ha;34;118;6;28;20;98;21;13;4;2;17;11;1;0;1;5;;
Mato Rico;De 4 a menos de 5 ha;40;190;6;34;28;162;28;12;2;4;26;8;1;2;2;3;;
Mato Rico;De 5 a menos de 10 ha;72;555;6;66;47;508;48;24;3;3;45;21;0;3;1;16;;
Mato Rico;De 10 a menos de 20 ha;119;1736;6;113;93;1643;87;32;3;3;84;29;1;1;2;22;;
Mato Rico;De 20 a menos de 50 ha;125;3962;6;119;186;3776;100;25;2;4;98;21;0;4;2;16;;
Mato Rico;De 50 a menos de 100 ha;51;3378;7;44;567;2811;42;9;6;1;36;8;0;0;1;6;;
Mato Rico;De 100 a menos de 200 ha;24;3370;24;0;3370;0;19;5;19;5;0;0;1;2;0;0;;
Mato Rico;De 200 a menos de 500 ha;32;9899;32;0;9899;0;25;7;25;7;0;0;0;7;0;0;;
Mato Rico;De 500 a menos de 1.000 ha;6;3814;6;0;3814;0;5;1;5;1;0;0;0;1;0;0;;
Mato Rico;De 1.000 a menos de 2.500 ha;3;0;3;0;0;0;1;2;1;2;0;0;1;1;0;0;;
Mato Rico;De 2.500 a menos de 10.000 ha;0;0;0;0;0;0;0;0;0;0;0;0;0;0;0;0;;
Mato Rico;De 10.000 ha e mais;0;0;0;0;0;0;0;0;0;0;0;0;0;0;0;0;;
Mato Rico;Produtor sem área;3;0;0;3;0;0;0;0;0;0;0;0;0;0;0;0;;
Mauá da Serra;Mais de 0 a menos de 0,1 ha;1;0;0;1;0;0;0;1;0;0;0;1;0;0;0;1;;
Mauá da Serra;De 0,1 a menos de 0,2 ha;0;0;0;0;0;0;0;0;0;0;0;0;0;0;0;0;;
Mauá da Serra;De 0,2 a menos de 0,5 ha;2;0;0;2;0;0;2;0;0;0;2;0;0;0;0;0;;
Mauá da Serra;De 0,5 a menos de 1 ha;32;17;13;19;7;10;12;20;4;9;8;11;0;5;0;6;;
Mauá da Serra;De 1 a menos de 2 ha;4;5;2;2;0;0;2;2;0;2;2;0;0;2;0;0;;
Mauá da Serra;De 2 a menos de 3 ha;2;0;1;1;0;0;1;1;0;1;1;0;0;1;0;0;;
Mauá da Serra;De 3 a menos de 4 ha;24;82;6;18;21;60;15;9;2;4;13;5;1;2;0;2;;
Mauá da Serra;De 4 a menos de 5 ha;24;110;7;17;31;80;15;9;3;4;12;5;0;1;1;4;;
Mauá da Serra;De 5 a menos de 10 ha;20;136;5;15;33;103;12;8;4;1;8;7;0;1;1;6;;
Mauá da Serra;De 10 a menos de 20 ha;11;152;2;9;0;0;3;8;1;1;2;7;0;1;1;4;;
Mauá da Serra;De 20 a menos de 50 ha;17;537;8;9;263;275;9;8;2;6;7;2;0;5;0;2;;
Mauá da Serra;De 50 a menos de 100 ha;13;856;8;5;555;301;9;4;6;2;3;2;0;2;0;1;;
Mauá da Serra;De 100 a menos de 200 ha;8;1150;8;0;1150;0;6;2;6;2;0;0;0;2;0;0;;
Mauá da Serra;De 200 a menos de 500 ha;10;3754;10;0;3754;0;6;4;6;4;0;0;0;3;0;0;;
Mauá da Serra;De 500 a menos de 1.000 ha;0;0;0;0;0;0;0;0;0;0;0;0;0;0;0;0;;
Mauá da Serra;De 1.000 a menos de 2.500 ha;0;0;0;0;0;0;0;0;0;0;0;0;0;0;0;0;;
Mauá da Serra;De 2.500 a menos de 10.000 ha;0;0;0;0;0;0;0;0;0;0;0;0;0;0;0;0;;
Mauá da Serra;De 10.000 ha e mais;0;0;0;0;0;0;0;0;0;0;0;0;0;0;0;0;;
Mauá da Serra;Produtor sem área;0;0;0;0;0;0;0;0;0;0;0;0;0;0;0;0;;
Medianeira;Mais de 0 a menos de 0,1 ha;2;0;0;2;0;0;0;2;0;0;0;2;0;0;0;2;;
Medianeira;De 0,1 a menos de 0,2 ha;9;1;4;5;0;0;0;9;0;4;0;5;0;4;0;5;;
Medianeira;De 0,2 a menos de 0,5 ha;13;4;7;6;2;2;0;13;0;7;0;6;0;7;1;5;;
Medianeira;De 0,5 a menos de 1 ha;58;33;21;37;12;21;12;46;2;19;10;27;0;19;1;26;;
Medianeira;De 1 a menos de 2 ha;71;96;38;33;52;44;9;62;4;34;5;28;1;29;0;26;;
Medianeira;De 2 a menos de 3 ha;82;195;22;60;51;145;25;57;4;18;21;39;0;17;1;35;;
Medianeira;De 3 a menos de 4 ha;35;120;9;26;30;90;17;18;3;6;14;12;0;6;1;10;;
Medianeira;De 4 a menos de 5 ha;66;308;16;50;73;235;28;38;7;9;21;29;2;7;2;23;;
Medianeira;De 5 a menos de 10 ha;191;1472;38;153;291;1181;116;75;18;20;98;55;2;17;6;44;;
Medianeira;De 10 a menos de 20 ha;250;3599;20;230;274;3324;203;47;15;5;188;42;0;4;8;28;;
Medianeira;De 20 a menos de 50 ha;243;7353;15;228;449;6905;212;31;11;4;201;27;0;4;4;18;;
Medianeira;De 50 a menos de 100 ha;78;5337;33;45;2620;2717;69;9;27;6;42;3;0;6;0;3;;
Medianeira;De 100 a menos de 200 ha;33;4621;33;0;4621;0;31;2;31;2;0;0;2;0;0;0;;
Medianeira;De 200 a menos de 500 ha;18;5394;18;0;5394;0;14;4;14;4;0;0;2;2;0;0;;
Medianeira;De 500 a menos de 1.000 ha;3;0;3;0;0;0;3;0;3;0;0;0;0;0;0;0;;
Medianeira;De 1.000 a menos de 2.500 ha;0;0;0;0;0;0;0;0;0;0;0;0;0;0;0;0;;
Medianeira;De 2.500 a menos de 10.000 ha;0;0;0;0;0;0;0;0;0;0;0;0;0;0;0;0;;
Medianeira;De 10.000 ha e mais;0;0;0;0;0;0;0;0;0;0;0;0;0;0;0;0;;
Medianeira;Produtor sem área;1;0;1;0;0;0;0;0;0;0;0;0;0;0;0;0;;
Mercedes;Mais de 0 a menos de 0,1 ha;43;2;25;18;1;1;4;39;1;24;3;15;5;17;9;6;;
Mercedes;De 0,1 a menos de 0,2 ha;0;0;0;0;0;0;0;0;0;0;0;0;0;0;0;0;;
Mercedes;De 0,2 a menos de 0,5 ha;1;0;1;0;0;0;0;1;0;1;0;0;1;0;0;0;;
Mercedes;De 0,5 a menos de 1 ha;6;4;2;4;0;0;1;5;0;2;1;3;0;1;1;2;;
Mercedes;De 1 a menos de 2 ha;15;19;3;12;0;0;4;11;1;2;3;9;0;1;2;6;;
Mercedes;De 2 a menos de 3 ha;17;42;3;14;8;35;7;10;1;2;6;8;1;1;1;4;;
Mercedes;De 3 a menos de 4 ha;32;114;7;25;25;89;23;9;4;3;19;6;1;0;1;3;;
Mercedes;De 4 a menos de 5 ha;54;258;9;45;43;215;38;16;8;1;30;15;0;0;5;8;;
Mercedes;De 5 a menos de 10 ha;162;1293;17;145;136;1157;142;20;13;4;129;16;0;3;2;10;;
Mercedes;De 10 a menos de 20 ha;172;2444;9;163;124;2320;161;11;6;3;155;8;0;2;0;0;;
Mercedes;De 20 a menos de 50 ha;143;4317;5;138;161;4156;138;5;3;2;135;3;0;2;0;1;;
Mercedes;De 50 a menos de 100 ha;43;2893;18;25;1433;1460;42;1;17;1;25;0;0;1;0;0;;
Mercedes;De 100 a menos de 200 ha;14;1810;14;0;1810;0;14;0;14;0;0;0;0;0;0;0;;
Mercedes;De 200 a menos de 500 ha;3;0;3;0;0;0;3;0;3;0;0;0;0;0;0;0;;
Mercedes;De 500 a menos de 1.000 ha;1;0;1;0;0;0;1;0;1;0;0;0;0;0;0;0;;
Mercedes;De 1.000 a menos de 2.500 ha;0;0;0;0;0;0;0;0;0;0;0;0;0;0;0;0;;
Mercedes;De 2.500 a menos de 10.000 ha;0;0;0;0;0;0;0;0;0;0;0;0;0;0;0;0;;
Mercedes;De 10.000 ha e mais;0;0;0;0;0;0;0;0;0;0;0;0;0;0;0;0;;
Mercedes;Produtor sem área;0;0;0;0;0;0;0;0;0;0;0;0;0;0;0;0;;
Mirador;Mais de 0 a menos de 0,1 ha;0;0;0;0;0;0;0;0;0;0;0;0;0;0;0;0;;
Mirador;De 0,1 a menos de 0,2 ha;0;0;0;0;0;0;0;0;0;0;0;0;0;0;0;0;;
Mirador;De 0,2 a menos de 0,5 ha;2;0;2;0;0;0;1;1;1;1;0;0;0;1;0;0;;
Mirador;De 0,5 a menos de 1 ha;3;2;1;2;0;0;0;3;0;1;0;2;0;1;0;2;;
Mirador;De 1 a menos de 2 ha;3;5;0;3;0;5;0;3;0;0;0;3;0;0;0;3;;
Mirador;De 2 a menos de 3 ha;12;29;6;6;15;14;1;11;0;6;1;5;0;1;0;4;;
Mirador;De 3 a menos de 4 ha;3;11;0;3;0;11;1;2;0;0;1;2;0;0;0;2;;
Mirador;De 4 a menos de 5 ha;12;56;1;11;0;0;0;12;0;1;0;11;0;1;0;7;;
Mirador;De 5 a menos de 10 ha;18;135;6;12;45;91;4;14;0;6;4;8;0;4;0;5;;
Mirador;De 10 a menos de 20 ha;34;537;5;29;74;463;10;24;1;4;9;20;0;0;0;7;;
Mirador;De 20 a menos de 50 ha;38;1140;4;34;133;1007;12;26;1;3;11;23;0;2;0;10;;
Mirador;De 50 a menos de 100 ha;13;882;4;9;281;601;5;8;1;3;4;5;0;1;0;2;;
Mirador;De 100 a menos de 200 ha;16;2424;16;0;2424;0;8;8;8;8;0;0;0;2;0;0;;
Mirador;De 200 a menos de 500 ha;9;2678;9;0;2678;0;7;2;7;2;0;0;0;0;0;0;;
Mirador;De 500 a menos de 1.000 ha;4;2994;4;0;2994;0;4;0;4;0;0;0;0;0;0;0;;
Mirador;De 1.000 a menos de 2.500 ha;4;6841;4;0;6841;0;3;1;3;1;0;0;0;1;0;0;;
Mirador;De 2.500 a menos de 10.000 ha;1;0;1;0;0;0;1;0;1;0;0;0;0;0;0;0;;
Mirador;De 10.000 ha e mais;0;0;0;0;0;0;0;0;0;0;0;0;0;0;0;0;;
Mirador;Produtor sem área;3;0;1;2;0;0;0;0;0;0;0;0;0;0;0;0;;
Miraselva;Mais de 0 a menos de 0,1 ha;2;0;1;1;0;0;0;2;0;1;0;1;0;1;0;1;;
Miraselva;De 0,1 a menos de 0,2 ha;1;0;1;0;0;0;0;1;0;1;0;0;0;0;0;0;;
Miraselva;De 0,2 a menos de 0,5 ha;4;1;2;2;0;0;0;4;0;2;0;2;0;2;0;2;;
Miraselva;De 0,5 a menos de 1 ha;24;13;7;17;4;9;5;19;0;7;5;12;0;4;0;12;;
Miraselva;De 1 a menos de 2 ha;4;5;3;1;0;0;0;4;0;3;0;1;0;3;0;1;;
Miraselva;De 2 a menos de 3 ha;1;0;0;1;0;0;0;1;0;0;0;1;0;0;0;1;;
Miraselva;De 3 a menos de 4 ha;17;56;6;11;20;36;2;15;1;5;1;10;0;5;0;9;;
Miraselva;De 4 a menos de 5 ha;8;36;1;7;0;0;1;7;0;1;1;6;0;1;0;5;;
Miraselva;De 5 a menos de 10 ha;20;161;7;13;58;102;4;16;0;7;4;9;0;6;0;5;;
Miraselva;De 10 a menos de 20 ha;21;300;12;9;178;122;6;15;3;9;3;6;0;7;0;5;;
Miraselva;De 20 a menos de 50 ha;19;554;13;6;359;194;7;12;4;9;3;3;0;6;0;2;;
Miraselva;De 50 a menos de 100 ha;4;281;3;1;0;0;2;2;2;1;0;1;0;1;0;1;;
Miraselva;De 100 a menos de 200 ha;3;344;3;0;344;0;0;3;0;3;0;0;0;2;0;0;;
Miraselva;De 200 a menos de 500 ha;4;1228;4;0;1228;0;3;1;3;1;0;0;0;0;0;0;;
Miraselva;De 500 a menos de 1.000 ha;1;0;1;0;0;0;1;0;1;0;0;0;0;0;0;0;;
Miraselva;De 1.000 a menos de 2.500 ha;1;0;1;0;0;0;1;0;1;0;0;0;0;0;0;0;;
Miraselva;De 2.500 a menos de 10.000 ha;0;0;0;0;0;0;0;0;0;0;0;0;0;0;0;0;;
Miraselva;De 10.000 ha e mais;0;0;0;0;0;0;0;0;0;0;0;0;0;0;0;0;;
Miraselva;Produtor sem área;0;0;0;0;0;0;0;0;0;0;0;0;0;0;0;0;;
Missal;Mais de 0 a menos de 0,1 ha;2;0;1;1;0;0;1;1;1;0;0;1;0;0;0;1;;
Missal;De 0,1 a menos de 0,2 ha;5;0;0;5;0;0;0;5;0;0;0;5;0;0;0;5;;
Missal;De 0,2 a menos de 0,5 ha;7;2;1;6;0;0;0;7;0;1;0;6;0;1;0;6;;
Missal;De 0,5 a menos de 1 ha;38;23;7;31;5;18;9;29;0;7;9;22;0;7;5;17;;
Missal;De 1 a menos de 2 ha;51;61;10;41;13;49;10;41;1;9;9;32;0;9;4;28;;
Missal;De 2 a menos de 3 ha;84;198;18;66;44;154;25;59;3;15;22;44;0;13;5;37;;
Missal;De 3 a menos de 4 ha;76;259;9;67;32;227;27;49;2;7;25;42;0;7;4;37;;
Missal;De 4 a menos de 5 ha;99;456;17;82;79;377;33;66;3;14;30;52;1;11;2;46;;
Missal;De 5 a menos de 10 ha;321;2328;50;271;350;1978;171;150;16;34;155;116;1;32;6;103;;
Missal;De 10 a menos de 20 ha;316;4452;34;282;449;4003;229;87;18;16;211;71;0;15;4;60;;
Missal;De 20 a menos de 50 ha;221;6704;20;201;601;6103;192;29;13;7;179;22;0;7;1;19;;
Missal;De 50 a menos de 100 ha;72;4912;29;43;2369;2543;67;5;26;3;41;2;0;3;0;2;;
Missal;De 100 a menos de 200 ha;29;4016;29;0;4016;0;29;0;29;0;0;0;0;0;0;0;;
Missal;De 200 a menos de 500 ha;8;2300;8;0;2300;0;8;0;8;0;0;0;0;0;0;0;;
Missal;De 500 a menos de 1.000 ha;2;0;2;0;0;0;1;1;1;1;0;0;0;1;0;0;;
Missal;De 1.000 a menos de 2.500 ha;0;0;0;0;0;0;0;0;0;0;0;0;0;0;0;0;;
Missal;De 2.500 a menos de 10.000 ha;0;0;0;0;0;0;0;0;0;0;0;0;0;0;0;0;;
Missal;De 10.000 ha e mais;0;0;0;0;0;0;0;0;0;0;0;0;0;0;0;0;;
Missal;Produtor sem área;0;0;0;0;0;0;0;0;0;0;0;0;0;0;0;0;;
Moreira Sales;Mais de 0 a menos de 0,1 ha;4;0;0;4;0;0;0;4;0;0;0;4;0;0;0;4;;
Moreira Sales;De 0,1 a menos de 0,2 ha;0;0;0;0;0;0;0;0;0;0;0;0;0;0;0;0;;
Moreira Sales;De 0,2 a menos de 0,5 ha;2;0;1;1;0;0;1;1;0;1;1;0;0;1;0;0;;
Moreira Sales;De 0,5 a menos de 1 ha;30;16;16;14;8;8;5;25;2;14;3;11;0;12;0;8;;
Moreira Sales;De 1 a menos de 2 ha;23;28;11;12;14;15;0;23;0;11;0;12;0;11;0;12;;
Moreira Sales;De 2 a menos de 3 ha;46;113;17;29;42;71;2;44;0;17;2;27;0;12;0;22;;
Moreira Sales;De 3 a menos de 4 ha;42;147;9;33;31;116;2;40;0;9;2;31;0;6;0;19;;
Moreira Sales;De 4 a menos de 5 ha;67;320;24;43;115;205;9;58;2;22;7;36;0;19;1;25;;
Moreira Sales;De 5 a menos de 10 ha;181;1391;32;149;235;1155;29;152;2;30;27;122;0;19;1;72;;
Moreira Sales;De 10 a menos de 20 ha;143;2025;22;121;321;1705;43;100;2;20;41;80;0;16;0;44;;
Moreira Sales;De 20 a menos de 50 ha;125;3787;19;106;537;3250;56;69;6;13;50;56;0;11;1;23;;
Moreira Sales;De 50 a menos de 100 ha;26;1791;6;20;518;1273;17;9;2;4;15;5;0;4;0;3;;
Moreira Sales;De 100 a menos de 200 ha;18;2441;18;0;2441;0;12;6;12;6;0;0;0;3;0;0;;
Moreira Sales;De 200 a menos de 500 ha;12;3494;12;0;3494;0;7;5;7;5;0;0;0;1;0;0;;
Moreira Sales;De 500 a menos de 1.000 ha;2;0;2;0;0;0;2;0;2;0;0;0;0;0;0;0;;
Moreira Sales;De 1.000 a menos de 2.500 ha;2;0;2;0;0;0;1;1;1;1;0;0;0;0;0;0;;
Moreira Sales;De 2.500 a menos de 10.000 ha;1;0;1;0;0;0;1;0;1;0;0;0;0;0;0;0;;
Moreira Sales;De 10.000 ha e mais;0;0;0;0;0;0;0;0;0;0;0;0;0;0;0;0;;
Moreira Sales;Produtor sem área;0;0;0;0;0;0;0;0;0;0;0;0;0;0;0;0;;
Morretes;Mais de 0 a menos de 0,1 ha;5;0;1;4;0;0;0;5;0;1;0;4;0;1;0;3;;
Morretes;De 0,1 a menos de 0,2 ha;4;0;1;3;0;0;0;4;0;1;0;3;0;1;0;3;;
Morretes;De 0,2 a menos de 0,5 ha;3;0;0;3;0;0;0;3;0;0;0;3;0;0;0;1;;
Morretes;De 0,5 a menos de 1 ha;11;7;4;7;3;5;3;8;1;3;2;5;0;3;0;3;;
Morretes;De 1 a menos de 2 ha;51;61;11;40;12;49;0;51;0;11;0;40;0;10;0;30;;
Morretes;De 2 a menos de 3 ha;68;160;14;54;33;126;10;58;3;11;7;47;0;10;0;35;;
Morretes;De 3 a menos de 4 ha;18;64;4;14;14;50;10;8;1;3;9;5;0;3;0;1;;
Morretes;De 4 a menos de 5 ha;67;319;15;52;72;247;22;45;2;13;20;32;0;10;0;22;;
Morretes;De 5 a menos de 10 ha;115;870;28;87;213;656;55;60;11;17;44;43;1;12;1;30;;
Morretes;De 10 a menos de 20 ha;91;1308;20;71;308;1000;54;37;14;6;40;31;0;3;1;23;;
Morretes;De 20 a menos de 50 ha;54;1525;16;38;466;1059;28;26;10;6;18;20;1;5;1;11;;
Morretes;De 50 a menos de 100 ha;11;770;9;2;0;0;3;8;3;6;0;2;0;5;0;2;;
Morretes;De 100 a menos de 200 ha;15;2406;15;0;2406;0;6;9;6;9;0;0;0;5;0;0;;
Morretes;De 200 a menos de 500 ha;10;2692;10;0;2692;0;3;7;3;7;0;0;1;6;0;0;;
Morretes;De 500 a menos de 1.000 ha;3;0;3;0;0;0;0;3;0;3;0;0;0;1;0;0;;
Morretes;De 1.000 a menos de 2.500 ha;0;0;0;0;0;0;0;0;0;0;0;0;0;0;0;0;;
Morretes;De 2.500 a menos de 10.000 ha;0;0;0;0;0;0;0;0;0;0;0;0;0;0;0;0;;
Morretes;De 10.000 ha e mais;0;0;0;0;0;0;0;0;0;0;0;0;0;0;0;0;;
Morretes;Produtor sem área;1;0;0;1;0;0;0;1;0;0;0;1;0;0;0;1;;
Munhoz de Melo;Mais de 0 a menos de 0,1 ha;0;0;0;0;0;0;0;0;0;0;0;0;0;0;0;0;;
Munhoz de Melo;De 0,1 a menos de 0,2 ha;0;0;0;0;0;0;0;0;0;0;0;0;0;0;0;0;;
Munhoz de Melo;De 0,2 a menos de 0,5 ha;0;0;0;0;0;0;0;0;0;0;0;0;0;0;0;0;;
Munhoz de Melo;De 0,5 a menos de 1 ha;24;15;2;22;0;0;11;13;0;2;11;11;0;1;0;6;;
Munhoz de Melo;De 1 a menos de 2 ha;4;5;1;3;0;0;2;2;1;0;1;2;0;0;0;2;;
Munhoz de Melo;De 2 a menos de 3 ha;16;39;3;13;7;31;6;10;1;2;5;8;0;2;0;4;;
Munhoz de Melo;De 3 a menos de 4 ha;24;86;2;22;0;0;10;14;1;1;9;13;0;1;2;9;;
Munhoz de Melo;De 4 a menos de 5 ha;31;149;5;26;24;125;14;17;3;2;11;15;0;1;0;7;;
Munhoz de Melo;De 5 a menos de 10 ha;59;467;8;51;67;401;28;31;5;3;23;28;0;3;0;16;;
Munhoz de Melo;De 10 a menos de 20 ha;71;982;13;58;181;801;28;43;6;7;22;36;0;7;2;23;;
Munhoz de Melo;De 20 a menos de 50 ha;36;1168;8;28;210;958;22;14;2;6;20;8;0;4;0;2;;
Munhoz de Melo;De 50 a menos de 100 ha;16;1127;13;3;968;159;14;2;12;1;2;1;0;0;0;1;;
Munhoz de Melo;De 100 a menos de 200 ha;8;1021;8;0;1021;0;5;3;5;3;0;0;0;1;0;0;;
Munhoz de Melo;De 200 a menos de 500 ha;9;2771;9;0;2771;0;9;0;9;0;0;0;0;0;0;0;;
Munhoz de Melo;De 500 a menos de 1.000 ha;2;0;2;0;0;0;2;0;2;0;0;0;0;0;0;0;;
Munhoz de Melo;De 1.000 a menos de 2.500 ha;0;0;0;0;0;0;0;0;0;0;0;0;0;0;0;0;;
Munhoz de Melo;De 2.500 a menos de 10.000 ha;1;0;1;0;0;0;1;0;1;0;0;0;0;0;0;0;;
Munhoz de Melo;De 10.000 ha e mais;0;0;0;0;0;0;0;0;0;0;0;0;0;0;0;0;;
Munhoz de Melo;Produtor sem área;0;0;0;0;0;0;0;0;0;0;0;0;0;0;0;0;;
Nossa Senhora das Graças;Mais de 0 a menos de 0,1 ha;0;0;0;0;0;0;0;0;0;0;0;0;0;0;0;0;;
Nossa Senhora das Graças;De 0,1 a menos de 0,2 ha;0;0;0;0;0;0;0;0;0;0;0;0;0;0;0;0;;
Nossa Senhora das Graças;De 0,2 a menos de 0,5 ha;0;0;0;0;0;0;0;0;0;0;0;0;0;0;0;0;;
Nossa Senhora das Graças;De 0,5 a menos de 1 ha;17;9;7;10;4;5;1;16;1;6;0;10;0;6;0;8;;
Nossa Senhora das Graças;De 1 a menos de 2 ha;5;6;0;5;0;6;0;5;0;0;0;5;0;0;0;4;;
Nossa Senhora das Graças;De 2 a menos de 3 ha;9;22;5;4;0;0;1;8;0;5;1;3;0;1;0;1;;
Nossa Senhora das Graças;De 3 a menos de 4 ha;15;52;3;12;10;42;0;15;0;3;0;12;1;1;1;10;;
Nossa Senhora das Graças;De 4 a menos de 5 ha;11;51;3;8;14;38;0;11;0;3;0;8;0;1;1;4;;
Nossa Senhora das Graças;De 5 a menos de 10 ha;33;258;8;25;64;194;5;28;1;7;4;21;0;5;2;12;;
Nossa Senhora das Graças;De 10 a menos de 20 ha;41;585;10;31;140;445;1;40;0;10;1;30;0;6;1;16;;
Nossa Senhora das Graças;De 20 a menos de 50 ha;30;974;9;21;275;698;6;24;2;7;4;17;2;1;0;3;;
Nossa Senhora das Graças;De 50 a menos de 100 ha;13;984;10;3;0;0;6;7;5;5;1;2;1;1;0;1;;
Nossa Senhora das Graças;De 100 a menos de 200 ha;6;801;6;0;801;0;4;2;4;2;0;0;0;1;0;0;;
Nossa Senhora das Graças;De 200 a menos de 500 ha;7;2299;7;0;2299;0;5;2;5;2;0;0;0;2;0;0;;
Nossa Senhora das Graças;De 500 a menos de 1.000 ha;2;0;2;0;0;0;1;1;1;1;0;0;0;0;0;0;;
Nossa Senhora das Graças;De 1.000 a menos de 2.500 ha;0;0;0;0;0;0;0;0;0;0;0;0;0;0;0;0;;
Nossa Senhora das Graças;De 2.500 a menos de 10.000 ha;0;0;0;0;0;0;0;0;0;0;0;0;0;0;0;0;;
Nossa Senhora das Graças;De 10.000 ha e mais;1;0;1;0;0;0;1;0;1;0;0;0;0;0;0;0;;
Nossa Senhora das Graças;Produtor sem área;0;0;0;0;0;0;0;0;0;0;0;0;0;0;0;0;;
Nova Aliança do Ivaí;Mais de 0 a menos de 0,1 ha;2;0;0;2;0;0;0;2;0;0;0;2;0;0;0;2;;
Nova Aliança do Ivaí;De 0,1 a menos de 0,2 ha;0;0;0;0;0;0;0;0;0;0;0;0;0;0;0;0;;
Nova Aliança do Ivaí;De 0,2 a menos de 0,5 ha;5;2;1;4;0;0;0;5;0;1;0;4;0;1;0;4;;
Nova Aliança do Ivaí;De 0,5 a menos de 1 ha;28;15;22;6;11;3;6;22;4;18;2;4;0;11;0;3;;
Nova Aliança do Ivaí;De 1 a menos de 2 ha;9;12;5;4;7;5;0;9;0;5;0;4;0;5;0;4;;
Nova Aliança do Ivaí;De 2 a menos de 3 ha;8;20;2;6;0;0;3;5;1;1;2;4;0;1;0;3;;
Nova Aliança do Ivaí;De 3 a menos de 4 ha;1;0;0;1;0;0;1;0;0;0;1;0;0;0;0;0;;
Nova Aliança do Ivaí;De 4 a menos de 5 ha;28;134;7;21;34;100;15;13;6;1;9;12;0;1;0;10;;
Nova Aliança do Ivaí;De 5 a menos de 10 ha;24;186;10;14;80;106;14;10;5;5;9;5;0;4;0;4;;
Nova Aliança do Ivaí;De 10 a menos de 20 ha;31;464;10;21;161;303;16;15;6;4;10;11;0;3;0;8;;
Nova Aliança do Ivaí;De 20 a menos de 50 ha;45;1445;10;35;346;1099;21;24;2;8;19;16;0;7;0;14;;
Nova Aliança do Ivaí;De 50 a menos de 100 ha;27;1937;13;14;940;997;14;13;5;8;9;5;0;5;0;4;;
Nova Aliança do Ivaí;De 100 a menos de 200 ha;19;2576;19;0;2576;0;13;6;13;6;0;0;0;4;0;0;;
Nova Aliança do Ivaí;De 200 a menos de 500 ha;3;714;3;0;714;0;2;1;2;1;0;0;0;1;0;0;;
Nova Aliança do Ivaí;De 500 a menos de 1.000 ha;1;0;1;0;0;0;1;0;1;0;0;0;0;0;0;0;;
Nova Aliança do Ivaí;De 1.000 a menos de 2.500 ha;1;0;1;0;0;0;1;0;1;0;0;0;0;0;0;0;;
Nova Aliança do Ivaí;De 2.500 a menos de 10.000 ha;1;0;1;0;0;0;1;0;1;0;0;0;0;0;0;0;;
Nova Aliança do Ivaí;De 10.000 ha e mais;0;0;0;0;0;0;0;0;0;0;0;0;0;0;0;0;;
Nova Aliança do Ivaí;Produtor sem área;6;0;0;6;0;0;0;4;0;0;0;4;0;0;0;4;;
Nova América da Colina;Mais de 0 a menos de 0,1 ha;1;0;0;1;0;0;0;1;0;0;0;1;0;0;0;1;;
Nova América da Colina;De 0,1 a menos de 0,2 ha;0;0;0;0;0;0;0;0;0;0;0;0;0;0;0;0;;
Nova América da Colina;De 0,2 a menos de 0,5 ha;1;0;0;1;0;0;1;0;0;0;1;0;0;0;0;0;;
Nova América da Colina;De 0,5 a menos de 1 ha;17;9;2;15;0;0;9;8;2;0;7;8;0;0;2;3;;
Nova América da Colina;De 1 a menos de 2 ha;2;0;1;1;0;0;2;0;1;0;1;0;0;0;0;0;;
Nova América da Colina;De 2 a menos de 3 ha;6;15;2;4;0;0;1;5;0;2;1;3;0;1;0;3;;
Nova América da Colina;De 3 a menos de 4 ha;12;43;2;10;0;0;5;7;1;1;4;6;0;1;1;3;;
Nova América da Colina;De 4 a menos de 5 ha;13;63;0;13;0;63;7;6;0;0;7;6;0;0;0;5;;
Nova América da Colina;De 5 a menos de 10 ha;24;173;3;21;22;151;11;13;1;2;10;11;0;2;0;8;;
Nova América da Colina;De 10 a menos de 20 ha;40;557;3;37;39;518;23;17;2;1;21;16;0;1;1;10;;
Nova América da Colina;De 20 a menos de 50 ha;27;855;2;25;0;0;17;10;0;2;17;8;0;1;0;5;;
Nova América da Colina;De 50 a menos de 100 ha;10;764;6;4;525;238;8;2;5;1;3;1;0;0;0;1;;
Nova América da Colina;De 100 a menos de 200 ha;8;1142;8;0;1142;0;5;3;5;3;0;0;0;3;0;0;;
Nova América da Colina;De 200 a menos de 500 ha;2;0;2;0;0;0;2;0;2;0;0;0;0;0;0;0;;
Nova América da Colina;De 500 a menos de 1.000 ha;1;0;1;0;0;0;1;0;1;0;0;0;0;0;0;0;;
Nova América da Colina;De 1.000 a menos de 2.500 ha;2;0;2;0;0;0;2;0;2;0;0;0;0;0;0;0;;
Nova América da Colina;De 2.500 a menos de 10.000 ha;0;0;0;0;0;0;0;0;0;0;0;0;0;0;0;0;;
Nova América da Colina;De 10.000 ha e mais;0;0;0;0;0;0;0;0;0;0;0;0;0;0;0;0;;
Nova América da Colina;Produtor sem área;0;0;0;0;0;0;0;0;0;0;0;0;0;0;0;0;;
Nova Aurora;Mais de 0 a menos de 0,1 ha;4;0;2;2;0;0;1;3;1;1;0;2;0;1;1;1;;
Nova Aurora;De 0,1 a menos de 0,2 ha;0;0;0;0;0;0;0;0;0;0;0;0;0;0;0;0;;
Nova Aurora;De 0,2 a menos de 0,5 ha;3;1;0;3;0;1;1;2;0;0;1;2;0;0;1;1;;
Nova Aurora;De 0,5 a menos de 1 ha;2;0;1;1;0;0;1;1;0;1;1;0;1;0;0;0;;
Nova Aurora;De 1 a menos de 2 ha;9;13;0;9;0;13;3;6;0;0;3;6;0;0;0;6;;
Nova Aurora;De 2 a menos de 3 ha;21;50;4;17;9;41;5;16;0;4;5;12;0;4;0;12;;
Nova Aurora;De 3 a menos de 4 ha;33;115;3;30;10;106;14;19;0;3;14;16;0;3;1;15;;
Nova Aurora;De 4 a menos de 5 ha;44;212;7;37;34;178;28;16;3;4;25;12;0;4;1;10;;
Nova Aurora;De 5 a menos de 10 ha;155;1206;21;134;158;1047;102;53;7;14;95;39;1;12;3;33;;
Nova Aurora;De 10 a menos de 20 ha;199;2837;20;179;277;2560;171;28;15;5;156;23;0;4;1;16;;
Nova Aurora;De 20 a menos de 50 ha;191;6013;24;167;745;5268;171;20;19;5;152;15;0;4;0;12;;
Nova Aurora;De 50 a menos de 100 ha;101;7221;52;49;4270;2951;93;8;48;4;45;4;1;1;0;4;;
Nova Aurora;De 100 a menos de 200 ha;40;5640;40;0;5640;0;38;2;38;2;0;0;0;2;0;0;;
Nova Aurora;De 200 a menos de 500 ha;31;9672;31;0;9672;0;30;1;30;1;0;0;1;0;0;0;;
Nova Aurora;De 500 a menos de 1.000 ha;5;3560;5;0;3560;0;5;0;5;0;0;0;0;0;0;0;;
Nova Aurora;De 1.000 a menos de 2.500 ha;1;0;1;0;0;0;1;0;1;0;0;0;0;0;0;0;;
Nova Aurora;De 2.500 a menos de 10.000 ha;0;0;0;0;0;0;0;0;0;0;0;0;0;0;0;0;;
Nova Aurora;De 10.000 ha e mais;0;0;0;0;0;0;0;0;0;0;0;0;0;0;0;0;;
Nova Aurora;Produtor sem área;0;0;0;0;0;0;0;0;0;0;0;0;0;0;0;0;;
Nova Cantu;Mais de 0 a menos de 0,1 ha;5;0;3;2;0;0;0;5;0;3;0;2;1;1;1;1;;
Nova Cantu;De 0,1 a menos de 0,2 ha;1;0;0;1;0;0;0;1;0;0;0;1;0;0;0;1;;
Nova Cantu;De 0,2 a menos de 0,5 ha;1;0;1;0;0;0;0;1;0;1;0;0;0;1;0;0;;
Nova Cantu;De 0,5 a menos de 1 ha;28;17;14;14;8;8;5;23;2;12;3;11;0;11;0;10;;
Nova Cantu;De 1 a menos de 2 ha;7;8;2;5;0;0;5;2;2;0;3;2;0;0;0;2;;
Nova Cantu;De 2 a menos de 3 ha;11;27;2;9;0;0;3;8;2;0;1;8;0;0;0;7;;
Nova Cantu;De 3 a menos de 4 ha;15;53;5;10;18;35;2;13;0;5;2;8;0;5;2;5;;
Nova Cantu;De 4 a menos de 5 ha;25;120;1;24;0;0;7;18;1;0;6;18;0;0;2;12;;
Nova Cantu;De 5 a menos de 10 ha;96;750;15;81;117;632;32;64;3;12;29;52;0;8;1;46;;
Nova Cantu;De 10 a menos de 20 ha;198;2997;6;192;104;2893;123;75;0;6;123;69;0;6;6;54;;
Nova Cantu;De 20 a menos de 50 ha;168;5089;10;158;328;4761;118;50;5;5;113;45;0;4;8;31;;
Nova Cantu;De 50 a menos de 100 ha;61;4334;20;41;1736;2598;45;16;14;6;31;10;0;5;1;9;;
Nova Cantu;De 100 a menos de 200 ha;42;5618;42;0;5618;0;33;9;33;9;0;0;0;8;0;0;;
Nova Cantu;De 200 a menos de 500 ha;35;10551;35;0;10551;0;29;6;29;6;0;0;1;4;0;0;;
Nova Cantu;De 500 a menos de 1.000 ha;12;8079;12;0;8079;0;11;1;11;1;0;0;0;0;0;0;;
Nova Cantu;De 1.000 a menos de 2.500 ha;6;10049;6;0;10049;0;6;0;6;0;0;0;0;0;0;0;;
Nova Cantu;De 2.500 a menos de 10.000 ha;0;0;0;0;0;0;0;0;0;0;0;0;0;0;0;0;;
Nova Cantu;De 10.000 ha e mais;0;0;0;0;0;0;0;0;0;0;0;0;0;0;0;0;;
Nova Cantu;Produtor sem área;0;0;0;0;0;0;0;0;0;0;0;0;0;0;0;0;;
Nova Esperança;Mais de 0 a menos de 0,1 ha;1;0;0;1;0;0;0;1;0;0;0;1;0;0;0;1;;
Nova Esperança;De 0,1 a menos de 0,2 ha;0;0;0;0;0;0;0;0;0;0;0;0;0;0;0;0;;
Nova Esperança;De 0,2 a menos de 0,5 ha;4;0;0;4;0;0;0;4;0;0;0;4;0;0;0;3;;
Nova Esperança;De 0,5 a menos de 1 ha;81;43;33;48;17;25;2;79;0;33;2;46;0;27;1;38;;
Nova Esperança;De 1 a menos de 2 ha;20;23;3;17;3;20;0;20;0;3;0;17;0;2;2;9;;
Nova Esperança;De 2 a menos de 3 ha;32;78;11;21;26;52;3;29;0;11;3;18;0;8;0;13;;
Nova Esperança;De 3 a menos de 4 ha;33;114;5;28;17;97;1;32;0;5;1;27;0;4;3;18;;
Nova Esperança;De 4 a menos de 5 ha;44;211;4;40;19;192;11;33;2;2;9;31;0;2;6;19;;
Nova Esperança;De 5 a menos de 10 ha;138;1010;23;115;170;840;33;105;2;21;31;84;0;16;4;59;;
Nova Esperança;De 10 a menos de 20 ha;171;2390;32;139;450;1940;40;131;7;25;33;106;0;21;4;71;;
Nova Esperança;De 20 a menos de 50 ha;142;4336;28;114;852;3484;55;87;14;14;41;73;1;10;0;51;;
Nova Esperança;De 50 a menos de 100 ha;59;4154;36;23;2687;1467;33;26;21;15;12;11;1;10;0;7;;
Nova Esperança;De 100 a menos de 200 ha;28;4260;28;0;4260;0;12;16;12;16;0;0;2;9;0;0;;
Nova Esperança;De 200 a menos de 500 ha;17;5430;17;0;5430;0;11;6;11;6;0;0;0;5;0;0;;
Nova Esperança;De 500 a menos de 1.000 ha;4;2454;4;0;2454;0;2;2;2;2;0;0;0;2;0;0;;
Nova Esperança;De 1.000 a menos de 2.500 ha;1;0;1;0;0;0;1;0;1;0;0;0;0;0;0;0;;
Nova Esperança;De 2.500 a menos de 10.000 ha;2;0;2;0;0;0;2;0;2;0;0;0;0;0;0;0;;
Nova Esperança;De 10.000 ha e mais;0;0;0;0;0;0;0;0;0;0;0;0;0;0;0;0;;
Nova Esperança;Produtor sem área;0;0;0;0;0;0;0;0;0;0;0;0;0;0;0;0;;
Nova Esperança do Sudoeste;Mais de 0 a menos de 0,1 ha;15;1;4;11;0;1;3;12;2;2;1;10;0;2;0;8;;
Nova Esperança do Sudoeste;De 0,1 a menos de 0,2 ha;14;2;7;7;0;0;1;13;0;7;1;6;0;6;0;5;;
Nova Esperança do Sudoeste;De 0,2 a menos de 0,5 ha;33;10;16;17;5;5;5;28;2;14;3;14;0;13;0;13;;
Nova Esperança do Sudoeste;De 0,5 a menos de 1 ha;35;24;13;22;9;15;8;27;1;12;7;15;0;11;0;13;;
Nova Esperança do Sudoeste;De 1 a menos de 2 ha;40;54;17;23;23;31;9;31;5;12;4;19;0;10;0;15;;
Nova Esperança do Sudoeste;De 2 a menos de 3 ha;49;122;15;34;36;85;12;37;3;12;9;25;0;8;0;15;;
Nova Esperança do Sudoeste;De 3 a menos de 4 ha;46;161;13;33;45;115;19;27;4;9;15;18;0;6;0;12;;
Nova Esperança do Sudoeste;De 4 a menos de 5 ha;73;350;19;54;91;259;38;35;8;11;30;24;0;8;1;16;;
Nova Esperança do Sudoeste;De 5 a menos de 10 ha;180;1413;32;148;241;1173;92;88;11;21;81;67;0;15;0;42;;
Nova Esperança do Sudoeste;De 10 a menos de 20 ha;231;3360;23;208;309;3051;149;82;10;13;139;69;0;11;0;38;;
Nova Esperança do Sudoeste;De 20 a menos de 50 ha;167;5052;13;154;394;4657;139;28;9;4;130;24;0;4;0;17;;
Nova Esperança do Sudoeste;De 50 a menos de 100 ha;31;2211;9;22;782;1429;23;8;5;4;18;4;0;4;0;3;;
Nova Esperança do Sudoeste;De 100 a menos de 200 ha;8;1180;8;0;1180;0;7;1;7;1;0;0;0;1;0;0;;
Nova Esperança do Sudoeste;De 200 a menos de 500 ha;5;1217;5;0;1217;0;2;3;2;3;0;0;0;3;0;0;;
Nova Esperança do Sudoeste;De 500 a menos de 1.000 ha;3;0;3;0;0;0;1;2;1;2;0;0;0;1;0;0;;
Nova Esperança do Sudoeste;De 1.000 a menos de 2.500 ha;1;0;1;0;0;0;1;0;1;0;0;0;0;0;0;0;;
Nova Esperança do Sudoeste;De 2.500 a menos de 10.000 ha;0;0;0;0;0;0;0;0;0;0;0;0;0;0;0;0;;
Nova Esperança do Sudoeste;De 10.000 ha e mais;0;0;0;0;0;0;0;0;0;0;0;0;0;0;0;0;;
Nova Esperança do Sudoeste;Produtor sem área;9;0;5;4;0;0;1;7;0;5;1;2;0;5;0;2;;
Nova Fátima;Mais de 0 a menos de 0,1 ha;1;0;0;1;0;0;1;0;0;0;1;0;0;0;0;0;;
Nova Fátima;De 0,1 a menos de 0,2 ha;0;0;0;0;0;0;0;0;0;0;0;0;0;0;0;0;;
Nova Fátima;De 0,2 a menos de 0,5 ha;0;0;0;0;0;0;0;0;0;0;0;0;0;0;0;0;;
Nova Fátima;De 0,5 a menos de 1 ha;95;48;56;39;29;20;3;92;1;55;2;37;1;27;5;15;;
Nova Fátima;De 1 a menos de 2 ha;9;11;2;7;0;0;0;9;0;2;0;7;0;0;2;3;;
Nova Fátima;De 2 a menos de 3 ha;3;0;1;2;0;0;3;0;1;0;2;0;0;0;0;0;;
Nova Fátima;De 3 a menos de 4 ha;8;27;0;8;0;27;1;7;0;0;1;7;0;0;0;4;;
Nova Fátima;De 4 a menos de 5 ha;8;38;3;5;15;23;4;4;1;2;3;2;0;2;0;1;;
Nova Fátima;De 5 a menos de 10 ha;25;193;7;18;53;140;11;14;2;5;9;9;1;3;1;2;;
Nova Fátima;De 10 a menos de 20 ha;21;302;2;19;0;0;11;10;0;2;11;8;0;1;2;3;;
Nova Fátima;De 20 a menos de 50 ha;22;734;7;15;223;512;14;8;5;2;9;6;0;1;0;3;;
Nova Fátima;De 50 a menos de 100 ha;21;1410;10;11;774;636;17;4;8;2;9;2;0;0;0;2;;
Nova Fátima;De 100 a menos de 200 ha;11;1590;11;0;1590;0;8;3;8;3;0;0;0;1;0;0;;
Nova Fátima;De 200 a menos de 500 ha;9;2679;9;0;2679;0;8;1;8;1;0;0;0;1;0;0;;
Nova Fátima;De 500 a menos de 1.000 ha;7;5685;7;0;5685;0;6;1;6;1;0;0;0;1;0;0;;
Nova Fátima;De 1.000 a menos de 2.500 ha;4;6142;4;0;6142;0;4;0;4;0;0;0;0;0;0;0;;
Nova Fátima;De 2.500 a menos de 10.000 ha;1;0;1;0;0;0;1;0;1;0;0;0;0;0;0;0;;
Nova Fátima;De 10.000 ha e mais;0;0;0;0;0;0;0;0;0;0;0;0;0;0;0;0;;
Nova Fátima;Produtor sem área;0;0;0;0;0;0;0;0;0;0;0;0;0;0;0;0;;
Nova Laranjeiras;Mais de 0 a menos de 0,1 ha;10;1;1;9;0;0;2;8;1;0;1;8;0;0;0;7;;
Nova Laranjeiras;De 0,1 a menos de 0,2 ha;29;4;7;22;1;3;1;28;0;7;1;21;4;3;2;18;;
Nova Laranjeiras;De 0,2 a menos de 0,5 ha;23;8;2;21;0;0;1;22;0;2;1;20;1;1;4;10;;
Nova Laranjeiras;De 0,5 a menos de 1 ha;44;30;4;40;2;28;13;31;1;3;12;28;2;1;8;16;;
Nova Laranjeiras;De 1 a menos de 2 ha;130;180;20;110;26;154;42;88;6;14;36;74;1;13;25;43;;
Nova Laranjeiras;De 2 a menos de 3 ha;138;349;23;115;59;290;51;87;6;17;45;70;4;10;26;39;;
Nova Laranjeiras;De 3 a menos de 4 ha;84;303;13;71;46;257;35;49;7;6;28;43;3;3;7;27;;
Nova Laranjeiras;De 4 a menos de 5 ha;110;529;17;93;82;447;43;67;4;13;39;54;4;6;12;31;;
Nova Laranjeiras;De 5 a menos de 10 ha;237;1845;38;199;301;1544;127;110;16;22;111;88;6;12;10;53;;
Nova Laranjeiras;De 10 a menos de 20 ha;519;7438;46;473;649;6789;329;190;21;25;308;165;1;20;11;95;;
Nova Laranjeiras;De 20 a menos de 50 ha;413;12577;31;382;972;11605;275;138;15;16;260;122;2;10;10;73;;
Nova Laranjeiras;De 50 a menos de 100 ha;135;9660;68;67;5685;3975;97;38;49;19;48;19;1;16;1;12;;
Nova Laranjeiras;De 100 a menos de 200 ha;76;10528;76;0;10528;0;53;23;53;23;0;0;2;17;0;0;;
Nova Laranjeiras;De 200 a menos de 500 ha;69;20071;69;0;20071;0;36;33;36;33;0;0;3;24;0;0;;
Nova Laranjeiras;De 500 a menos de 1.000 ha;18;12255;18;0;12255;0;13;5;13;5;0;0;1;4;0;0;;
Nova Laranjeiras;De 1.000 a menos de 2.500 ha;4;0;4;0;0;0;3;1;3;1;0;0;0;1;0;0;;
Nova Laranjeiras;De 2.500 a menos de 10.000 ha;1;0;1;0;0;0;0;1;0;1;0;0;1;0;0;0;;
Nova Laranjeiras;De 10.000 ha e mais;0;0;0;0;0;0;0;0;0;0;0;0;0;0;0;0;;
Nova Laranjeiras;Produtor sem área;1;0;0;1;0;0;1;0;0;0;1;0;0;0;0;0;;
Nova Londrina;Mais de 0 a menos de 0,1 ha;1;0;0;1;0;0;0;1;0;0;0;1;0;0;0;1;;
Nova Londrina;De 0,1 a menos de 0,2 ha;0;0;0;0;0;0;0;0;0;0;0;0;0;0;0;0;;
Nova Londrina;De 0,2 a menos de 0,5 ha;0;0;0;0;0;0;0;0;0;0;0;0;0;0;0;0;;
Nova Londrina;De 0,5 a menos de 1 ha;61;31;29;32;15;16;0;61;0;29;0;32;0;27;0;32;;
Nova Londrina;De 1 a menos de 2 ha;4;0;2;2;0;0;0;4;0;2;0;2;0;2;0;2;;
Nova Londrina;De 2 a menos de 3 ha;15;37;7;8;17;20;0;15;0;7;0;8;0;5;0;7;;
Nova Londrina;De 3 a menos de 4 ha;5;17;3;2;0;0;0;5;0;3;0;2;0;3;0;2;;
Nova Londrina;De 4 a menos de 5 ha;29;138;16;13;77;61;0;29;0;16;0;13;0;14;0;11;;
Nova Londrina;De 5 a menos de 10 ha;41;309;22;19;161;148;2;39;1;21;1;18;0;21;0;12;;
Nova Londrina;De 10 a menos de 20 ha;38;584;14;24;208;376;2;36;0;14;2;22;0;14;0;19;;
Nova Londrina;De 20 a menos de 50 ha;46;1324;7;39;204;1120;5;41;1;6;4;35;0;5;0;25;;
Nova Londrina;De 50 a menos de 100 ha;21;1462;6;15;467;995;2;19;0;6;2;13;0;3;0;11;;
Nova Londrina;De 100 a menos de 200 ha;14;1944;14;0;1944;0;1;13;1;13;0;0;0;8;0;0;;
Nova Londrina;De 200 a menos de 500 ha;16;5535;16;0;5535;0;1;15;1;15;0;0;0;9;0;0;;
Nova Londrina;De 500 a menos de 1.000 ha;8;6219;8;0;6219;0;0;8;0;8;0;0;0;5;0;0;;
Nova Londrina;De 1.000 a menos de 2.500 ha;0;0;0;0;0;0;0;0;0;0;0;0;0;0;0;0;;
Nova Londrina;De 2.500 a menos de 10.000 ha;1;0;1;0;0;0;1;0;1;0;0;0;0;0;0;0;;
Nova Londrina;De 10.000 ha e mais;0;0;0;0;0;0;0;0;0;0;0;0;0;0;0;0;;
Nova Londrina;Produtor sem área;0;0;0;0;0;0;0;0;0;0;0;0;0;0;0;0;;
Nova Olímpia;Mais de 0 a menos de 0,1 ha;1;0;0;1;0;0;0;1;0;0;0;1;0;0;0;0;;
Nova Olímpia;De 0,1 a menos de 0,2 ha;1;0;0;1;0;0;0;1;0;0;0;1;0;0;0;1;;
Nova Olímpia;De 0,2 a menos de 0,5 ha;4;1;0;4;0;1;1;3;0;0;1;3;0;0;0;2;;
Nova Olímpia;De 0,5 a menos de 1 ha;25;13;13;12;7;7;16;9;9;4;7;5;0;4;0;4;;
Nova Olímpia;De 1 a menos de 2 ha;9;12;2;7;0;0;4;5;1;1;3;4;0;1;0;2;;
Nova Olímpia;De 2 a menos de 3 ha;8;20;3;5;7;13;1;7;0;3;1;4;0;2;0;4;;
Nova Olímpia;De 3 a menos de 4 ha;6;21;2;4;0;0;3;3;0;2;3;1;0;2;0;1;;
Nova Olímpia;De 4 a menos de 5 ha;19;90;5;14;24;66;7;12;1;4;6;8;0;3;0;5;;
Nova Olímpia;De 5 a menos de 10 ha;38;274;7;31;49;225;13;25;2;5;11;20;0;4;0;13;;
Nova Olímpia;De 10 a menos de 20 ha;67;910;16;51;228;682;28;39;5;11;23;28;0;10;0;15;;
Nova Olímpia;De 20 a menos de 50 ha;43;1346;6;37;202;1144;23;20;2;4;21;16;0;3;0;11;;
Nova Olímpia;De 50 a menos de 100 ha;17;1222;3;14;0;0;10;7;2;1;8;6;0;0;0;4;;
Nova Olímpia;De 100 a menos de 200 ha;8;1113;8;0;1113;0;3;5;3;5;0;0;0;2;0;0;;
Nova Olímpia;De 200 a menos de 500 ha;6;1879;6;0;1879;0;3;3;3;3;0;0;0;3;0;0;;
Nova Olímpia;De 500 a menos de 1.000 ha;2;0;2;0;0;0;2;0;2;0;0;0;0;0;0;0;;
Nova Olímpia;De 1.000 a menos de 2.500 ha;1;0;1;0;0;0;1;0;1;0;0;0;0;0;0;0;;
Nova Olímpia;De 2.500 a menos de 10.000 ha;1;0;1;0;0;0;1;0;1;0;0;0;0;0;0;0;;
Nova Olímpia;De 10.000 ha e mais;0;0;0;0;0;0;0;0;0;0;0;0;0;0;0;0;;
Nova Olímpia;Produtor sem área;2;0;0;2;0;0;1;1;0;0;1;1;0;0;0;1;;
Nova Santa Bárbara;Mais de 0 a menos de 0,1 ha;2;0;1;1;0;0;0;2;0;1;0;1;0;1;0;1;;
Nova Santa Bárbara;De 0,1 a menos de 0,2 ha;0;0;0;0;0;0;0;0;0;0;0;0;0;0;0;0;;
Nova Santa Bárbara;De 0,2 a menos de 0,5 ha;2;0;0;2;0;0;0;2;0;0;0;2;0;0;0;2;;
Nova Santa Bárbara;De 0,5 a menos de 1 ha;48;25;1;47;0;0;0;48;0;1;0;47;0;1;2;41;;
Nova Santa Bárbara;De 1 a menos de 2 ha;2;0;0;2;0;0;0;2;0;0;0;2;0;0;0;2;;
Nova Santa Bárbara;De 2 a menos de 3 ha;11;27;0;11;0;27;5;6;0;0;5;6;0;0;0;5;;
Nova Santa Bárbara;De 3 a menos de 4 ha;13;46;1;12;0;0;5;8;0;1;5;7;0;1;0;5;;
Nova Santa Bárbara;De 4 a menos de 5 ha;12;57;1;11;0;0;5;7;0;1;5;6;0;1;0;4;;
Nova Santa Bárbara;De 5 a menos de 10 ha;29;221;0;29;0;221;17;12;0;0;17;12;0;0;1;10;;
Nova Santa Bárbara;De 10 a menos de 20 ha;32;437;1;31;0;0;26;6;0;1;26;5;0;1;0;5;;
Nova Santa Bárbara;De 20 a menos de 50 ha;15;455;1;14;0;0;15;0;1;0;14;0;0;0;0;0;;
Nova Santa Bárbara;De 50 a menos de 100 ha;4;271;2;2;0;0;4;0;2;0;2;0;0;0;0;0;;
Nova Santa Bárbara;De 100 a menos de 200 ha;11;1624;11;0;1624;0;11;0;11;0;0;0;0;0;0;0;;
Nova Santa Bárbara;De 200 a menos de 500 ha;5;1382;5;0;1382;0;5;0;5;0;0;0;0;0;0;0;;
Nova Santa Bárbara;De 500 a menos de 1.000 ha;0;0;0;0;0;0;0;0;0;0;0;0;0;0;0;0;;
Nova Santa Bárbara;De 1.000 a menos de 2.500 ha;0;0;0;0;0;0;0;0;0;0;0;0;0;0;0;0;;
Nova Santa Bárbara;De 2.500 a menos de 10.000 ha;0;0;0;0;0;0;0;0;0;0;0;0;0;0;0;0;;
Nova Santa Bárbara;De 10.000 ha e mais;0;0;0;0;0;0;0;0;0;0;0;0;0;0;0;0;;
Nova Santa Bárbara;Produtor sem área;0;0;0;0;0;0;0;0;0;0;0;0;0;0;0;0;;
Nova Santa Rosa;Mais de 0 a menos de 0,1 ha;1;0;0;1;0;0;0;1;0;0;0;1;0;0;0;1;;
Nova Santa Rosa;De 0,1 a menos de 0,2 ha;1;0;0;1;0;0;1;0;0;0;1;0;0;0;0;0;;
Nova Santa Rosa;De 0,2 a menos de 0,5 ha;1;0;1;0;0;0;0;1;0;1;0;0;0;0;0;0;;
Nova Santa Rosa;De 0,5 a menos de 1 ha;2;0;0;2;0;0;0;2;0;0;0;2;0;0;0;2;;
Nova Santa Rosa;De 1 a menos de 2 ha;15;20;2;13;0;0;7;8;0;2;7;6;0;2;0;6;;
Nova Santa Rosa;De 2 a menos de 3 ha;30;74;5;25;12;62;12;18;1;4;11;14;0;4;1;12;;
Nova Santa Rosa;De 3 a menos de 4 ha;31;109;2;29;0;0;17;14;1;1;16;13;0;1;0;12;;
Nova Santa Rosa;De 4 a menos de 5 ha;39;180;4;35;18;161;29;10;3;1;26;9;0;1;0;7;;
Nova Santa Rosa;De 5 a menos de 10 ha;146;1115;28;118;201;913;113;33;10;18;103;15;0;17;0;12;;
Nova Santa Rosa;De 10 a menos de 20 ha;175;2527;21;154;298;2229;157;18;12;9;145;9;1;7;2;4;;
Nova Santa Rosa;De 20 a menos de 50 ha;173;5377;18;155;615;4762;170;3;16;2;154;1;0;2;0;0;;
Nova Santa Rosa;De 50 a menos de 100 ha;57;3809;27;30;2051;1758;56;1;26;1;30;0;0;1;0;0;;
Nova Santa Rosa;De 100 a menos de 200 ha;11;1437;11;0;1437;0;11;0;11;0;0;0;0;0;0;0;;
Nova Santa Rosa;De 200 a menos de 500 ha;4;956;4;0;956;0;4;0;4;0;0;0;0;0;0;0;;
Nova Santa Rosa;De 500 a menos de 1.000 ha;0;0;0;0;0;0;0;0;0;0;0;0;0;0;0;0;;
Nova Santa Rosa;De 1.000 a menos de 2.500 ha;0;0;0;0;0;0;0;0;0;0;0;0;0;0;0;0;;
Nova Santa Rosa;De 2.500 a menos de 10.000 ha;0;0;0;0;0;0;0;0;0;0;0;0;0;0;0;0;;
Nova Santa Rosa;De 10.000 ha e mais;0;0;0;0;0;0;0;0;0;0;0;0;0;0;0;0;;
Nova Santa Rosa;Produtor sem área;0;0;0;0;0;0;0;0;0;0;0;0;0;0;0;0;;
Nova Prata do Iguaçu;Mais de 0 a menos de 0,1 ha;12;1;2;10;0;0;2;10;0;2;2;8;0;1;0;7;;
Nova Prata do Iguaçu;De 0,1 a menos de 0,2 ha;13;2;8;5;0;0;2;11;2;6;0;5;0;4;0;5;;
Nova Prata do Iguaçu;De 0,2 a menos de 0,5 ha;16;5;5;11;1;3;3;13;1;4;2;9;0;4;0;7;;
Nova Prata do Iguaçu;De 0,5 a menos de 1 ha;33;21;14;19;9;12;15;18;7;7;8;11;0;2;0;5;;
Nova Prata do Iguaçu;De 1 a menos de 2 ha;39;52;10;29;13;39;15;24;1;9;14;15;0;5;0;12;;
Nova Prata do Iguaçu;De 2 a menos de 3 ha;29;70;6;23;15;56;14;15;3;3;11;12;0;2;1;5;;
Nova Prata do Iguaçu;De 3 a menos de 4 ha;47;160;17;30;57;103;29;18;9;8;20;10;0;4;1;8;;
Nova Prata do Iguaçu;De 4 a menos de 5 ha;55;261;10;45;47;214;36;19;3;7;33;12;0;5;1;7;;
Nova Prata do Iguaçu;De 5 a menos de 10 ha;176;1369;20;156;165;1205;138;38;14;6;124;32;0;3;1;15;;
Nova Prata do Iguaçu;De 10 a menos de 20 ha;208;3052;12;196;163;2890;183;25;7;5;176;20;1;3;1;10;;
Nova Prata do Iguaçu;De 20 a menos de 50 ha;229;7207;13;216;429;6777;210;19;11;2;199;17;0;2;3;6;;
Nova Prata do Iguaçu;De 50 a menos de 100 ha;65;4386;17;48;1339;3046;64;1;17;0;47;1;0;0;0;1;;
Nova Prata do Iguaçu;De 100 a menos de 200 ha;39;5319;38;1;0;0;37;2;36;2;1;0;0;0;0;0;;
Nova Prata do Iguaçu;De 200 a menos de 500 ha;12;3634;12;0;3634;0;12;0;12;0;0;0;0;0;0;0;;
Nova Prata do Iguaçu;De 500 a menos de 1.000 ha;4;0;4;0;0;0;3;1;3;1;0;0;0;1;0;0;;
Nova Prata do Iguaçu;De 1.000 a menos de 2.500 ha;0;0;0;0;0;0;0;0;0;0;0;0;0;0;0;0;;
Nova Prata do Iguaçu;De 2.500 a menos de 10.000 ha;0;0;0;0;0;0;0;0;0;0;0;0;0;0;0;0;;
Nova Prata do Iguaçu;De 10.000 ha e mais;0;0;0;0;0;0;0;0;0;0;0;0;0;0;0;0;;
Nova Prata do Iguaçu;Produtor sem área;3;0;0;3;0;0;2;0;0;0;2;0;0;0;0;0;;
Nova Tebas;Mais de 0 a menos de 0,1 ha;2;0;2;0;0;0;1;1;1;1;0;0;0;1;0;0;;
Nova Tebas;De 0,1 a menos de 0,2 ha;2;0;0;2;0;0;0;2;0;0;0;2;0;0;0;2;;
Nova Tebas;De 0,2 a menos de 0,5 ha;40;18;5;35;2;16;18;22;3;2;15;20;0;1;2;9;;
Nova Tebas;De 0,5 a menos de 1 ha;40;28;7;33;4;24;7;33;3;4;4;29;0;3;3;16;;
Nova Tebas;De 1 a menos de 2 ha;67;93;12;55;16;76;24;43;5;7;19;36;1;5;4;21;;
Nova Tebas;De 2 a menos de 3 ha;71;175;17;54;41;134;25;46;7;10;18;36;4;6;4;25;;
Nova Tebas;De 3 a menos de 4 ha;70;244;7;63;26;218;27;43;5;2;22;41;0;1;5;26;;
Nova Tebas;De 4 a menos de 5 ha;77;367;7;70;34;333;28;49;1;6;27;43;0;4;7;28;;
Nova Tebas;De 5 a menos de 10 ha;204;1554;33;171;257;1297;95;109;12;21;83;88;4;14;14;53;;
Nova Tebas;De 10 a menos de 20 ha;173;2538;26;147;371;2167;76;97;9;17;67;80;3;11;6;55;;
Nova Tebas;De 20 a menos de 50 ha;140;4547;15;125;485;4062;85;55;7;8;78;47;0;7;10;28;;
Nova Tebas;De 50 a menos de 100 ha;56;3942;16;40;1356;2585;39;17;13;3;26;14;0;2;0;9;;
Nova Tebas;De 100 a menos de 200 ha;37;5334;37;0;5334;0;27;10;27;10;0;0;0;9;0;0;;
Nova Tebas;De 200 a menos de 500 ha;57;18201;57;0;18201;0;41;16;41;16;0;0;0;15;0;0;;
Nova Tebas;De 500 a menos de 1.000 ha;7;4615;7;0;4615;0;4;3;4;3;0;0;0;3;0;0;;
Nova Tebas;De 1.000 a menos de 2.500 ha;3;3518;3;0;3518;0;3;0;3;0;0;0;0;0;0;0;;
Nova Tebas;De 2.500 a menos de 10.000 ha;1;0;1;0;0;0;1;0;1;0;0;0;0;0;0;0;;
Nova Tebas;De 10.000 ha e mais;0;0;0;0;0;0;0;0;0;0;0;0;0;0;0;0;;
Nova Tebas;Produtor sem área;4;0;0;4;0;0;0;0;0;0;0;0;0;0;0;0;;
Novo Itacolomi;Mais de 0 a menos de 0,1 ha;7;0;1;6;0;0;1;6;0;1;1;5;0;1;0;4;;
Novo Itacolomi;De 0,1 a menos de 0,2 ha;8;1;1;7;0;0;1;7;0;1;1;6;0;1;0;6;;
Novo Itacolomi;De 0,2 a menos de 0,5 ha;7;2;2;5;0;0;2;5;1;1;1;4;0;0;0;3;;
Novo Itacolomi;De 0,5 a menos de 1 ha;10;5;3;7;2;4;0;10;0;3;0;7;0;3;0;7;;
Novo Itacolomi;De 1 a menos de 2 ha;11;14;1;10;0;0;3;8;0;1;3;7;0;0;0;6;;
Novo Itacolomi;De 2 a menos de 3 ha;21;50;5;16;12;38;5;16;1;4;4;12;0;4;0;11;;
Novo Itacolomi;De 3 a menos de 4 ha;25;86;3;22;10;76;12;13;1;2;11;11;0;2;0;8;;
Novo Itacolomi;De 4 a menos de 5 ha;41;194;9;32;43;152;23;18;3;6;20;12;0;6;0;12;;
Novo Itacolomi;De 5 a menos de 10 ha;89;651;16;73;113;538;58;31;6;10;52;21;0;9;0;18;;
Novo Itacolomi;De 10 a menos de 20 ha;82;1167;7;75;82;1086;58;24;4;3;54;21;0;3;0;17;;
Novo Itacolomi;De 20 a menos de 50 ha;76;2208;6;70;166;2042;51;25;2;4;49;21;0;4;0;15;;
Novo Itacolomi;De 50 a menos de 100 ha;23;1558;14;9;1054;505;17;6;9;5;8;1;0;5;0;1;;
Novo Itacolomi;De 100 a menos de 200 ha;13;1820;13;0;1820;0;9;4;9;4;0;0;0;4;0;0;;
Novo Itacolomi;De 200 a menos de 500 ha;7;0;7;0;0;0;5;2;5;2;0;0;0;1;0;0;;
Novo Itacolomi;De 500 a menos de 1.000 ha;2;0;2;0;0;0;2;0;2;0;0;0;0;0;0;0;;
Novo Itacolomi;De 1.000 a menos de 2.500 ha;0;0;0;0;0;0;0;0;0;0;0;0;0;0;0;0;;
Novo Itacolomi;De 2.500 a menos de 10.000 ha;0;0;0;0;0;0;0;0;0;0;0;0;0;0;0;0;;
Novo Itacolomi;De 10.000 ha e mais;0;0;0;0;0;0;0;0;0;0;0;0;0;0;0;0;;
Novo Itacolomi;Produtor sem área;0;0;0;0;0;0;0;0;0;0;0;0;0;0;0;0;;
Ortigueira;Mais de 0 a menos de 0,1 ha;14;1;6;8;0;0;4;10;1;5;3;5;0;4;0;3;;
Ortigueira;De 0,1 a menos de 0,2 ha;18;3;6;12;1;2;2;16;0;6;2;10;0;4;0;5;;
Ortigueira;De 0,2 a menos de 0,5 ha;73;27;12;61;4;23;12;61;0;12;12;49;0;7;0;20;;
Ortigueira;De 0,5 a menos de 1 ha;131;79;34;97;21;59;36;95;10;24;26;71;0;15;1;30;;
Ortigueira;De 1 a menos de 2 ha;121;154;29;92;38;117;43;78;10;19;33;59;1;15;5;38;;
Ortigueira;De 2 a menos de 3 ha;203;489;36;167;87;402;82;121;13;23;69;98;1;12;8;52;;
Ortigueira;De 3 a menos de 4 ha;76;269;15;61;54;215;34;42;6;9;28;33;1;6;0;16;;
Ortigueira;De 4 a menos de 5 ha;193;931;37;156;178;752;87;106;11;26;76;80;2;18;4;52;;
Ortigueira;De 5 a menos de 10 ha;351;2748;57;294;449;2299;152;199;20;37;132;162;0;22;5;103;;
Ortigueira;De 10 a menos de 20 ha;651;9818;64;587;926;8892;293;358;29;35;264;323;0;21;12;204;;
Ortigueira;De 20 a menos de 50 ha;652;19528;64;588;1966;17562;290;362;23;41;267;321;1;32;9;217;;
Ortigueira;De 50 a menos de 100 ha;155;10886;55;100;4637;6249;71;84;26;29;45;55;0;22;1;35;;
Ortigueira;De 100 a menos de 200 ha;120;17380;120;0;17380;0;52;68;52;68;0;0;1;53;0;0;;
Ortigueira;De 200 a menos de 500 ha;131;41601;131;0;41601;0;63;68;63;68;0;0;1;46;0;0;;
Ortigueira;De 500 a menos de 1.000 ha;52;36098;51;1;0;0;24;28;24;27;0;1;2;13;1;0;;
Ortigueira;De 1.000 a menos de 2.500 ha;19;28015;19;0;28015;0;11;8;11;8;0;0;0;6;0;0;;
Ortigueira;De 2.500 a menos de 10.000 ha;3;0;3;0;0;0;1;2;1;2;0;0;0;0;0;0;;
Ortigueira;De 10.000 ha e mais;1;0;1;0;0;0;1;0;1;0;0;0;0;0;0;0;;
Ortigueira;Produtor sem área;4;0;1;3;0;0;1;0;0;0;1;0;0;0;0;0;;
Ourizona;Mais de 0 a menos de 0,1 ha;0;0;0;0;0;0;0;0;0;0;0;0;0;0;0;0;;
Ourizona;De 0,1 a menos de 0,2 ha;0;0;0;0;0;0;0;0;0;0;0;0;0;0;0;0;;
Ourizona;De 0,2 a menos de 0,5 ha;1;0;0;1;0;0;0;1;0;0;0;1;0;0;1;0;;
Ourizona;De 0,5 a menos de 1 ha;6;4;1;5;0;0;2;4;0;1;2;3;0;1;0;3;;
Ourizona;De 1 a menos de 2 ha;5;7;1;4;0;0;2;3;0;1;2;2;0;1;0;2;;
Ourizona;De 2 a menos de 3 ha;8;19;2;6;0;0;3;5;2;0;1;5;0;0;1;4;;
Ourizona;De 3 a menos de 4 ha;4;0;2;2;0;0;2;2;0;2;2;0;0;1;0;0;;
Ourizona;De 4 a menos de 5 ha;10;48;2;8;0;0;7;3;0;2;7;1;0;1;0;0;;
Ourizona;De 5 a menos de 10 ha;19;147;1;18;0;0;13;6;1;0;12;6;0;0;1;1;;
Ourizona;De 10 a menos de 20 ha;30;434;4;26;53;381;27;3;3;1;24;2;0;1;1;1;;
Ourizona;De 20 a menos de 50 ha;49;1625;5;44;175;1450;45;4;3;2;42;2;0;1;1;1;;
Ourizona;De 50 a menos de 100 ha;28;2041;20;8;1598;443;28;0;20;0;8;0;0;0;0;0;;
Ourizona;De 100 a menos de 200 ha;24;3281;24;0;3281;0;24;0;24;0;0;0;0;0;0;0;;
Ourizona;De 200 a menos de 500 ha;12;3282;12;0;3282;0;12;0;12;0;0;0;0;0;0;0;;
Ourizona;De 500 a menos de 1.000 ha;6;3863;6;0;3863;0;6;0;6;0;0;0;0;0;0;0;;
Ourizona;De 1.000 a menos de 2.500 ha;1;0;1;0;0;0;1;0;1;0;0;0;0;0;0;0;;
Ourizona;De 2.500 a menos de 10.000 ha;0;0;0;0;0;0;0;0;0;0;0;0;0;0;0;0;;
Ourizona;De 10.000 ha e mais;0;0;0;0;0;0;0;0;0;0;0;0;0;0;0;0;;
Ourizona;Produtor sem área;0;0;0;0;0;0;0;0;0;0;0;0;0;0;0;0;;
Ouro Verde do Oeste;Mais de 0 a menos de 0,1 ha;0;0;0;0;0;0;0;0;0;0;0;0;0;0;0;0;;
Ouro Verde do Oeste;De 0,1 a menos de 0,2 ha;3;0;2;1;0;0;0;3;0;2;0;1;1;1;0;1;;
Ouro Verde do Oeste;De 0,2 a menos de 0,5 ha;3;0;0;3;0;0;2;1;0;0;2;1;0;0;0;0;;
Ouro Verde do Oeste;De 0,5 a menos de 1 ha;32;17;15;17;8;9;16;16;5;10;11;6;1;6;2;2;;
Ouro Verde do Oeste;De 1 a menos de 2 ha;9;12;2;7;0;0;2;7;0;2;2;5;0;2;1;3;;
Ouro Verde do Oeste;De 2 a menos de 3 ha;25;61;12;13;29;32;12;13;5;7;7;6;0;6;1;4;;
Ouro Verde do Oeste;De 3 a menos de 4 ha;9;32;0;9;0;32;6;3;0;0;6;3;0;0;1;2;;
Ouro Verde do Oeste;De 4 a menos de 5 ha;25;119;3;22;14;105;19;6;2;1;17;5;0;1;0;5;;
Ouro Verde do Oeste;De 5 a menos de 10 ha;68;507;9;59;58;449;49;19;3;6;46;13;1;5;2;10;;
Ouro Verde do Oeste;De 10 a menos de 20 ha;93;1331;13;80;189;1142;83;10;9;4;74;6;0;4;0;5;;
Ouro Verde do Oeste;De 20 a menos de 50 ha;96;3003;12;84;379;2624;85;11;7;5;78;6;0;5;0;6;;
Ouro Verde do Oeste;De 50 a menos de 100 ha;46;3330;25;21;2066;1265;45;1;25;0;20;1;0;0;0;1;;
Ouro Verde do Oeste;De 100 a menos de 200 ha;28;3776;28;0;3776;0;26;2;26;2;0;0;0;1;0;0;;
Ouro Verde do Oeste;De 200 a menos de 500 ha;15;4845;15;0;4845;0;15;0;15;0;0;0;0;0;0;0;;
Ouro Verde do Oeste;De 500 a menos de 1.000 ha;4;2631;4;0;2631;0;4;0;4;0;0;0;0;0;0;0;;
Ouro Verde do Oeste;De 1.000 a menos de 2.500 ha;3;0;3;0;0;0;3;0;3;0;0;0;0;0;0;0;;
Ouro Verde do Oeste;De 2.500 a menos de 10.000 ha;1;0;1;0;0;0;1;0;1;0;0;0;0;0;0;0;;
Ouro Verde do Oeste;De 10.000 ha e mais;0;0;0;0;0;0;0;0;0;0;0;0;0;0;0;0;;
Ouro Verde do Oeste;Produtor sem área;1;0;0;1;0;0;0;0;0;0;0;0;0;0;0;0;;
Paiçandu;Mais de 0 a menos de 0,1 ha;0;0;0;0;0;0;0;0;0;0;0;0;0;0;0;0;;
Paiçandu;De 0,1 a menos de 0,2 ha;0;0;0;0;0;0;0;0;0;0;0;0;0;0;0;0;;
Paiçandu;De 0,2 a menos de 0,5 ha;0;0;0;0;0;0;0;0;0;0;0;0;0;0;0;0;;
Paiçandu;De 0,5 a menos de 1 ha;1;0;0;1;0;0;1;0;0;0;1;0;0;0;0;0;;
Paiçandu;De 1 a menos de 2 ha;1;0;0;1;0;0;1;0;0;0;1;0;0;0;0;0;;
Paiçandu;De 2 a menos de 3 ha;9;21;1;8;0;0;5;4;0;1;5;3;0;1;0;2;;
Paiçandu;De 3 a menos de 4 ha;7;25;1;6;0;0;4;3;0;1;4;2;0;1;0;1;;
Paiçandu;De 4 a menos de 5 ha;6;0;0;6;0;0;1;5;0;0;1;5;0;0;0;5;;
Paiçandu;De 5 a menos de 10 ha;16;125;2;14;0;0;11;5;2;0;9;5;0;0;0;4;;
Paiçandu;De 10 a menos de 20 ha;33;478;3;30;45;433;25;8;2;1;23;7;0;1;2;3;;
Paiçandu;De 20 a menos de 50 ha;48;1708;2;46;0;0;48;0;2;0;46;0;0;0;0;0;;
Paiçandu;De 50 a menos de 100 ha;29;2018;12;17;1035;983;28;1;12;0;16;1;0;0;0;1;;
Paiçandu;De 100 a menos de 200 ha;12;1650;12;0;1650;0;12;0;12;0;0;0;0;0;0;0;;
Paiçandu;De 200 a menos de 500 ha;15;4258;15;0;4258;0;15;0;15;0;0;0;0;0;0;0;;
Paiçandu;De 500 a menos de 1.000 ha;1;0;1;0;0;0;1;0;1;0;0;0;0;0;0;0;;
Paiçandu;De 1.000 a menos de 2.500 ha;0;0;0;0;0;0;0;0;0;0;0;0;0;0;0;0;;
Paiçandu;De 2.500 a menos de 10.000 ha;1;0;1;0;0;0;1;0;1;0;0;0;0;0;0;0;;
Paiçandu;De 10.000 ha e mais;0;0;0;0;0;0;0;0;0;0;0;0;0;0;0;0;;
Paiçandu;Produtor sem área;0;0;0;0;0;0;0;0;0;0;0;0;0;0;0;0;;
Palmas;Mais de 0 a menos de 0,1 ha;1;0;0;1;0;0;1;0;0;0;1;0;0;0;0;0;;
Palmas;De 0,1 a menos de 0,2 ha;0;0;0;0;0;0;0;0;0;0;0;0;0;0;0;0;;
Palmas;De 0,2 a menos de 0,5 ha;2;0;0;2;0;0;1;1;0;0;1;1;0;0;1;0;;
Palmas;De 0,5 a menos de 1 ha;49;27;17;32;9;18;5;44;3;14;2;30;8;1;14;6;;
Palmas;De 1 a menos de 2 ha;2;0;1;1;0;0;0;2;0;1;0;1;0;1;0;0;;
Palmas;De 2 a menos de 3 ha;7;17;2;5;0;0;0;7;0;2;0;5;0;1;0;4;;
Palmas;De 3 a menos de 4 ha;3;9;1;2;0;0;1;2;0;1;1;1;0;0;1;0;;
Palmas;De 4 a menos de 5 ha;9;44;2;7;0;0;1;8;0;2;1;6;1;1;1;4;;
Palmas;De 5 a menos de 10 ha;35;275;13;22;102;172;11;24;3;10;8;14;1;8;3;8;;
Palmas;De 10 a menos de 20 ha;190;3068;59;131;914;2154;89;101;21;38;68;63;1;26;6;37;;
Palmas;De 20 a menos de 50 ha;107;3035;39;68;1217;1817;65;42;23;16;42;26;0;13;0;14;;
Palmas;De 50 a menos de 100 ha;44;3074;19;25;1349;1725;17;27;7;12;10;15;0;11;1;8;;
Palmas;De 100 a menos de 200 ha;42;6137;41;1;0;0;22;20;22;19;0;1;1;11;0;1;;
Palmas;De 200 a menos de 500 ha;74;23406;70;4;22259;1147;35;39;35;35;0;4;3;19;0;3;;
Palmas;De 500 a menos de 1.000 ha;43;30023;43;0;30023;0;29;14;29;14;0;0;1;12;0;0;;
Palmas;De 1.000 a menos de 2.500 ha;31;47562;30;1;0;0;18;13;18;12;0;1;0;7;0;1;;
Palmas;De 2.500 a menos de 10.000 ha;2;0;2;0;0;0;0;2;0;2;0;0;0;1;0;0;;
Palmas;De 10.000 ha e mais;1;0;1;0;0;0;0;1;0;1;0;0;0;1;0;0;;
Palmas;Produtor sem área;2;0;0;2;0;0;0;0;0;0;0;0;0;0;0;0;;
Palmeira;Mais de 0 a menos de 0,1 ha;10;1;5;5;0;0;2;8;2;3;0;5;3;0;1;4;;
Palmeira;De 0,1 a menos de 0,2 ha;7;1;1;6;0;0;1;6;0;1;1;5;1;0;2;3;;
Palmeira;De 0,2 a menos de 0,5 ha;17;6;5;12;1;4;6;11;1;4;5;7;2;1;3;2;;
Palmeira;De 0,5 a menos de 1 ha;35;23;7;28;5;18;12;23;2;5;10;18;2;2;4;7;;
Palmeira;De 1 a menos de 2 ha;69;97;12;57;14;84;42;27;5;7;37;20;2;3;6;8;;
Palmeira;De 2 a menos de 3 ha;137;336;11;126;27;309;97;40;4;7;93;33;4;1;5;18;;
Palmeira;De 3 a menos de 4 ha;121;425;3;118;0;0;76;45;0;3;76;42;0;2;14;12;;
Palmeira;De 4 a menos de 5 ha;147;695;5;142;23;672;98;49;2;3;96;46;1;2;15;8;;
Palmeira;De 5 a menos de 10 ha;403;3019;22;381;153;2866;308;95;10;12;298;83;1;4;22;23;;
Palmeira;De 10 a menos de 20 ha;381;5516;15;366;222;5293;312;69;8;7;304;62;2;4;12;22;;
Palmeira;De 20 a menos de 50 ha;345;11181;18;327;568;10613;307;38;10;8;297;30;0;5;12;8;;
Palmeira;De 50 a menos de 100 ha;135;9842;94;41;7486;2356;124;11;90;4;34;7;0;2;1;3;;
Palmeira;De 100 a menos de 200 ha;73;9816;73;0;9816;0;64;9;64;9;0;0;1;2;0;0;;
Palmeira;De 200 a menos de 500 ha;66;20091;66;0;20091;0;62;4;62;4;0;0;0;2;0;0;;
Palmeira;De 500 a menos de 1.000 ha;16;11199;16;0;11199;0;15;1;15;1;0;0;0;0;0;0;;
Palmeira;De 1.000 a menos de 2.500 ha;17;24366;17;0;24366;0;15;2;15;2;0;0;0;2;0;0;;
Palmeira;De 2.500 a menos de 10.000 ha;5;0;5;0;0;0;4;1;4;1;0;0;0;1;0;0;;
Palmeira;De 10.000 ha e mais;0;0;0;0;0;0;0;0;0;0;0;0;0;0;0;0;;
Palmeira;Produtor sem área;3;0;1;2;0;0;0;2;0;1;0;1;0;1;0;1;;
Palmital;Mais de 0 a menos de 0,1 ha;2;0;0;2;0;0;2;0;0;0;2;0;0;0;0;0;;
Palmital;De 0,1 a menos de 0,2 ha;5;1;3;2;0;0;0;5;0;3;0;2;0;2;0;0;;
Palmital;De 0,2 a menos de 0,5 ha;15;6;3;12;1;5;0;15;0;3;0;12;1;1;1;6;;
Palmital;De 0,5 a menos de 1 ha;20;13;3;17;2;11;9;11;1;2;8;9;0;0;1;4;;
Palmital;De 1 a menos de 2 ha;42;57;8;34;10;47;8;34;1;7;7;27;1;5;2;14;;
Palmital;De 2 a menos de 3 ha;48;115;13;35;30;85;15;33;3;10;12;23;0;7;1;13;;
Palmital;De 3 a menos de 4 ha;60;205;12;48;41;165;17;43;4;8;13;35;3;3;2;20;;
Palmital;De 4 a menos de 5 ha;95;452;10;85;47;404;40;55;3;7;37;48;1;4;0;25;;
Palmital;De 5 a menos de 10 ha;240;1849;27;213;209;1640;112;128;5;22;107;106;1;15;2;71;;
Palmital;De 10 a menos de 20 ha;456;7006;39;417;583;6423;260;196;10;29;250;167;0;18;2;114;;
Palmital;De 20 a menos de 50 ha;413;12759;27;386;941;11818;246;167;10;17;236;150;0;15;5;95;;
Palmital;De 50 a menos de 100 ha;122;8708;38;84;3375;5333;71;51;18;20;53;31;1;18;0;25;;
Palmital;De 100 a menos de 200 ha;81;11329;81;0;11329;0;42;39;42;39;0;0;0;32;0;0;;
Palmital;De 200 a menos de 500 ha;68;21480;68;0;21480;0;29;39;29;39;0;0;1;34;0;0;;
Palmital;De 500 a menos de 1.000 ha;10;6299;10;0;6299;0;5;5;5;5;0;0;0;5;0;0;;
Palmital;De 1.000 a menos de 2.500 ha;3;0;3;0;0;0;1;2;1;2;0;0;0;2;0;0;;
Palmital;De 2.500 a menos de 10.000 ha;0;0;0;0;0;0;0;0;0;0;0;0;0;0;0;0;;
Palmital;De 10.000 ha e mais;0;0;0;0;0;0;0;0;0;0;0;0;0;0;0;0;;
Palmital;Produtor sem área;4;0;0;4;0;0;2;0;0;0;2;0;0;0;0;0;;
Palotina;Mais de 0 a menos de 0,1 ha;21;1;7;14;0;1;3;18;1;6;2;12;6;0;11;1;;
Palotina;De 0,1 a menos de 0,2 ha;15;2;5;10;0;0;1;14;0;5;1;9;5;0;7;2;;
Palotina;De 0,2 a menos de 0,5 ha;6;2;1;5;0;0;2;4;0;1;2;3;0;1;1;2;;
Palotina;De 0,5 a menos de 1 ha;85;46;12;73;6;39;8;77;0;12;8;65;2;10;11;54;;
Palotina;De 1 a menos de 2 ha;32;43;5;27;8;35;10;22;2;3;8;19;1;2;2;15;;
Palotina;De 2 a menos de 3 ha;56;136;10;46;24;112;20;36;2;8;18;28;2;6;3;22;;
Palotina;De 3 a menos de 4 ha;20;71;4;16;15;56;8;12;1;3;7;9;2;0;3;3;;
Palotina;De 4 a menos de 5 ha;51;240;7;44;33;207;29;22;4;3;25;19;0;3;5;11;;
Palotina;De 5 a menos de 10 ha;135;1047;17;118;120;927;100;35;8;9;92;26;0;7;1;14;;
Palotina;De 10 a menos de 20 ha;255;3586;24;231;321;3265;229;26;13;11;216;15;0;10;2;11;;
Palotina;De 20 a menos de 50 ha;277;8738;38;239;1222;7515;265;12;35;3;230;9;0;2;2;4;;
Palotina;De 50 a menos de 100 ha;159;11660;96;63;7891;3769;156;3;94;2;62;1;1;0;0;1;;
Palotina;De 100 a menos de 200 ha;78;10867;78;0;10867;0;77;1;77;1;0;0;0;1;0;0;;
Palotina;De 200 a menos de 500 ha;43;11743;43;0;11743;0;42;1;42;1;0;0;0;1;0;0;;
Palotina;De 500 a menos de 1.000 ha;10;6574;10;0;6574;0;10;0;10;0;0;0;0;0;0;0;;
Palotina;De 1.000 a menos de 2.500 ha;3;5639;3;0;5639;0;3;0;3;0;0;0;0;0;0;0;;
Palotina;De 2.500 a menos de 10.000 ha;1;0;1;0;0;0;1;0;1;0;0;0;0;0;0;0;;
Palotina;De 10.000 ha e mais;0;0;0;0;0;0;0;0;0;0;0;0;0;0;0;0;;
Palotina;Produtor sem área;2;0;1;1;0;0;0;0;0;0;0;0;0;0;0;0;;
Paraíso do Norte;Mais de 0 a menos de 0,1 ha;18;1;8;10;0;0;5;13;3;5;2;8;0;5;0;8;;
Paraíso do Norte;De 0,1 a menos de 0,2 ha;2;0;2;0;0;0;2;0;2;0;0;0;0;0;0;0;;
Paraíso do Norte;De 0,2 a menos de 0,5 ha;14;5;8;6;3;2;4;10;1;7;3;3;0;7;0;3;;
Paraíso do Norte;De 0,5 a menos de 1 ha;118;60;68;50;35;26;16;102;10;58;6;44;0;44;0;38;;
Paraíso do Norte;De 1 a menos de 2 ha;12;14;8;4;0;0;2;10;1;7;1;3;0;4;0;3;;
Paraíso do Norte;De 2 a menos de 3 ha;16;36;8;8;18;18;2;14;1;7;1;7;0;4;0;6;;
Paraíso do Norte;De 3 a menos de 4 ha;13;45;6;7;21;24;1;12;1;5;0;7;0;4;0;0;;
Paraíso do Norte;De 4 a menos de 5 ha;18;85;11;7;52;33;6;12;3;8;3;4;0;6;0;3;;
Paraíso do Norte;De 5 a menos de 10 ha;34;250;10;24;66;184;7;27;2;8;5;19;0;6;0;14;;
Paraíso do Norte;De 10 a menos de 20 ha;33;463;9;24;120;343;20;13;5;4;15;9;0;2;0;5;;
Paraíso do Norte;De 20 a menos de 50 ha;33;1102;5;28;154;948;25;8;3;2;22;6;0;2;0;2;;
Paraíso do Norte;De 50 a menos de 100 ha;19;1315;5;14;417;898;15;4;4;1;11;3;0;1;0;1;;
Paraíso do Norte;De 100 a menos de 200 ha;10;1518;10;0;1518;0;8;2;8;2;0;0;0;0;0;0;;
Paraíso do Norte;De 200 a menos de 500 ha;10;3052;10;0;3052;0;7;3;7;3;0;0;0;1;0;0;;
Paraíso do Norte;De 500 a menos de 1.000 ha;1;0;1;0;0;0;0;1;0;1;0;0;0;1;0;0;;
Paraíso do Norte;De 1.000 a menos de 2.500 ha;4;6488;4;0;6488;0;4;0;4;0;0;0;0;0;0;0;;
Paraíso do Norte;De 2.500 a menos de 10.000 ha;1;0;1;0;0;0;1;0;1;0;0;0;0;0;0;0;;
Paraíso do Norte;De 10.000 ha e mais;0;0;0;0;0;0;0;0;0;0;0;0;0;0;0;0;;
Paraíso do Norte;Produtor sem área;2;0;1;1;0;0;0;0;0;0;0;0;0;0;0;0;;
Paranacity;Mais de 0 a menos de 0,1 ha;1;0;0;1;0;0;0;1;0;0;0;1;0;0;0;1;;
Paranacity;De 0,1 a menos de 0,2 ha;0;0;0;0;0;0;0;0;0;0;0;0;0;0;0;0;;
Paranacity;De 0,2 a menos de 0,5 ha;0;0;0;0;0;0;0;0;0;0;0;0;0;0;0;0;;
Paranacity;De 0,5 a menos de 1 ha;55;28;26;29;13;15;1;54;1;25;0;29;0;19;0;25;;
Paranacity;De 1 a menos de 2 ha;6;7;1;5;0;0;0;6;0;1;0;5;0;1;0;4;;
Paranacity;De 2 a menos de 3 ha;13;31;3;10;7;23;2;11;1;2;1;9;0;1;0;7;;
Paranacity;De 3 a menos de 4 ha;5;18;1;4;0;0;2;3;1;0;1;3;0;0;1;0;;
Paranacity;De 4 a menos de 5 ha;10;48;6;4;29;19;1;9;1;5;0;4;0;3;0;0;;
Paranacity;De 5 a menos de 10 ha;27;195;7;20;53;143;9;18;3;4;6;14;0;2;2;7;;
Paranacity;De 10 a menos de 20 ha;55;851;9;46;135;715;10;45;1;8;9;37;0;7;2;16;;
Paranacity;De 20 a menos de 50 ha;42;1361;12;30;369;993;22;20;3;9;19;11;0;6;0;4;;
Paranacity;De 50 a menos de 100 ha;7;534;3;4;0;0;3;4;1;2;2;2;0;2;0;0;;
Paranacity;De 100 a menos de 200 ha;15;2012;15;0;2012;0;8;7;8;7;0;0;0;3;0;0;;
Paranacity;De 200 a menos de 500 ha;4;1239;4;0;1239;0;4;0;4;0;0;0;0;0;0;0;;
Paranacity;De 500 a menos de 1.000 ha;4;2950;4;0;2950;0;1;3;1;3;0;0;1;0;0;0;;
Paranacity;De 1.000 a menos de 2.500 ha;0;0;0;0;0;0;0;0;0;0;0;0;0;0;0;0;;
Paranacity;De 2.500 a menos de 10.000 ha;1;0;1;0;0;0;1;0;1;0;0;0;0;0;0;0;;
Paranacity;De 10.000 ha e mais;1;0;1;0;0;0;1;0;1;0;0;0;0;0;0;0;;
Paranacity;Produtor sem área;0;0;0;0;0;0;0;0;0;0;0;0;0;0;0;0;;
Paranaguá;Mais de 0 a menos de 0,1 ha;5;0;3;2;0;0;0;5;0;3;0;2;0;3;0;1;;
Paranaguá;De 0,1 a menos de 0,2 ha;1;0;1;0;0;0;0;1;0;1;0;0;0;1;0;0;;
Paranaguá;De 0,2 a menos de 0,5 ha;5;1;2;3;0;0;0;5;0;2;0;3;0;2;0;3;;
Paranaguá;De 0,5 a menos de 1 ha;8;5;1;7;0;0;0;8;0;1;0;7;0;1;1;6;;
Paranaguá;De 1 a menos de 2 ha;14;18;3;11;0;0;3;11;0;3;3;8;0;2;1;6;;
Paranaguá;De 2 a menos de 3 ha;9;21;5;4;12;10;2;7;1;4;1;3;0;2;1;2;;
Paranaguá;De 3 a menos de 4 ha;6;20;2;4;0;0;2;4;1;1;1;3;0;1;0;1;;
Paranaguá;De 4 a menos de 5 ha;6;28;2;4;0;0;1;5;1;1;0;4;0;1;0;3;;
Paranaguá;De 5 a menos de 10 ha;24;172;5;19;38;134;6;18;0;5;6;13;0;5;0;9;;
Paranaguá;De 10 a menos de 20 ha;21;294;6;15;78;216;7;14;2;4;5;10;0;3;1;4;;
Paranaguá;De 20 a menos de 50 ha;28;856;10;18;310;546;4;24;1;9;3;15;0;7;1;11;;
Paranaguá;De 50 a menos de 100 ha;5;310;2;3;0;0;2;3;1;1;1;2;0;1;0;1;;
Paranaguá;De 100 a menos de 200 ha;4;0;4;0;0;0;0;4;0;4;0;0;0;4;0;0;;
Paranaguá;De 200 a menos de 500 ha;1;0;1;0;0;0;0;1;0;1;0;0;0;0;0;0;;
Paranaguá;De 500 a menos de 1.000 ha;0;0;0;0;0;0;0;0;0;0;0;0;0;0;0;0;;
Paranaguá;De 1.000 a menos de 2.500 ha;0;0;0;0;0;0;0;0;0;0;0;0;0;0;0;0;;
Paranaguá;De 2.500 a menos de 10.000 ha;0;0;0;0;0;0;0;0;0;0;0;0;0;0;0;0;;
Paranaguá;De 10.000 ha e mais;0;0;0;0;0;0;0;0;0;0;0;0;0;0;0;0;;
Paranaguá;Produtor sem área;0;0;0;0;0;0;0;0;0;0;0;0;0;0;0;0;;
Paranapoema;Mais de 0 a menos de 0,1 ha;0;0;0;0;0;0;0;0;0;0;0;0;0;0;0;0;;
Paranapoema;De 0,1 a menos de 0,2 ha;0;0;0;0;0;0;0;0;0;0;0;0;0;0;0;0;;
Paranapoema;De 0,2 a menos de 0,5 ha;0;0;0;0;0;0;0;0;0;0;0;0;0;0;0;0;;
Paranapoema;De 0,5 a menos de 1 ha;3;0;2;1;0;0;0;3;0;2;0;1;0;2;0;1;;
Paranapoema;De 1 a menos de 2 ha;1;0;0;1;0;0;0;1;0;0;0;1;0;0;0;1;;
Paranapoema;De 2 a menos de 3 ha;1;0;0;1;0;0;0;1;0;0;0;1;0;0;0;0;;
Paranapoema;De 3 a menos de 4 ha;0;0;0;0;0;0;0;0;0;0;0;0;0;0;0;0;;
Paranapoema;De 4 a menos de 5 ha;0;0;0;0;0;0;0;0;0;0;0;0;0;0;0;0;;
Paranapoema;De 5 a menos de 10 ha;1;0;0;1;0;0;0;1;0;0;0;1;0;0;0;1;;
Paranapoema;De 10 a menos de 20 ha;0;0;0;0;0;0;0;0;0;0;0;0;0;0;0;0;;
Paranapoema;De 20 a menos de 50 ha;2;0;0;2;0;0;1;1;0;0;1;1;0;0;0;1;;
Paranapoema;De 50 a menos de 100 ha;5;350;0;5;0;350;4;1;0;0;4;1;0;0;0;1;;
Paranapoema;De 100 a menos de 200 ha;1;0;1;0;0;0;0;1;0;1;0;0;0;1;0;0;;
Paranapoema;De 200 a menos de 500 ha;4;1375;4;0;1375;0;2;2;2;2;0;0;0;2;0;0;;
Paranapoema;De 500 a menos de 1.000 ha;3;2193;3;0;2193;0;3;0;3;0;0;0;0;0;0;0;;
Paranapoema;De 1.000 a menos de 2.500 ha;2;0;2;0;0;0;2;0;2;0;0;0;0;0;0;0;;
Paranapoema;De 2.500 a menos de 10.000 ha;2;0;2;0;0;0;2;0;2;0;0;0;0;0;0;0;;
Paranapoema;De 10.000 ha e mais;0;0;0;0;0;0;0;0;0;0;0;0;0;0;0;0;;
Paranapoema;Produtor sem área;0;0;0;0;0;0;0;0;0;0;0;0;0;0;0;0;;
Paranavaí;Mais de 0 a menos de 0,1 ha;13;1;5;8;0;0;0;13;0;5;0;8;1;4;0;8;;
Paranavaí;De 0,1 a menos de 0,2 ha;5;1;4;1;0;0;0;5;0;4;0;1;1;3;0;1;;
Paranavaí;De 0,2 a menos de 0,5 ha;10;3;4;6;0;0;3;7;2;2;1;5;0;2;0;4;;
Paranavaí;De 0,5 a menos de 1 ha;189;100;99;90;52;48;30;159;16;83;14;76;2;67;9;48;;
Paranavaí;De 1 a menos de 2 ha;63;78;20;43;27;51;10;53;4;16;6;37;2;11;4;27;;
Paranavaí;De 2 a menos de 3 ha;71;177;31;40;79;98;16;55;4;27;12;28;2;16;0;19;;
Paranavaí;De 3 a menos de 4 ha;39;134;17;22;58;76;6;33;1;16;5;17;0;12;0;13;;
Paranavaí;De 4 a menos de 5 ha;41;196;10;31;48;148;8;33;3;7;5;26;2;4;2;18;;
Paranavaí;De 5 a menos de 10 ha;108;848;27;81;209;638;35;73;9;18;26;55;1;12;4;37;;
Paranavaí;De 10 a menos de 20 ha;197;2835;67;130;919;1917;60;137;21;46;39;91;3;34;13;60;;
Paranavaí;De 20 a menos de 50 ha;284;9342;60;224;2071;7270;93;191;21;39;72;152;4;25;18;99;;
Paranavaí;De 50 a menos de 100 ha;139;9990;65;74;5202;4788;44;95;25;40;19;55;5;25;11;23;;
Paranavaí;De 100 a menos de 200 ha;73;10018;73;0;10018;0;26;47;26;47;0;0;2;31;0;0;;
Paranavaí;De 200 a menos de 500 ha;56;18550;56;0;18550;0;28;28;28;28;0;0;1;17;0;0;;
Paranavaí;De 500 a menos de 1.000 ha;26;17407;26;0;17407;0;13;13;13;13;0;0;0;7;0;0;;
Paranavaí;De 1.000 a menos de 2.500 ha;5;6244;5;0;6244;0;4;1;4;1;0;0;0;1;0;0;;
Paranavaí;De 2.500 a menos de 10.000 ha;4;15216;4;0;15216;0;4;0;4;0;0;0;0;0;0;0;;
Paranavaí;De 10.000 ha e mais;1;0;1;0;0;0;1;0;1;0;0;0;0;0;0;0;;
Paranavaí;Produtor sem área;4;0;4;0;0;0;0;1;0;1;0;0;0;1;0;0;;
Pato Bragado;Mais de 0 a menos de 0,1 ha;1;0;1;0;0;0;1;0;1;0;0;0;0;0;0;0;;
Pato Bragado;De 0,1 a menos de 0,2 ha;2;0;0;2;0;0;0;2;0;0;0;2;0;0;0;2;;
Pato Bragado;De 0,2 a menos de 0,5 ha;4;0;0;4;0;0;0;4;0;0;0;4;0;0;2;1;;
Pato Bragado;De 0,5 a menos de 1 ha;7;4;1;6;0;0;1;6;0;1;1;5;0;0;3;2;;
Pato Bragado;De 1 a menos de 2 ha;23;30;7;16;8;22;8;15;2;5;6;10;0;4;5;0;;
Pato Bragado;De 2 a menos de 3 ha;22;54;4;18;10;44;12;10;2;2;10;8;1;1;2;5;;
Pato Bragado;De 3 a menos de 4 ha;21;71;2;19;0;0;8;13;0;2;8;11;0;1;0;7;;
Pato Bragado;De 4 a menos de 5 ha;16;76;1;15;0;0;10;6;0;1;10;5;0;0;1;3;;
Pato Bragado;De 5 a menos de 10 ha;58;452;5;53;38;414;45;13;2;3;43;10;0;2;1;3;;
Pato Bragado;De 10 a menos de 20 ha;75;1003;6;69;82;921;66;9;4;2;62;7;0;1;2;1;;
Pato Bragado;De 20 a menos de 50 ha;57;1662;10;47;294;1368;56;1;10;0;46;1;0;0;0;1;;
Pato Bragado;De 50 a menos de 100 ha;27;1764;12;15;901;863;26;1;11;1;15;0;0;0;0;0;;
Pato Bragado;De 100 a menos de 200 ha;4;704;4;0;704;0;4;0;4;0;0;0;0;0;0;0;;
Pato Bragado;De 200 a menos de 500 ha;4;1088;4;0;1088;0;4;0;4;0;0;0;0;0;0;0;;
Pato Bragado;De 500 a menos de 1.000 ha;0;0;0;0;0;0;0;0;0;0;0;0;0;0;0;0;;
Pato Bragado;De 1.000 a menos de 2.500 ha;0;0;0;0;0;0;0;0;0;0;0;0;0;0;0;0;;
Pato Bragado;De 2.500 a menos de 10.000 ha;0;0;0;0;0;0;0;0;0;0;0;0;0;0;0;0;;
Pato Bragado;De 10.000 ha e mais;0;0;0;0;0;0;0;0;0;0;0;0;0;0;0;0;;
Pato Bragado;Produtor sem área;0;0;0;0;0;0;0;0;0;0;0;0;0;0;0;0;;
Pato Branco;Mais de 0 a menos de 0,1 ha;3;0;1;2;0;0;2;1;0;1;2;0;0;1;0;0;;
Pato Branco;De 0,1 a menos de 0,2 ha;2;0;0;2;0;0;0;2;0;0;0;2;0;0;1;1;;
Pato Branco;De 0,2 a menos de 0,5 ha;7;2;2;5;0;0;5;2;2;0;3;2;0;0;0;1;;
Pato Branco;De 0,5 a menos de 1 ha;14;9;6;8;4;5;8;6;4;2;4;4;0;2;1;2;;
Pato Branco;De 1 a menos de 2 ha;33;45;11;22;15;30;20;13;6;5;14;8;2;3;1;6;;
Pato Branco;De 2 a menos de 3 ha;60;145;14;46;34;111;36;24;9;5;27;19;1;3;6;9;;
Pato Branco;De 3 a menos de 4 ha;47;167;14;33;48;118;31;16;8;6;23;10;0;6;0;7;;
Pato Branco;De 4 a menos de 5 ha;66;314;10;56;47;267;50;16;8;2;42;14;1;0;4;6;;
Pato Branco;De 5 a menos de 10 ha;171;1275;19;152;142;1133;130;41;14;5;116;36;0;3;6;27;;
Pato Branco;De 10 a menos de 20 ha;246;3553;20;226;292;3261;219;27;15;5;204;22;0;3;3;12;;
Pato Branco;De 20 a menos de 50 ha;249;7610;15;234;480;7129;237;12;11;4;226;8;1;3;1;6;;
Pato Branco;De 50 a menos de 100 ha;121;8634;65;56;5389;3245;120;1;65;0;55;1;0;0;0;1;;
Pato Branco;De 100 a menos de 200 ha;56;7941;56;0;7941;0;55;1;55;1;0;0;0;1;0;0;;
Pato Branco;De 200 a menos de 500 ha;35;10055;35;0;10055;0;32;3;32;3;0;0;0;3;0;0;;
Pato Branco;De 500 a menos de 1.000 ha;6;4352;6;0;4352;0;6;0;6;0;0;0;0;0;0;0;;
Pato Branco;De 1.000 a menos de 2.500 ha;0;0;0;0;0;0;0;0;0;0;0;0;0;0;0;0;;
Pato Branco;De 2.500 a menos de 10.000 ha;0;0;0;0;0;0;0;0;0;0;0;0;0;0;0;0;;
Pato Branco;De 10.000 ha e mais;0;0;0;0;0;0;0;0;0;0;0;0;0;0;0;0;;
Pato Branco;Produtor sem área;0;0;0;0;0;0;0;0;0;0;0;0;0;0;0;0;;
Paula Freitas;Mais de 0 a menos de 0,1 ha;2;0;1;1;0;0;1;1;0;1;1;0;0;0;0;0;;
Paula Freitas;De 0,1 a menos de 0,2 ha;0;0;0;0;0;0;0;0;0;0;0;0;0;0;0;0;;
Paula Freitas;De 0,2 a menos de 0,5 ha;3;1;0;3;0;1;1;2;0;0;1;2;0;0;1;0;;
Paula Freitas;De 0,5 a menos de 1 ha;3;0;1;2;0;0;1;2;0;1;1;1;0;1;1;0;;
Paula Freitas;De 1 a menos de 2 ha;15;21;1;14;0;0;10;5;1;0;9;5;0;0;0;4;;
Paula Freitas;De 2 a menos de 3 ha;21;50;5;16;12;38;14;7;3;2;11;5;0;1;0;4;;
Paula Freitas;De 3 a menos de 4 ha;16;56;4;12;0;0;11;5;1;3;10;2;1;1;1;0;;
Paula Freitas;De 4 a menos de 5 ha;17;80;2;15;0;0;15;2;2;0;13;2;0;0;0;1;;
Paula Freitas;De 5 a menos de 10 ha;81;613;5;76;40;574;63;18;3;2;60;16;0;0;2;9;;
Paula Freitas;De 10 a menos de 20 ha;115;1707;8;107;109;1597;103;12;4;4;99;8;0;3;0;5;;
Paula Freitas;De 20 a menos de 50 ha;110;3228;4;106;119;3109;102;8;3;1;99;7;0;1;0;2;;
Paula Freitas;De 50 a menos de 100 ha;47;3283;8;39;708;2575;42;5;7;1;35;4;0;1;1;1;;
Paula Freitas;De 100 a menos de 200 ha;29;3905;29;0;3905;0;29;0;29;0;0;0;0;0;0;0;;
Paula Freitas;De 200 a menos de 500 ha;13;4133;13;0;4133;0;12;1;12;1;0;0;0;1;0;0;;
Paula Freitas;De 500 a menos de 1.000 ha;9;5446;9;0;5446;0;7;2;7;2;0;0;0;2;0;0;;
Paula Freitas;De 1.000 a menos de 2.500 ha;4;5720;4;0;5720;0;4;0;4;0;0;0;0;0;0;0;;
Paula Freitas;De 2.500 a menos de 10.000 ha;0;0;0;0;0;0;0;0;0;0;0;0;0;0;0;0;;
Paula Freitas;De 10.000 ha e mais;0;0;0;0;0;0;0;0;0;0;0;0;0;0;0;0;;
Paula Freitas;Produtor sem área;0;0;0;0;0;0;0;0;0;0;0;0;0;0;0;0;;
Paulo Frontin;Mais de 0 a menos de 0,1 ha;0;0;0;0;0;0;0;0;0;0;0;0;0;0;0;0;;
Paulo Frontin;De 0,1 a menos de 0,2 ha;0;0;0;0;0;0;0;0;0;0;0;0;0;0;0;0;;
Paulo Frontin;De 0,2 a menos de 0,5 ha;5;2;3;2;0;0;1;4;1;2;0;2;0;0;0;2;;
Paulo Frontin;De 0,5 a menos de 1 ha;8;6;3;5;0;0;4;4;1;2;3;2;0;2;0;2;;
Paulo Frontin;De 1 a menos de 2 ha;62;83;15;47;20;64;33;29;3;12;30;17;0;12;0;17;;
Paulo Frontin;De 2 a menos de 3 ha;69;171;20;49;49;122;42;27;6;14;36;13;1;11;0;12;;
Paulo Frontin;De 3 a menos de 4 ha;54;193;5;49;18;175;39;15;4;1;35;14;0;1;0;14;;
Paulo Frontin;De 4 a menos de 5 ha;87;417;14;73;68;350;65;22;8;6;57;16;0;4;0;15;;
Paulo Frontin;De 5 a menos de 10 ha;253;2014;15;238;114;1900;207;46;9;6;198;40;0;6;0;37;;
Paulo Frontin;De 10 a menos de 20 ha;324;4896;14;310;225;4671;290;34;8;6;282;28;0;5;0;24;;
Paulo Frontin;De 20 a menos de 50 ha;233;7104;9;224;279;6825;217;16;4;5;213;11;0;5;0;9;;
Paulo Frontin;De 50 a menos de 100 ha;40;2710;1;39;0;0;37;3;1;0;36;3;0;0;0;2;;
Paulo Frontin;De 100 a menos de 200 ha;22;2923;22;0;2923;0;20;2;20;2;0;0;0;2;0;0;;
Paulo Frontin;De 200 a menos de 500 ha;8;2452;8;0;2452;0;8;0;8;0;0;0;0;0;0;0;;
Paulo Frontin;De 500 a menos de 1.000 ha;1;0;1;0;0;0;1;0;1;0;0;0;0;0;0;0;;
Paulo Frontin;De 1.000 a menos de 2.500 ha;2;0;2;0;0;0;2;0;2;0;0;0;0;0;0;0;;
Paulo Frontin;De 2.500 a menos de 10.000 ha;0;0;0;0;0;0;0;0;0;0;0;0;0;0;0;0;;
Paulo Frontin;De 10.000 ha e mais;0;0;0;0;0;0;0;0;0;0;0;0;0;0;0;0;;
Paulo Frontin;Produtor sem área;0;0;0;0;0;0;0;0;0;0;0;0;0;0;0;0;;
Peabiru;Mais de 0 a menos de 0,1 ha;0;0;0;0;0;0;0;0;0;0;0;0;0;0;0;0;;
Peabiru;De 0,1 a menos de 0,2 ha;0;0;0;0;0;0;0;0;0;0;0;0;0;0;0;0;;
Peabiru;De 0,2 a menos de 0,5 ha;1;0;1;0;0;0;1;0;1;0;0;0;0;0;0;0;;
Peabiru;De 0,5 a menos de 1 ha;12;7;2;10;0;0;1;11;0;2;1;9;1;1;6;0;;
Peabiru;De 1 a menos de 2 ha;10;13;2;8;0;0;3;7;1;1;2;6;1;0;1;4;;
Peabiru;De 2 a menos de 3 ha;19;46;5;14;12;34;7;12;1;4;6;8;1;3;3;4;;
Peabiru;De 3 a menos de 4 ha;24;84;3;21;10;74;11;13;0;3;11;10;2;1;2;5;;
Peabiru;De 4 a menos de 5 ha;24;114;4;20;19;94;11;13;3;1;8;12;1;0;3;7;;
Peabiru;De 5 a menos de 10 ha;43;304;9;34;61;243;28;15;6;3;22;12;2;0;2;8;;
Peabiru;De 10 a menos de 20 ha;150;2155;13;137;172;1984;124;26;7;6;117;20;4;1;7;7;;
Peabiru;De 20 a menos de 50 ha;104;3273;6;98;222;3050;90;14;4;2;86;12;0;2;1;5;;
Peabiru;De 50 a menos de 100 ha;52;3709;20;32;1641;2068;49;3;18;2;31;1;0;0;0;1;;
Peabiru;De 100 a menos de 200 ha;48;6770;48;0;6770;0;45;3;45;3;0;0;1;2;0;0;;
Peabiru;De 200 a menos de 500 ha;45;13129;45;0;13129;0;44;1;44;1;0;0;0;1;0;0;;
Peabiru;De 500 a menos de 1.000 ha;9;6155;9;0;6155;0;8;1;8;1;0;0;0;0;0;0;;
Peabiru;De 1.000 a menos de 2.500 ha;3;0;3;0;0;0;3;0;3;0;0;0;0;0;0;0;;
Peabiru;De 2.500 a menos de 10.000 ha;1;0;1;0;0;0;1;0;1;0;0;0;0;0;0;0;;
Peabiru;De 10.000 ha e mais;0;0;0;0;0;0;0;0;0;0;0;0;0;0;0;0;;
Peabiru;Produtor sem área;0;0;0;0;0;0;0;0;0;0;0;0;0;0;0;0;;
Perobal;Mais de 0 a menos de 0,1 ha;53;2;16;37;1;1;7;46;0;16;7;30;2;10;5;23;;
Perobal;De 0,1 a menos de 0,2 ha;11;1;4;7;1;1;1;10;0;4;1;6;1;2;0;5;;
Perobal;De 0,2 a menos de 0,5 ha;10;3;4;6;0;0;1;9;0;4;1;5;0;4;0;5;;
Perobal;De 0,5 a menos de 1 ha;47;25;15;32;8;17;6;41;2;13;4;28;1;10;0;24;;
Perobal;De 1 a menos de 2 ha;17;25;10;7;15;10;3;14;1;9;2;5;0;7;0;4;;
Perobal;De 2 a menos de 3 ha;39;95;13;26;32;63;7;32;2;11;5;21;1;6;0;12;;
Perobal;De 3 a menos de 4 ha;26;92;6;20;21;70;2;24;1;5;1;19;0;5;1;12;;
Perobal;De 4 a menos de 5 ha;37;177;6;31;28;149;13;24;1;5;12;19;0;5;4;11;;
Perobal;De 5 a menos de 10 ha;87;668;17;70;133;535;33;54;7;10;26;44;0;8;0;25;;
Perobal;De 10 a menos de 20 ha;126;1784;17;109;222;1562;38;88;5;12;33;76;2;5;5;37;;
Perobal;De 20 a menos de 50 ha;87;2659;14;73;420;2239;32;55;1;13;31;42;0;7;3;23;;
Perobal;De 50 a menos de 100 ha;37;2677;15;22;1268;1409;24;13;11;4;13;9;1;2;1;5;;
Perobal;De 100 a menos de 200 ha;34;5010;34;0;5010;0;22;12;22;12;0;0;1;6;0;0;;
Perobal;De 200 a menos de 500 ha;22;6871;22;0;6871;0;20;2;20;2;0;0;0;1;0;0;;
Perobal;De 500 a menos de 1.000 ha;13;9005;13;0;9005;0;12;1;12;1;0;0;0;0;0;0;;
Perobal;De 1.000 a menos de 2.500 ha;4;0;4;0;0;0;1;3;1;3;0;0;0;1;0;0;;
Perobal;De 2.500 a menos de 10.000 ha;1;0;1;0;0;0;1;0;1;0;0;0;0;0;0;0;;
Perobal;De 10.000 ha e mais;0;0;0;0;0;0;0;0;0;0;0;0;0;0;0;0;;
Perobal;Produtor sem área;7;0;5;2;0;0;1;2;0;2;1;0;0;2;0;0;;
Pérola;Mais de 0 a menos de 0,1 ha;1;0;0;1;0;0;0;1;0;0;0;1;0;0;0;1;;
Pérola;De 0,1 a menos de 0,2 ha;0;0;0;0;0;0;0;0;0;0;0;0;0;0;0;0;;
Pérola;De 0,2 a menos de 0,5 ha;1;0;0;1;0;0;1;0;0;0;1;0;0;0;0;0;;
Pérola;De 0,5 a menos de 1 ha;23;15;8;15;5;10;10;13;3;5;7;8;1;2;3;4;;
Pérola;De 1 a menos de 2 ha;21;30;4;17;0;0;10;11;2;2;8;9;0;1;1;5;;
Pérola;De 2 a menos de 3 ha;44;110;8;36;21;89;21;23;4;4;17;19;0;2;4;9;;
Pérola;De 3 a menos de 4 ha;14;0;0;14;0;0;8;6;0;0;8;6;0;0;2;2;;
Pérola;De 4 a menos de 5 ha;32;150;6;26;27;123;13;19;2;4;11;15;0;3;1;6;;
Pérola;De 5 a menos de 10 ha;99;715;15;84;104;610;57;42;8;7;49;35;1;1;3;15;;
Pérola;De 10 a menos de 20 ha;116;1634;12;104;163;1471;81;35;8;4;73;31;0;2;4;10;;
Pérola;De 20 a menos de 50 ha;147;4555;13;134;370;4186;91;56;5;8;86;48;0;6;1;25;;
Pérola;De 50 a menos de 100 ha;38;2634;10;28;865;1769;21;17;5;5;16;12;0;3;0;4;;
Pérola;De 100 a menos de 200 ha;23;3123;23;0;3123;0;12;11;12;11;0;0;0;6;0;0;;
Pérola;De 200 a menos de 500 ha;17;4594;17;0;4594;0;9;8;9;8;0;0;0;3;0;0;;
Pérola;De 500 a menos de 1.000 ha;5;0;5;0;0;0;4;1;4;1;0;0;0;0;0;0;;
Pérola;De 1.000 a menos de 2.500 ha;0;0;0;0;0;0;0;0;0;0;0;0;0;0;0;0;;
Pérola;De 2.500 a menos de 10.000 ha;0;0;0;0;0;0;0;0;0;0;0;0;0;0;0;0;;
Pérola;De 10.000 ha e mais;0;0;0;0;0;0;0;0;0;0;0;0;0;0;0;0;;
Pérola;Produtor sem área;0;0;0;0;0;0;0;0;0;0;0;0;0;0;0;0;;
Pérola d'Oeste;Mais de 0 a menos de 0,1 ha;10;1;6;4;0;0;2;8;0;6;2;2;2;3;1;1;;
Pérola d'Oeste;De 0,1 a menos de 0,2 ha;31;4;11;20;1;2;8;23;2;9;6;14;6;2;10;3;;
Pérola d'Oeste;De 0,2 a menos de 0,5 ha;33;9;15;18;4;5;19;14;7;8;12;6;5;0;4;2;;
Pérola d'Oeste;De 0,5 a menos de 1 ha;14;8;4;10;0;0;12;2;4;0;8;2;0;0;0;2;;
Pérola d'Oeste;De 1 a menos de 2 ha;40;48;14;26;16;31;21;19;8;6;13;13;1;5;5;7;;
Pérola d'Oeste;De 2 a menos de 3 ha;60;141;11;49;26;115;45;15;10;1;35;14;1;0;2;9;;
Pérola d'Oeste;De 3 a menos de 4 ha;56;186;8;48;26;160;46;10;5;3;41;7;0;1;2;3;;
Pérola d'Oeste;De 4 a menos de 5 ha;53;237;7;46;32;206;38;15;3;4;35;11;0;4;1;6;;
Pérola d'Oeste;De 5 a menos de 10 ha;256;1831;18;238;130;1701;232;24;13;5;219;19;1;4;3;11;;
Pérola d'Oeste;De 10 a menos de 20 ha;249;3487;13;236;169;3318;234;15;10;3;224;12;0;3;1;6;;
Pérola d'Oeste;De 20 a menos de 50 ha;202;6053;10;192;321;5732;195;7;7;3;188;4;0;3;0;3;;
Pérola d'Oeste;De 50 a menos de 100 ha;64;4206;11;53;955;3251;63;1;11;0;52;1;0;0;0;1;;
Pérola d'Oeste;De 100 a menos de 200 ha;6;818;6;0;818;0;6;0;6;0;0;0;0;0;0;0;;
Pérola d'Oeste;De 200 a menos de 500 ha;5;1409;5;0;1409;0;5;0;5;0;0;0;0;0;0;0;;
Pérola d'Oeste;De 500 a menos de 1.000 ha;0;0;0;0;0;0;0;0;0;0;0;0;0;0;0;0;;
Pérola d'Oeste;De 1.000 a menos de 2.500 ha;0;0;0;0;0;0;0;0;0;0;0;0;0;0;0;0;;
Pérola d'Oeste;De 2.500 a menos de 10.000 ha;0;0;0;0;0;0;0;0;0;0;0;0;0;0;0;0;;
Pérola d'Oeste;De 10.000 ha e mais;0;0;0;0;0;0;0;0;0;0;0;0;0;0;0;0;;
Pérola d'Oeste;Produtor sem área;0;0;0;0;0;0;0;0;0;0;0;0;0;0;0;0;;
Piên;Mais de 0 a menos de 0,1 ha;7;0;1;6;0;0;3;4;0;1;3;3;0;1;0;2;;
Piên;De 0,1 a menos de 0,2 ha;11;2;3;8;0;1;0;11;0;3;0;8;0;2;0;5;;
Piên;De 0,2 a menos de 0,5 ha;15;5;4;11;1;4;6;9;0;4;6;5;0;4;0;4;;
Piên;De 0,5 a menos de 1 ha;15;11;1;14;0;0;10;5;1;0;9;5;0;0;0;3;;
Piên;De 1 a menos de 2 ha;103;150;7;96;11;140;79;24;3;4;76;20;0;3;1;11;;
Piên;De 2 a menos de 3 ha;108;254;4;104;11;243;93;15;2;2;91;13;0;1;2;8;;
Piên;De 3 a menos de 4 ha;89;295;5;84;17;278;81;8;4;1;77;7;0;0;0;3;;
Piên;De 4 a menos de 5 ha;98;447;2;96;0;0;87;11;2;0;85;11;0;0;0;8;;
Piên;De 5 a menos de 10 ha;319;2330;7;312;48;2283;291;28;5;2;286;26;0;2;1;20;;
Piên;De 10 a menos de 20 ha;261;3635;6;255;95;3540;242;19;6;0;236;19;0;0;1;12;;
Piên;De 20 a menos de 50 ha;148;4285;6;142;168;4116;136;12;6;0;130;12;0;0;0;9;;
Piên;De 50 a menos de 100 ha;26;1638;3;23;248;1390;22;4;1;2;21;2;0;2;0;2;;
Piên;De 100 a menos de 200 ha;6;748;6;0;748;0;5;1;5;1;0;0;0;1;0;0;;
Piên;De 200 a menos de 500 ha;5;0;5;0;0;0;2;3;2;3;0;0;0;2;0;0;;
Piên;De 500 a menos de 1.000 ha;0;0;0;0;0;0;0;0;0;0;0;0;0;0;0;0;;
Piên;De 1.000 a menos de 2.500 ha;2;0;2;0;0;0;1;1;1;1;0;0;0;1;0;0;;
Piên;De 2.500 a menos de 10.000 ha;0;0;0;0;0;0;0;0;0;0;0;0;0;0;0;0;;
Piên;De 10.000 ha e mais;0;0;0;0;0;0;0;0;0;0;0;0;0;0;0;0;;
Piên;Produtor sem área;0;0;0;0;0;0;0;0;0;0;0;0;0;0;0;0;;
Pinhais;Mais de 0 a menos de 0,1 ha;0;0;0;0;0;0;0;0;0;0;0;0;0;0;0;0;;
Pinhais;De 0,1 a menos de 0,2 ha;1;0;1;0;0;0;0;1;0;1;0;0;0;1;0;0;;
Pinhais;De 0,2 a menos de 0,5 ha;3;1;0;3;0;1;0;3;0;0;0;3;0;0;0;3;;
Pinhais;De 0,5 a menos de 1 ha;3;2;2;1;0;0;0;3;0;2;0;1;0;2;0;1;;
Pinhais;De 1 a menos de 2 ha;6;8;1;5;0;0;0;6;0;1;0;5;0;1;0;5;;
Pinhais;De 2 a menos de 3 ha;5;12;3;2;0;0;0;5;0;3;0;2;0;3;0;2;;
Pinhais;De 3 a menos de 4 ha;3;10;1;2;0;0;0;3;0;1;0;2;0;1;0;1;;
Pinhais;De 4 a menos de 5 ha;0;0;0;0;0;0;0;0;0;0;0;0;0;0;0;0;;
Pinhais;De 5 a menos de 10 ha;4;29;4;0;29;0;0;4;0;4;0;0;0;1;0;0;;
Pinhais;De 10 a menos de 20 ha;7;110;4;3;0;0;0;7;0;4;0;3;0;1;0;2;;
Pinhais;De 20 a menos de 50 ha;0;0;0;0;0;0;0;0;0;0;0;0;0;0;0;0;;
Pinhais;De 50 a menos de 100 ha;3;189;3;0;189;0;1;2;1;2;0;0;0;1;0;0;;
Pinhais;De 100 a menos de 200 ha;1;0;1;0;0;0;0;1;0;1;0;0;1;0;0;0;;
Pinhais;De 200 a menos de 500 ha;1;0;1;0;0;0;0;1;0;1;0;0;0;0;0;0;;
Pinhais;De 500 a menos de 1.000 ha;0;0;0;0;0;0;0;0;0;0;0;0;0;0;0;0;;
Pinhais;De 1.000 a menos de 2.500 ha;0;0;0;0;0;0;0;0;0;0;0;0;0;0;0;0;;
Pinhais;De 2.500 a menos de 10.000 ha;0;0;0;0;0;0;0;0;0;0;0;0;0;0;0;0;;
Pinhais;De 10.000 ha e mais;0;0;0;0;0;0;0;0;0;0;0;0;0;0;0;0;;
Pinhais;Produtor sem área;0;0;0;0;0;0;0;0;0;0;0;0;0;0;0;0;;
Pinhalão;Mais de 0 a menos de 0,1 ha;0;0;0;0;0;0;0;0;0;0;0;0;0;0;0;0;;
Pinhalão;De 0,1 a menos de 0,2 ha;1;0;1;0;0;0;0;1;0;1;0;0;0;0;0;0;;
Pinhalão;De 0,2 a menos de 0,5 ha;3;0;0;3;0;0;2;1;0;0;2;1;0;0;0;0;;
Pinhalão;De 0,5 a menos de 1 ha;8;5;2;6;0;0;5;3;2;0;3;3;0;0;1;0;;
Pinhalão;De 1 a menos de 2 ha;39;53;7;32;9;44;27;12;5;2;22;10;0;1;2;4;;
Pinhalão;De 2 a menos de 3 ha;41;99;8;33;20;80;34;7;5;3;29;4;0;0;0;1;;
Pinhalão;De 3 a menos de 4 ha;72;244;9;63;31;213;59;13;7;2;52;11;0;1;0;5;;
Pinhalão;De 4 a menos de 5 ha;72;341;8;64;38;304;52;20;4;4;48;16;1;2;0;5;;
Pinhalão;De 5 a menos de 10 ha;168;1212;11;157;84;1128;126;42;8;3;118;39;0;0;0;14;;
Pinhalão;De 10 a menos de 20 ha;104;1439;23;81;335;1104;75;29;13;10;62;19;0;7;1;9;;
Pinhalão;De 20 a menos de 50 ha;58;1776;7;51;223;1553;37;21;6;1;31;20;0;1;2;14;;
Pinhalão;De 50 a menos de 100 ha;22;1647;16;6;1276;371;19;3;14;2;5;1;0;2;0;1;;
Pinhalão;De 100 a menos de 200 ha;15;2167;15;0;2167;0;8;7;8;7;0;0;0;4;0;0;;
Pinhalão;De 200 a menos de 500 ha;12;3556;12;0;3556;0;10;2;10;2;0;0;0;1;0;0;;
Pinhalão;De 500 a menos de 1.000 ha;0;0;0;0;0;0;0;0;0;0;0;0;0;0;0;0;;
Pinhalão;De 1.000 a menos de 2.500 ha;1;0;1;0;0;0;1;0;1;0;0;0;0;0;0;0;;
Pinhalão;De 2.500 a menos de 10.000 ha;0;0;0;0;0;0;0;0;0;0;0;0;0;0;0;0;;
Pinhalão;De 10.000 ha e mais;0;0;0;0;0;0;0;0;0;0;0;0;0;0;0;0;;
Pinhalão;Produtor sem área;0;0;0;0;0;0;0;0;0;0;0;0;0;0;0;0;;
Pinhal de São Bento;Mais de 0 a menos de 0,1 ha;5;0;2;3;0;0;0;5;0;2;0;3;0;2;0;3;;
Pinhal de São Bento;De 0,1 a menos de 0,2 ha;4;0;1;3;0;0;1;3;0;1;1;2;1;0;0;2;;
Pinhal de São Bento;De 0,2 a menos de 0,5 ha;1;0;0;1;0;0;0;1;0;0;0;1;0;0;0;1;;
Pinhal de São Bento;De 0,5 a menos de 1 ha;12;9;4;8;3;6;2;10;1;3;1;7;0;2;0;6;;
Pinhal de São Bento;De 1 a menos de 2 ha;13;19;2;11;0;0;2;11;0;2;2;9;0;2;1;5;;
Pinhal de São Bento;De 2 a menos de 3 ha;9;22;1;8;0;0;5;4;0;1;5;3;0;1;1;2;;
Pinhal de São Bento;De 3 a menos de 4 ha;30;106;9;21;32;74;21;9;7;2;14;7;0;1;1;4;;
Pinhal de São Bento;De 4 a menos de 5 ha;34;159;5;29;23;136;23;11;1;4;22;7;0;3;1;4;;
Pinhal de São Bento;De 5 a menos de 10 ha;102;784;14;88;101;683;85;17;11;3;74;14;0;3;0;9;;
Pinhal de São Bento;De 10 a menos de 20 ha;96;1403;6;90;101;1302;84;12;3;3;81;9;0;3;1;8;;
Pinhal de São Bento;De 20 a menos de 50 ha;65;2004;7;58;215;1789;62;3;5;2;57;1;0;2;0;0;;
Pinhal de São Bento;De 50 a menos de 100 ha;21;1493;8;13;713;780;20;1;8;0;12;1;0;0;0;0;;
Pinhal de São Bento;De 100 a menos de 200 ha;6;802;6;0;802;0;5;1;5;1;0;0;0;1;0;0;;
Pinhal de São Bento;De 200 a menos de 500 ha;6;1787;6;0;1787;0;6;0;6;0;0;0;0;0;0;0;;
Pinhal de São Bento;De 500 a menos de 1.000 ha;1;0;1;0;0;0;1;0;1;0;0;0;0;0;0;0;;
Pinhal de São Bento;De 1.000 a menos de 2.500 ha;0;0;0;0;0;0;0;0;0;0;0;0;0;0;0;0;;
Pinhal de São Bento;De 2.500 a menos de 10.000 ha;0;0;0;0;0;0;0;0;0;0;0;0;0;0;0;0;;
Pinhal de São Bento;De 10.000 ha e mais;0;0;0;0;0;0;0;0;0;0;0;0;0;0;0;0;;
Pinhal de São Bento;Produtor sem área;0;0;0;0;0;0;0;0;0;0;0;0;0;0;0;0;;
Pinhão;Mais de 0 a menos de 0,1 ha;6;0;2;4;0;0;1;5;0;2;1;3;0;2;0;3;;
Pinhão;De 0,1 a menos de 0,2 ha;17;2;7;10;1;1;4;13;2;5;2;8;1;3;1;5;;
Pinhão;De 0,2 a menos de 0,5 ha;67;24;30;37;10;13;13;54;4;26;9;28;1;23;0;21;;
Pinhão;De 0,5 a menos de 1 ha;94;66;38;56;28;37;27;67;14;24;13;43;1;19;2;31;;
Pinhão;De 1 a menos de 2 ha;137;182;52;85;69;113;37;100;8;44;29;56;1;38;2;45;;
Pinhão;De 2 a menos de 3 ha;218;533;73;145;180;353;77;141;17;56;60;85;1;49;3;69;;
Pinhão;De 3 a menos de 4 ha;125;447;34;91;121;326;54;71;9;25;45;46;0;21;0;41;;
Pinhão;De 4 a menos de 5 ha;185;890;43;142;206;683;70;115;10;33;60;82;2;25;5;65;;
Pinhão;De 5 a menos de 10 ha;376;2884;72;304;544;2340;193;183;24;48;169;135;2;40;6;101;;
Pinhão;De 10 a menos de 20 ha;509;7380;81;428;1110;6270;289;220;31;50;258;170;3;40;8;125;;
Pinhão;De 20 a menos de 50 ha;721;21420;77;644;2388;19031;407;314;28;49;379;265;4;40;8;220;;
Pinhão;De 50 a menos de 100 ha;167;11784;64;103;5213;6571;99;68;40;24;59;44;2;19;1;39;;
Pinhão;De 100 a menos de 200 ha;103;14252;98;5;13639;613;64;39;61;37;3;2;1;31;0;2;;
Pinhão;De 200 a menos de 500 ha;86;27275;83;3;0;0;57;29;55;28;2;1;3;21;0;1;;
Pinhão;De 500 a menos de 1.000 ha;24;16670;23;1;0;0;19;5;19;4;0;1;0;4;0;1;;
Pinhão;De 1.000 a menos de 2.500 ha;13;16943;13;0;16943;0;11;2;11;2;0;0;0;1;0;0;;
Pinhão;De 2.500 a menos de 10.000 ha;4;0;4;0;0;0;4;0;4;0;0;0;0;0;0;0;;
Pinhão;De 10.000 ha e mais;0;0;0;0;0;0;0;0;0;0;0;0;0;0;0;0;;
Pinhão;Produtor sem área;0;0;0;0;0;0;0;0;0;0;0;0;0;0;0;0;;
Piraí do Sul;Mais de 0 a menos de 0,1 ha;20;1;5;15;0;1;4;16;3;2;1;14;0;2;2;12;;
Piraí do Sul;De 0,1 a menos de 0,2 ha;7;1;4;3;0;0;0;7;0;4;0;3;0;4;0;3;;
Piraí do Sul;De 0,2 a menos de 0,5 ha;35;13;14;21;5;8;9;26;5;9;4;17;1;5;1;11;;
Piraí do Sul;De 0,5 a menos de 1 ha;29;19;11;18;7;12;5;24;1;10;4;14;3;6;1;13;;
Piraí do Sul;De 1 a menos de 2 ha;72;92;22;50;27;64;15;57;7;15;8;42;1;13;5;33;;
Piraí do Sul;De 2 a menos de 3 ha;112;267;38;74;91;176;33;79;17;21;16;58;0;17;1;49;;
Piraí do Sul;De 3 a menos de 4 ha;84;295;20;64;71;225;21;63;8;12;13;51;0;11;2;36;;
Piraí do Sul;De 4 a menos de 5 ha;88;419;31;57;147;272;23;65;7;24;16;41;1;20;1;35;;
Piraí do Sul;De 5 a menos de 10 ha;194;1439;33;161;227;1212;83;111;18;15;65;96;1;12;3;75;;
Piraí do Sul;De 10 a menos de 20 ha;226;3301;28;198;429;2872;138;88;12;16;126;72;2;14;3;56;;
Piraí do Sul;De 20 a menos de 50 ha;154;4767;18;136;559;4208;103;51;5;13;98;38;0;12;0;34;;
Piraí do Sul;De 50 a menos de 100 ha;60;4109;31;29;2456;1653;43;17;24;7;19;10;0;7;0;8;;
Piraí do Sul;De 100 a menos de 200 ha;63;8979;63;0;8979;0;50;13;50;13;0;0;0;11;0;0;;
Piraí do Sul;De 200 a menos de 500 ha;48;14711;48;0;14711;0;40;8;40;8;0;0;1;4;0;0;;
Piraí do Sul;De 500 a menos de 1.000 ha;24;17615;24;0;17615;0;22;2;22;2;0;0;0;2;0;0;;
Piraí do Sul;De 1.000 a menos de 2.500 ha;15;21903;15;0;21903;0;12;3;12;3;0;0;0;2;0;0;;
Piraí do Sul;De 2.500 a menos de 10.000 ha;6;0;6;0;0;0;5;1;5;1;0;0;0;1;0;0;;
Piraí do Sul;De 10.000 ha e mais;0;0;0;0;0;0;0;0;0;0;0;0;0;0;0;0;;
Piraí do Sul;Produtor sem área;1;0;0;1;0;0;0;0;0;0;0;0;0;0;0;0;;
Piraquara;Mais de 0 a menos de 0,1 ha;1;0;0;1;0;0;0;1;0;0;0;1;0;0;0;1;;
Piraquara;De 0,1 a menos de 0,2 ha;3;0;1;2;0;0;0;3;0;1;0;2;0;1;0;2;;
Piraquara;De 0,2 a menos de 0,5 ha;9;3;4;5;1;2;1;8;1;3;0;5;0;3;0;3;;
Piraquara;De 0,5 a menos de 1 ha;14;10;6;8;4;6;1;13;0;6;1;7;0;6;0;4;;
Piraquara;De 1 a menos de 2 ha;11;15;3;8;4;11;1;10;0;3;1;7;0;3;0;3;;
Piraquara;De 2 a menos de 3 ha;24;57;8;16;20;37;1;23;0;8;1;15;0;7;3;9;;
Piraquara;De 3 a menos de 4 ha;10;35;4;6;14;20;3;7;1;3;2;4;0;2;0;4;;
Piraquara;De 4 a menos de 5 ha;10;46;5;5;23;23;3;7;2;3;1;4;0;2;0;3;;
Piraquara;De 5 a menos de 10 ha;33;263;22;11;179;84;2;31;1;21;1;10;0;17;0;4;;
Piraquara;De 10 a menos de 20 ha;39;557;23;16;337;219;10;29;2;21;8;8;0;14;0;4;;
Piraquara;De 20 a menos de 50 ha;37;1167;18;19;590;577;12;25;3;15;9;10;0;12;1;5;;
Piraquara;De 50 a menos de 100 ha;13;919;13;0;919;0;6;7;6;7;0;0;0;4;0;0;;
Piraquara;De 100 a menos de 200 ha;4;645;4;0;645;0;1;3;1;3;0;0;0;3;0;0;;
Piraquara;De 200 a menos de 500 ha;0;0;0;0;0;0;0;0;0;0;0;0;0;0;0;0;;
Piraquara;De 500 a menos de 1.000 ha;2;0;2;0;0;0;0;2;0;2;0;0;0;2;0;0;;
Piraquara;De 1.000 a menos de 2.500 ha;0;0;0;0;0;0;0;0;0;0;0;0;0;0;0;0;;
Piraquara;De 2.500 a menos de 10.000 ha;0;0;0;0;0;0;0;0;0;0;0;0;0;0;0;0;;
Piraquara;De 10.000 ha e mais;0;0;0;0;0;0;0;0;0;0;0;0;0;0;0;0;;
Piraquara;Produtor sem área;0;0;0;0;0;0;0;0;0;0;0;0;0;0;0;0;;
Pitanga;Mais de 0 a menos de 0,1 ha;30;2;10;20;0;0;2;28;0;10;2;18;1;7;4;13;;
Pitanga;De 0,1 a menos de 0,2 ha;49;7;17;32;2;5;11;38;4;13;7;25;0;10;9;14;;
Pitanga;De 0,2 a menos de 0,5 ha;125;48;45;80;16;31;55;70;19;26;36;44;5;19;6;23;;
Pitanga;De 0,5 a menos de 1 ha;120;82;29;91;19;63;51;69;12;17;39;52;1;13;5;24;;
Pitanga;De 1 a menos de 2 ha;166;234;43;123;58;175;77;89;21;22;56;67;2;15;5;38;;
Pitanga;De 2 a menos de 3 ha;184;451;44;140;109;342;111;73;23;21;88;52;1;15;4;31;;
Pitanga;De 3 a menos de 4 ha;130;450;19;111;66;384;65;65;7;12;58;53;1;10;1;32;;
Pitanga;De 4 a menos de 5 ha;159;761;26;133;125;636;89;70;11;15;78;55;1;10;7;31;;
Pitanga;De 5 a menos de 10 ha;449;3487;67;382;503;2985;318;131;39;28;279;103;3;20;9;57;;
Pitanga;De 10 a menos de 20 ha;525;7518;36;489;531;6987;415;110;16;20;399;90;1;16;8;54;;
Pitanga;De 20 a menos de 50 ha;560;18053;26;534;841;17212;469;91;13;13;456;78;0;11;5;58;;
Pitanga;De 50 a menos de 100 ha;230;15915;61;169;5253;10662;199;31;50;11;149;20;1;8;1;13;;
Pitanga;De 100 a menos de 200 ha;129;18148;129;0;18148;0;109;20;109;20;0;0;1;15;0;0;;
Pitanga;De 200 a menos de 500 ha;81;25315;81;0;25315;0;67;14;67;14;0;0;0;8;0;0;;
Pitanga;De 500 a menos de 1.000 ha;25;18761;25;0;18761;0;21;4;21;4;0;0;0;3;0;0;;
Pitanga;De 1.000 a menos de 2.500 ha;9;0;9;0;0;0;8;1;8;1;0;0;0;0;0;0;;
Pitanga;De 2.500 a menos de 10.000 ha;2;0;2;0;0;0;1;1;1;1;0;0;0;1;0;0;;
Pitanga;De 10.000 ha e mais;0;0;0;0;0;0;0;0;0;0;0;0;0;0;0;0;;
Pitanga;Produtor sem área;35;0;7;28;0;0;10;24;0;7;10;17;0;7;0;16;;
Pitangueiras;Mais de 0 a menos de 0,1 ha;0;0;0;0;0;0;0;0;0;0;0;0;0;0;0;0;;
Pitangueiras;De 0,1 a menos de 0,2 ha;0;0;0;0;0;0;0;0;0;0;0;0;0;0;0;0;;
Pitangueiras;De 0,2 a menos de 0,5 ha;1;0;0;1;0;0;1;0;0;0;1;0;0;0;0;0;;
Pitangueiras;De 0,5 a menos de 1 ha;87;44;0;87;0;44;56;31;0;0;56;31;0;0;0;31;;
Pitangueiras;De 1 a menos de 2 ha;7;0;0;7;0;0;7;0;0;0;7;0;0;0;0;0;;
Pitangueiras;De 2 a menos de 3 ha;15;36;0;15;0;36;7;8;0;0;7;8;0;0;0;8;;
Pitangueiras;De 3 a menos de 4 ha;13;47;0;13;0;47;9;4;0;0;9;4;0;0;0;4;;
Pitangueiras;De 4 a menos de 5 ha;13;63;0;13;0;63;8;5;0;0;8;5;0;0;0;5;;
Pitangueiras;De 5 a menos de 10 ha;20;168;2;18;0;0;17;3;0;2;17;1;0;2;0;1;;
Pitangueiras;De 10 a menos de 20 ha;23;315;1;22;0;0;21;2;1;0;20;2;0;0;0;1;;
Pitangueiras;De 20 a menos de 50 ha;28;976;10;18;401;575;25;3;10;0;15;3;0;0;0;3;;
Pitangueiras;De 50 a menos de 100 ha;19;1282;19;0;1282;0;17;2;17;2;0;0;0;2;0;0;;
Pitangueiras;De 100 a menos de 200 ha;12;1796;12;0;1796;0;12;0;12;0;0;0;0;0;0;0;;
Pitangueiras;De 200 a menos de 500 ha;5;1634;5;0;1634;0;5;0;5;0;0;0;0;0;0;0;;
Pitangueiras;De 500 a menos de 1.000 ha;1;0;1;0;0;0;1;0;1;0;0;0;0;0;0;0;;
Pitangueiras;De 1.000 a menos de 2.500 ha;3;0;3;0;0;0;3;0;3;0;0;0;0;0;0;0;;
Pitangueiras;De 2.500 a menos de 10.000 ha;0;0;0;0;0;0;0;0;0;0;0;0;0;0;0;0;;
Pitangueiras;De 10.000 ha e mais;0;0;0;0;0;0;0;0;0;0;0;0;0;0;0;0;;
Pitangueiras;Produtor sem área;0;0;0;0;0;0;0;0;0;0;0;0;0;0;0;0;;
Planaltina do Paraná;Mais de 0 a menos de 0,1 ha;0;0;0;0;0;0;0;0;0;0;0;0;0;0;0;0;;
Planaltina do Paraná;De 0,1 a menos de 0,2 ha;0;0;0;0;0;0;0;0;0;0;0;0;0;0;0;0;;
Planaltina do Paraná;De 0,2 a menos de 0,5 ha;4;2;4;0;2;0;2;2;2;2;0;0;0;2;0;0;;
Planaltina do Paraná;De 0,5 a menos de 1 ha;14;7;8;6;4;3;8;6;4;4;4;2;0;4;0;2;;
Planaltina do Paraná;De 1 a menos de 2 ha;12;15;8;4;9;5;1;11;0;8;1;3;0;8;0;3;;
Planaltina do Paraná;De 2 a menos de 3 ha;11;26;5;6;12;14;4;7;2;3;2;4;0;3;0;4;;
Planaltina do Paraná;De 3 a menos de 4 ha;4;0;4;0;0;0;3;1;3;1;0;0;0;1;0;0;;
Planaltina do Paraná;De 4 a menos de 5 ha;22;106;10;12;48;58;10;12;5;5;5;7;0;4;0;6;;
Planaltina do Paraná;De 5 a menos de 10 ha;60;440;21;39;150;290;27;33;14;7;13;26;0;6;0;23;;
Planaltina do Paraná;De 10 a menos de 20 ha;161;2535;18;143;280;2255;72;89;8;10;64;79;0;9;2;66;;
Planaltina do Paraná;De 20 a menos de 50 ha;86;2530;16;70;553;1977;38;48;5;11;33;37;0;10;1;25;;
Planaltina do Paraná;De 50 a menos de 100 ha;28;1974;6;22;423;1551;17;11;3;3;14;8;0;3;0;6;;
Planaltina do Paraná;De 100 a menos de 200 ha;26;3704;26;0;3704;0;13;13;13;13;0;0;0;7;0;0;;
Planaltina do Paraná;De 200 a menos de 500 ha;26;7890;26;0;7890;0;18;8;18;8;0;0;0;6;0;0;;
Planaltina do Paraná;De 500 a menos de 1.000 ha;8;5447;8;0;5447;0;5;3;5;3;0;0;1;1;0;0;;
Planaltina do Paraná;De 1.000 a menos de 2.500 ha;5;7737;5;0;7737;0;4;1;4;1;0;0;0;0;0;0;;
Planaltina do Paraná;De 2.500 a menos de 10.000 ha;0;0;0;0;0;0;0;0;0;0;0;0;0;0;0;0;;
Planaltina do Paraná;De 10.000 ha e mais;0;0;0;0;0;0;0;0;0;0;0;0;0;0;0;0;;
Planaltina do Paraná;Produtor sem área;1;0;1;0;0;0;0;0;0;0;0;0;0;0;0;0;;
Planalto;Mais de 0 a menos de 0,1 ha;23;1;3;20;0;1;1;22;0;3;1;19;0;3;1;16;;
Planalto;De 0,1 a menos de 0,2 ha;37;5;7;30;1;4;4;33;2;5;2;28;0;4;0;25;;
Planalto;De 0,2 a menos de 0,5 ha;31;9;11;20;3;6;11;20;5;6;6;14;0;5;0;11;;
Planalto;De 0,5 a menos de 1 ha;46;30;5;41;3;27;26;20;3;2;23;18;0;0;1;13;;
Planalto;De 1 a menos de 2 ha;95;120;15;80;21;98;53;42;11;4;42;38;0;3;3;28;;
Planalto;De 2 a menos de 3 ha;101;239;18;83;42;197;60;41;11;7;49;34;0;4;4;22;;
Planalto;De 3 a menos de 4 ha;112;381;23;89;79;302;83;29;15;8;68;21;0;4;3;9;;
Planalto;De 4 a menos de 5 ha;133;621;16;117;75;546;102;31;8;8;94;23;0;6;2;14;;
Planalto;De 5 a menos de 10 ha;401;2989;33;368;232;2757;322;79;21;12;301;67;0;8;9;36;;
Planalto;De 10 a menos de 20 ha;484;6817;15;469;226;6590;441;43;13;2;428;41;0;1;9;19;;
Planalto;De 20 a menos de 50 ha;288;8819;17;271;511;8308;271;17;13;4;258;13;1;3;1;7;;
Planalto;De 50 a menos de 100 ha;75;5094;20;55;1652;3442;71;4;20;0;51;4;0;0;0;1;;
Planalto;De 100 a menos de 200 ha;19;2629;19;0;2629;0;18;1;18;1;0;0;0;0;0;0;;
Planalto;De 200 a menos de 500 ha;7;2006;7;0;2006;0;7;0;7;0;0;0;0;0;0;0;;
Planalto;De 500 a menos de 1.000 ha;0;0;0;0;0;0;0;0;0;0;0;0;0;0;0;0;;
Planalto;De 1.000 a menos de 2.500 ha;0;0;0;0;0;0;0;0;0;0;0;0;0;0;0;0;;
Planalto;De 2.500 a menos de 10.000 ha;0;0;0;0;0;0;0;0;0;0;0;0;0;0;0;0;;
Planalto;De 10.000 ha e mais;0;0;0;0;0;0;0;0;0;0;0;0;0;0;0;0;;
Planalto;Produtor sem área;0;0;0;0;0;0;0;0;0;0;0;0;0;0;0;0;;
Ponta Grossa;Mais de 0 a menos de 0,1 ha;15;1;6;9;0;0;2;13;1;5;1;8;0;4;0;8;;
Ponta Grossa;De 0,1 a menos de 0,2 ha;8;0;2;6;0;0;2;6;1;1;1;5;0;1;0;5;;
Ponta Grossa;De 0,2 a menos de 0,5 ha;26;8;9;17;3;6;0;26;0;9;0;17;1;7;1;15;;
Ponta Grossa;De 0,5 a menos de 1 ha;40;24;13;27;8;17;4;36;0;13;4;23;0;10;2;15;;
Ponta Grossa;De 1 a menos de 2 ha;55;70;26;29;34;37;12;43;5;21;7;22;1;18;1;15;;
Ponta Grossa;De 2 a menos de 3 ha;104;246;32;72;75;171;28;76;6;26;22;50;3;22;3;43;;
Ponta Grossa;De 3 a menos de 4 ha;44;151;7;37;25;125;8;36;1;6;7;30;0;5;3;18;;
Ponta Grossa;De 4 a menos de 5 ha;63;295;21;42;97;198;14;49;3;18;11;31;1;15;0;25;;
Ponta Grossa;De 5 a menos de 10 ha;203;1544;53;150;423;1121;86;117;16;37;70;80;2;27;5;64;;
Ponta Grossa;De 10 a menos de 20 ha;158;2266;38;120;542;1724;71;87;12;26;59;61;3;20;2;47;;
Ponta Grossa;De 20 a menos de 50 ha;204;6543;58;146;2099;4445;117;87;27;31;90;56;2;25;3;47;;
Ponta Grossa;De 50 a menos de 100 ha;93;6669;93;0;6669;0;67;26;67;26;0;0;1;22;0;0;;
Ponta Grossa;De 100 a menos de 200 ha;81;11670;80;1;0;0;66;15;66;14;0;1;0;14;0;1;;
Ponta Grossa;De 200 a menos de 500 ha;99;31814;99;0;31814;0;85;14;85;14;0;0;1;12;0;0;;
Ponta Grossa;De 500 a menos de 1.000 ha;36;24350;36;0;24350;0;31;5;31;5;0;0;1;2;0;0;;
Ponta Grossa;De 1.000 a menos de 2.500 ha;25;39648;25;0;39648;0;19;6;19;6;0;0;0;4;0;0;;
Ponta Grossa;De 2.500 a menos de 10.000 ha;4;0;4;0;0;0;2;2;2;2;0;0;0;1;0;0;;
Ponta Grossa;De 10.000 ha e mais;0;0;0;0;0;0;0;0;0;0;0;0;0;0;0;0;;
Ponta Grossa;Produtor sem área;0;0;0;0;0;0;0;0;0;0;0;0;0;0;0;0;;
Pontal do Paraná;Mais de 0 a menos de 0,1 ha;1;0;0;1;0;0;0;1;0;0;0;1;0;0;0;1;;
Pontal do Paraná;De 0,1 a menos de 0,2 ha;1;0;0;1;0;0;0;1;0;0;0;1;0;0;0;0;;
Pontal do Paraná;De 0,2 a menos de 0,5 ha;2;0;0;2;0;0;0;2;0;0;0;2;0;0;0;1;;
Pontal do Paraná;De 0,5 a menos de 1 ha;3;2;2;1;0;0;0;3;0;2;0;1;0;1;0;1;;
Pontal do Paraná;De 1 a menos de 2 ha;7;8;4;3;4;4;0;7;0;4;0;3;0;4;0;3;;
Pontal do Paraná;De 2 a menos de 3 ha;12;26;8;4;18;8;1;11;0;8;1;3;0;7;0;2;;
Pontal do Paraná;De 3 a menos de 4 ha;4;13;3;1;0;0;1;3;1;2;0;1;0;1;0;1;;
Pontal do Paraná;De 4 a menos de 5 ha;2;0;1;1;0;0;0;2;0;1;0;1;0;1;0;1;;
Pontal do Paraná;De 5 a menos de 10 ha;5;35;3;2;0;0;0;5;0;3;0;2;0;3;1;1;;
Pontal do Paraná;De 10 a menos de 20 ha;6;87;2;4;0;0;2;4;0;2;2;2;0;1;0;1;;
Pontal do Paraná;De 20 a menos de 50 ha;0;0;0;0;0;0;0;0;0;0;0;0;0;0;0;0;;
Pontal do Paraná;De 50 a menos de 100 ha;2;0;1;1;0;0;2;0;1;0;1;0;0;0;0;0;;
Pontal do Paraná;De 100 a menos de 200 ha;1;0;1;0;0;0;1;0;1;0;0;0;0;0;0;0;;
Pontal do Paraná;De 200 a menos de 500 ha;0;0;0;0;0;0;0;0;0;0;0;0;0;0;0;0;;
Pontal do Paraná;De 500 a menos de 1.000 ha;0;0;0;0;0;0;0;0;0;0;0;0;0;0;0;0;;
Pontal do Paraná;De 1.000 a menos de 2.500 ha;0;0;0;0;0;0;0;0;0;0;0;0;0;0;0;0;;
Pontal do Paraná;De 2.500 a menos de 10.000 ha;0;0;0;0;0;0;0;0;0;0;0;0;0;0;0;0;;
Pontal do Paraná;De 10.000 ha e mais;0;0;0;0;0;0;0;0;0;0;0;0;0;0;0;0;;
Pontal do Paraná;Produtor sem área;0;0;0;0;0;0;0;0;0;0;0;0;0;0;0;0;;
Porecatu;Mais de 0 a menos de 0,1 ha;0;0;0;0;0;0;0;0;0;0;0;0;0;0;0;0;;
Porecatu;De 0,1 a menos de 0,2 ha;0;0;0;0;0;0;0;0;0;0;0;0;0;0;0;0;;
Porecatu;De 0,2 a menos de 0,5 ha;7;2;1;6;0;0;0;7;0;1;0;6;0;1;0;5;;
Porecatu;De 0,5 a menos de 1 ha;35;21;4;31;2;19;9;26;1;3;8;23;0;2;1;19;;
Porecatu;De 1 a menos de 2 ha;9;11;0;9;0;11;3;6;0;0;3;6;0;0;0;5;;
Porecatu;De 2 a menos de 3 ha;19;46;3;16;7;39;5;14;1;2;4;12;0;1;0;7;;
Porecatu;De 3 a menos de 4 ha;23;79;2;21;0;0;8;15;1;1;7;14;0;0;0;10;;
Porecatu;De 4 a menos de 5 ha;11;53;2;9;0;0;4;7;1;1;3;6;0;1;0;4;;
Porecatu;De 5 a menos de 10 ha;20;164;2;18;0;0;8;12;1;1;7;11;0;1;0;5;;
Porecatu;De 10 a menos de 20 ha;17;227;0;17;0;227;10;7;0;0;10;7;0;0;0;6;;
Porecatu;De 20 a menos de 50 ha;13;404;6;7;198;206;9;4;3;3;6;1;0;2;0;1;;
Porecatu;De 50 a menos de 100 ha;3;248;3;0;248;0;2;1;2;1;0;0;0;1;0;0;;
Porecatu;De 100 a menos de 200 ha;1;0;1;0;0;0;1;0;1;0;0;0;0;0;0;0;;
Porecatu;De 200 a menos de 500 ha;3;985;3;0;985;0;3;0;3;0;0;0;0;0;0;0;;
Porecatu;De 500 a menos de 1.000 ha;2;0;2;0;0;0;2;0;2;0;0;0;0;0;0;0;;
Porecatu;De 1.000 a menos de 2.500 ha;0;0;0;0;0;0;0;0;0;0;0;0;0;0;0;0;;
Porecatu;De 2.500 a menos de 10.000 ha;2;0;2;0;0;0;2;0;2;0;0;0;0;0;0;0;;
Porecatu;De 10.000 ha e mais;1;0;1;0;0;0;1;0;1;0;0;0;0;0;0;0;;
Porecatu;Produtor sem área;0;0;0;0;0;0;0;0;0;0;0;0;0;0;0;0;;
Porto Amazonas;Mais de 0 a menos de 0,1 ha;0;0;0;0;0;0;0;0;0;0;0;0;0;0;0;0;;
Porto Amazonas;De 0,1 a menos de 0,2 ha;0;0;0;0;0;0;0;0;0;0;0;0;0;0;0;0;;
Porto Amazonas;De 0,2 a menos de 0,5 ha;1;0;0;1;0;0;0;1;0;0;0;1;0;0;0;1;;
Porto Amazonas;De 0,5 a menos de 1 ha;0;0;0;0;0;0;0;0;0;0;0;0;0;0;0;0;;
Porto Amazonas;De 1 a menos de 2 ha;3;3;0;3;0;3;0;3;0;0;0;3;0;0;0;3;;
Porto Amazonas;De 2 a menos de 3 ha;6;13;1;5;0;0;0;6;0;1;0;5;0;0;0;5;;
Porto Amazonas;De 3 a menos de 4 ha;1;0;0;1;0;0;0;1;0;0;0;1;0;0;0;1;;
Porto Amazonas;De 4 a menos de 5 ha;2;0;0;2;0;0;0;2;0;0;0;2;0;0;0;1;;
Porto Amazonas;De 5 a menos de 10 ha;10;68;0;10;0;68;0;10;0;0;0;10;0;0;0;7;;
Porto Amazonas;De 10 a menos de 20 ha;13;174;2;11;0;0;5;8;2;0;3;8;0;0;0;7;;
Porto Amazonas;De 20 a menos de 50 ha;14;463;0;14;0;463;4;10;0;0;4;10;0;0;0;8;;
Porto Amazonas;De 50 a menos de 100 ha;8;596;5;3;418;178;5;3;4;1;1;2;0;1;0;1;;
Porto Amazonas;De 100 a menos de 200 ha;16;2364;16;0;2364;0;9;7;9;7;0;0;0;6;0;0;;
Porto Amazonas;De 200 a menos de 500 ha;14;3769;14;0;3769;0;6;8;6;8;0;0;0;3;0;0;;
Porto Amazonas;De 500 a menos de 1.000 ha;6;4090;6;0;4090;0;4;2;4;2;0;0;0;2;0;0;;
Porto Amazonas;De 1.000 a menos de 2.500 ha;1;0;1;0;0;0;1;0;1;0;0;0;0;0;0;0;;
Porto Amazonas;De 2.500 a menos de 10.000 ha;0;0;0;0;0;0;0;0;0;0;0;0;0;0;0;0;;
Porto Amazonas;De 10.000 ha e mais;0;0;0;0;0;0;0;0;0;0;0;0;0;0;0;0;;
Porto Amazonas;Produtor sem área;7;0;2;5;0;0;1;4;0;1;1;3;0;1;0;3;;
Porto Barreiro;Mais de 0 a menos de 0,1 ha;3;0;1;2;0;0;0;3;0;1;0;2;0;1;0;2;;
Porto Barreiro;De 0,1 a menos de 0,2 ha;4;0;0;4;0;0;1;3;0;0;1;3;0;0;1;2;;
Porto Barreiro;De 0,2 a menos de 0,5 ha;12;5;1;11;0;0;9;3;0;1;9;2;0;1;1;1;;
Porto Barreiro;De 0,5 a menos de 1 ha;9;6;2;7;0;0;5;4;1;1;4;3;0;1;0;3;;
Porto Barreiro;De 1 a menos de 2 ha;11;15;2;9;0;0;7;4;1;1;6;3;0;0;1;2;;
Porto Barreiro;De 2 a menos de 3 ha;32;76;3;29;7;69;18;14;2;1;16;13;0;1;1;10;;
Porto Barreiro;De 3 a menos de 4 ha;19;69;4;15;14;54;15;4;2;2;13;2;0;2;0;2;;
Porto Barreiro;De 4 a menos de 5 ha;24;115;4;20;19;95;21;3;3;1;18;2;0;1;0;2;;
Porto Barreiro;De 5 a menos de 10 ha;109;853;20;89;154;699;101;8;19;1;82;7;0;0;0;5;;
Porto Barreiro;De 10 a menos de 20 ha;222;3187;15;207;221;2967;209;13;14;1;195;12;0;1;0;11;;
Porto Barreiro;De 20 a menos de 50 ha;186;5863;26;160;837;5026;177;9;22;4;155;5;0;2;0;5;;
Porto Barreiro;De 50 a menos de 100 ha;67;4748;37;30;2912;1836;66;1;37;0;29;1;0;0;0;1;;
Porto Barreiro;De 100 a menos de 200 ha;22;3080;22;0;3080;0;20;2;20;2;0;0;0;2;0;0;;
Porto Barreiro;De 200 a menos de 500 ha;20;6618;20;0;6618;0;18;2;18;2;0;0;1;1;0;0;;
Porto Barreiro;De 500 a menos de 1.000 ha;3;0;3;0;0;0;3;0;3;0;0;0;0;0;0;0;;
Porto Barreiro;De 1.000 a menos de 2.500 ha;0;0;0;0;0;0;0;0;0;0;0;0;0;0;0;0;;
Porto Barreiro;De 2.500 a menos de 10.000 ha;1;0;1;0;0;0;0;1;0;1;0;0;0;1;0;0;;
Porto Barreiro;De 10.000 ha e mais;0;0;0;0;0;0;0;0;0;0;0;0;0;0;0;0;;
Porto Barreiro;Produtor sem área;0;0;0;0;0;0;0;0;0;0;0;0;0;0;0;0;;
Porto Rico;Mais de 0 a menos de 0,1 ha;0;0;0;0;0;0;0;0;0;0;0;0;0;0;0;0;;
Porto Rico;De 0,1 a menos de 0,2 ha;0;0;0;0;0;0;0;0;0;0;0;0;0;0;0;0;;
Porto Rico;De 0,2 a menos de 0,5 ha;0;0;0;0;0;0;0;0;0;0;0;0;0;0;0;0;;
Porto Rico;De 0,5 a menos de 1 ha;0;0;0;0;0;0;0;0;0;0;0;0;0;0;0;0;;
Porto Rico;De 1 a menos de 2 ha;5;7;2;3;0;0;1;4;1;1;0;3;0;1;0;1;;
Porto Rico;De 2 a menos de 3 ha;5;12;0;5;0;12;0;5;0;0;0;5;0;0;0;4;;
Porto Rico;De 3 a menos de 4 ha;1;0;0;1;0;0;0;1;0;0;0;1;0;0;0;1;;
Porto Rico;De 4 a menos de 5 ha;7;33;2;5;0;0;0;7;0;2;0;5;0;2;0;5;;
Porto Rico;De 5 a menos de 10 ha;13;109;1;12;0;0;1;12;0;1;1;11;0;1;0;10;;
Porto Rico;De 10 a menos de 20 ha;25;351;6;19;75;276;2;23;1;5;1;18;0;4;0;13;;
Porto Rico;De 20 a menos de 50 ha;18;570;5;13;162;408;6;12;2;3;4;9;0;1;0;6;;
Porto Rico;De 50 a menos de 100 ha;24;1745;5;19;414;1331;8;16;1;4;7;12;0;4;0;8;;
Porto Rico;De 100 a menos de 200 ha;15;2256;15;0;2256;0;4;11;4;11;0;0;0;10;0;0;;
Porto Rico;De 200 a menos de 500 ha;13;4004;13;0;4004;0;2;11;2;11;0;0;0;7;0;0;;
Porto Rico;De 500 a menos de 1.000 ha;2;0;2;0;0;0;0;2;0;2;0;0;0;2;0;0;;
Porto Rico;De 1.000 a menos de 2.500 ha;3;4160;3;0;4160;0;0;3;0;3;0;0;0;1;0;0;;
Porto Rico;De 2.500 a menos de 10.000 ha;0;0;0;0;0;0;0;0;0;0;0;0;0;0;0;0;;
Porto Rico;De 10.000 ha e mais;0;0;0;0;0;0;0;0;0;0;0;0;0;0;0;0;;
Porto Rico;Produtor sem área;0;0;0;0;0;0;0;0;0;0;0;0;0;0;0;0;;
Porto Vitória;Mais de 0 a menos de 0,1 ha;3;0;1;2;0;0;0;3;0;1;0;2;1;0;0;2;;
Porto Vitória;De 0,1 a menos de 0,2 ha;2;0;0;2;0;0;0;2;0;0;0;2;0;0;0;2;;
Porto Vitória;De 0,2 a menos de 0,5 ha;4;1;1;3;0;0;1;3;1;0;0;3;0;0;0;3;;
Porto Vitória;De 0,5 a menos de 1 ha;11;8;2;9;0;0;0;11;0;2;0;9;2;0;0;9;;
Porto Vitória;De 1 a menos de 2 ha;17;21;6;11;7;14;1;16;1;5;0;11;3;2;1;8;;
Porto Vitória;De 2 a menos de 3 ha;14;32;4;10;9;23;0;14;0;4;0;10;3;1;2;6;;
Porto Vitória;De 3 a menos de 4 ha;12;41;2;10;0;0;1;11;0;2;1;9;1;0;2;7;;
Porto Vitória;De 4 a menos de 5 ha;15;70;5;10;24;46;3;12;1;4;2;8;4;0;1;6;;
Porto Vitória;De 5 a menos de 10 ha;57;457;11;46;94;363;15;42;1;10;14;32;4;5;5;21;;
Porto Vitória;De 10 a menos de 20 ha;93;1361;16;77;223;1138;33;60;7;9;26;51;3;5;3;33;;
Porto Vitória;De 20 a menos de 50 ha;116;3745;23;93;773;2971;53;63;3;20;50;43;3;11;13;17;;
Porto Vitória;De 50 a menos de 100 ha;58;3991;9;49;689;3302;36;22;2;7;34;15;2;4;3;8;;
Porto Vitória;De 100 a menos de 200 ha;8;1129;7;1;0;0;4;4;4;3;0;1;1;0;0;0;;
Porto Vitória;De 200 a menos de 500 ha;2;0;2;0;0;0;1;1;1;1;0;0;0;1;0;0;;
Porto Vitória;De 500 a menos de 1.000 ha;1;0;1;0;0;0;1;0;1;0;0;0;0;0;0;0;;
Porto Vitória;De 1.000 a menos de 2.500 ha;1;0;1;0;0;0;0;1;0;1;0;0;0;1;0;0;;
Porto Vitória;De 2.500 a menos de 10.000 ha;1;0;1;0;0;0;0;1;0;1;0;0;0;1;0;0;;
Porto Vitória;De 10.000 ha e mais;0;0;0;0;0;0;0;0;0;0;0;0;0;0;0;0;;
Porto Vitória;Produtor sem área;3;0;2;1;0;0;0;0;0;0;0;0;0;0;0;0;;
Prado Ferreira;Mais de 0 a menos de 0,1 ha;1;0;0;1;0;0;0;1;0;0;0;1;0;0;0;1;;
Prado Ferreira;De 0,1 a menos de 0,2 ha;0;0;0;0;0;0;0;0;0;0;0;0;0;0;0;0;;
Prado Ferreira;De 0,2 a menos de 0,5 ha;2;0;0;2;0;0;1;1;0;0;1;1;0;0;0;1;;
Prado Ferreira;De 0,5 a menos de 1 ha;30;16;16;14;9;8;5;25;2;14;3;11;0;7;0;7;;
Prado Ferreira;De 1 a menos de 2 ha;3;4;2;1;0;0;0;3;0;2;0;1;0;1;0;0;;
Prado Ferreira;De 2 a menos de 3 ha;0;0;0;0;0;0;0;0;0;0;0;0;0;0;0;0;;
Prado Ferreira;De 3 a menos de 4 ha;2;0;1;1;0;0;2;0;1;0;1;0;0;0;0;0;;
Prado Ferreira;De 4 a menos de 5 ha;5;23;2;3;0;0;1;4;0;2;1;2;0;2;0;1;;
Prado Ferreira;De 5 a menos de 10 ha;8;56;2;6;0;0;5;3;0;2;5;1;0;2;0;0;;
Prado Ferreira;De 10 a menos de 20 ha;12;168;1;11;0;0;7;5;0;1;7;4;0;1;0;2;;
Prado Ferreira;De 20 a menos de 50 ha;7;219;1;6;0;0;7;0;1;0;6;0;0;0;0;0;;
Prado Ferreira;De 50 a menos de 100 ha;9;633;3;6;290;343;9;0;3;0;6;0;0;0;0;0;;
Prado Ferreira;De 100 a menos de 200 ha;5;663;5;0;663;0;4;1;4;1;0;0;0;1;0;0;;
Prado Ferreira;De 200 a menos de 500 ha;7;2118;7;0;2118;0;5;2;5;2;0;0;0;2;0;0;;
Prado Ferreira;De 500 a menos de 1.000 ha;6;4024;6;0;4024;0;6;0;6;0;0;0;0;0;0;0;;
Prado Ferreira;De 1.000 a menos de 2.500 ha;3;4959;3;0;4959;0;3;0;3;0;0;0;0;0;0;0;;
Prado Ferreira;De 2.500 a menos de 10.000 ha;0;0;0;0;0;0;0;0;0;0;0;0;0;0;0;0;;
Prado Ferreira;De 10.000 ha e mais;0;0;0;0;0;0;0;0;0;0;0;0;0;0;0;0;;
Prado Ferreira;Produtor sem área;0;0;0;0;0;0;0;0;0;0;0;0;0;0;0;0;;
Pranchita;Mais de 0 a menos de 0,1 ha;1;0;1;0;0;0;0;1;0;1;0;0;0;1;0;0;;
Pranchita;De 0,1 a menos de 0,2 ha;4;1;0;4;0;1;1;3;0;0;1;3;0;0;0;3;;
Pranchita;De 0,2 a menos de 0,5 ha;6;2;2;4;0;0;2;4;0;2;2;2;0;2;1;1;;
Pranchita;De 0,5 a menos de 1 ha;11;8;0;11;0;8;4;7;0;0;4;7;0;0;0;6;;
Pranchita;De 1 a menos de 2 ha;10;13;1;9;0;0;4;6;1;0;3;6;0;0;0;6;;
Pranchita;De 2 a menos de 3 ha;8;19;1;7;0;0;4;4;0;1;4;3;0;1;0;3;;
Pranchita;De 3 a menos de 4 ha;13;45;0;13;0;45;6;7;0;0;6;7;0;0;0;7;;
Pranchita;De 4 a menos de 5 ha;36;168;0;36;0;168;27;9;0;0;27;9;0;0;0;7;;
Pranchita;De 5 a menos de 10 ha;72;545;2;70;0;0;60;12;1;1;59;11;0;1;2;6;;
Pranchita;De 10 a menos de 20 ha;93;1319;2;91;0;0;79;14;1;1;78;13;0;1;0;10;;
Pranchita;De 20 a menos de 50 ha;112;3492;5;107;172;3320;106;6;3;2;103;4;0;2;0;4;;
Pranchita;De 50 a menos de 100 ha;55;3880;15;40;1337;2543;54;1;15;0;39;1;0;0;0;1;;
Pranchita;De 100 a menos de 200 ha;22;3044;22;0;3044;0;22;0;22;0;0;0;0;0;0;0;;
Pranchita;De 200 a menos de 500 ha;13;3804;13;0;3804;0;13;0;13;0;0;0;0;0;0;0;;
Pranchita;De 500 a menos de 1.000 ha;4;0;4;0;0;0;4;0;4;0;0;0;0;0;0;0;;
Pranchita;De 1.000 a menos de 2.500 ha;0;0;0;0;0;0;0;0;0;0;0;0;0;0;0;0;;
Pranchita;De 2.500 a menos de 10.000 ha;0;0;0;0;0;0;0;0;0;0;0;0;0;0;0;0;;
Pranchita;De 10.000 ha e mais;0;0;0;0;0;0;0;0;0;0;0;0;0;0;0;0;;
Pranchita;Produtor sem área;0;0;0;0;0;0;0;0;0;0;0;0;0;0;0;0;;
Presidente Castelo Branco;Mais de 0 a menos de 0,1 ha;1;0;0;1;0;0;0;1;0;0;0;1;0;0;1;0;;
Presidente Castelo Branco;De 0,1 a menos de 0,2 ha;0;0;0;0;0;0;0;0;0;0;0;0;0;0;0;0;;
Presidente Castelo Branco;De 0,2 a menos de 0,5 ha;1;0;1;0;0;0;1;0;1;0;0;0;0;0;0;0;;
Presidente Castelo Branco;De 0,5 a menos de 1 ha;22;11;6;16;3;8;3;19;1;5;2;14;3;2;3;8;;
Presidente Castelo Branco;De 1 a menos de 2 ha;6;9;5;1;0;0;3;3;2;3;1;0;0;3;0;0;;
Presidente Castelo Branco;De 2 a menos de 3 ha;23;58;13;10;34;24;14;9;8;5;6;4;0;4;1;3;;
Presidente Castelo Branco;De 3 a menos de 4 ha;21;69;12;9;40;29;20;1;12;0;8;1;0;0;0;1;;
Presidente Castelo Branco;De 4 a menos de 5 ha;23;107;15;8;69;38;18;5;13;2;5;3;0;2;0;3;;
Presidente Castelo Branco;De 5 a menos de 10 ha;42;313;16;26;123;191;36;6;14;2;22;4;0;2;0;4;;
Presidente Castelo Branco;De 10 a menos de 20 ha;49;705;18;31;254;451;38;11;16;2;22;9;0;2;1;8;;
Presidente Castelo Branco;De 20 a menos de 50 ha;52;1668;17;35;595;1072;42;10;15;2;27;8;0;2;0;8;;
Presidente Castelo Branco;De 50 a menos de 100 ha;24;1674;16;8;0;0;21;3;15;1;6;2;0;1;0;2;;
Presidente Castelo Branco;De 100 a menos de 200 ha;17;2251;17;0;2251;0;15;2;15;2;0;0;0;2;0;0;;
Presidente Castelo Branco;De 200 a menos de 500 ha;6;1720;6;0;1720;0;6;0;6;0;0;0;0;0;0;0;;
Presidente Castelo Branco;De 500 a menos de 1.000 ha;0;0;0;0;0;0;0;0;0;0;0;0;0;0;0;0;;
Presidente Castelo Branco;De 1.000 a menos de 2.500 ha;0;0;0;0;0;0;0;0;0;0;0;0;0;0;0;0;;
Presidente Castelo Branco;De 2.500 a menos de 10.000 ha;1;0;1;0;0;0;1;0;1;0;0;0;0;0;0;0;;
Presidente Castelo Branco;De 10.000 ha e mais;0;0;0;0;0;0;0;0;0;0;0;0;0;0;0;0;;
Presidente Castelo Branco;Produtor sem área;0;0;0;0;0;0;0;0;0;0;0;0;0;0;0;0;;
Primeiro de Maio;Mais de 0 a menos de 0,1 ha;0;0;0;0;0;0;0;0;0;0;0;0;0;0;0;0;;
Primeiro de Maio;De 0,1 a menos de 0,2 ha;0;0;0;0;0;0;0;0;0;0;0;0;0;0;0;0;;
Primeiro de Maio;De 0,2 a menos de 0,5 ha;5;0;2;3;0;0;1;4;0;2;1;2;0;2;0;2;;
Primeiro de Maio;De 0,5 a menos de 1 ha;7;5;1;6;0;0;3;4;0;1;3;3;0;1;0;3;;
Primeiro de Maio;De 1 a menos de 2 ha;11;14;1;10;0;0;4;7;0;1;4;6;0;1;0;6;;
Primeiro de Maio;De 2 a menos de 3 ha;9;23;1;8;0;0;4;5;0;1;4;4;0;1;0;3;;
Primeiro de Maio;De 3 a menos de 4 ha;11;37;2;9;0;0;5;6;1;1;4;5;0;1;0;4;;
Primeiro de Maio;De 4 a menos de 5 ha;13;60;2;11;0;0;8;5;1;1;7;4;0;0;0;4;;
Primeiro de Maio;De 5 a menos de 10 ha;73;549;2;71;0;0;48;25;1;1;47;24;0;1;2;15;;
Primeiro de Maio;De 10 a menos de 20 ha;98;1400;1;97;0;0;97;1;1;0;96;1;0;0;0;1;;
Primeiro de Maio;De 20 a menos de 50 ha;109;3502;5;104;164;3338;103;6;5;0;98;6;0;0;0;6;;
Primeiro de Maio;De 50 a menos de 100 ha;45;3298;31;14;2499;798;45;0;31;0;14;0;0;0;0;0;;
Primeiro de Maio;De 100 a menos de 200 ha;38;4963;38;0;4963;0;37;1;37;1;0;0;0;1;0;0;;
Primeiro de Maio;De 200 a menos de 500 ha;23;6969;23;0;6969;0;23;0;23;0;0;0;0;0;0;0;;
Primeiro de Maio;De 500 a menos de 1.000 ha;3;0;3;0;0;0;3;0;3;0;0;0;0;0;0;0;;
Primeiro de Maio;De 1.000 a menos de 2.500 ha;0;0;0;0;0;0;0;0;0;0;0;0;0;0;0;0;;
Primeiro de Maio;De 2.500 a menos de 10.000 ha;0;0;0;0;0;0;0;0;0;0;0;0;0;0;0;0;;
Primeiro de Maio;De 10.000 ha e mais;0;0;0;0;0;0;0;0;0;0;0;0;0;0;0;0;;
Primeiro de Maio;Produtor sem área;0;0;0;0;0;0;0;0;0;0;0;0;0;0;0;0;;
Prudentópolis;Mais de 0 a menos de 0,1 ha;24;2;6;18;0;0;6;18;0;6;6;12;0;5;1;11;;
Prudentópolis;De 0,1 a menos de 0,2 ha;32;5;11;21;2;3;9;23;3;8;6;15;0;8;1;13;;
Prudentópolis;De 0,2 a menos de 0,5 ha;98;36;37;61;14;22;36;62;14;23;22;39;0;19;3;27;;
Prudentópolis;De 0,5 a menos de 1 ha;141;101;28;113;20;81;65;76;10;18;55;58;0;14;5;37;;
Prudentópolis;De 1 a menos de 2 ha;279;394;46;233;64;330;183;96;27;19;156;77;2;14;10;55;;
Prudentópolis;De 2 a menos de 3 ha;525;1302;82;443;205;1097;410;115;54;28;356;87;0;20;11;54;;
Prudentópolis;De 3 a menos de 4 ha;445;1574;49;396;172;1402;364;81;34;15;330;66;1;6;7;38;;
Prudentópolis;De 4 a menos de 5 ha;550;2622;54;496;256;2366;471;79;38;16;433;63;1;7;7;46;;
Prudentópolis;De 5 a menos de 10 ha;1382;10338;112;1270;836;9502;1223;159;79;33;1144;126;2;27;14;87;;
Prudentópolis;De 10 a menos de 20 ha;1414;20396;74;1340;1001;19395;1261;153;49;25;1212;128;2;17;13;91;;
Prudentópolis;De 20 a menos de 50 ha;1212;37766;56;1156;1786;35980;1106;106;41;15;1065;91;0;14;10;75;;
Prudentópolis;De 50 a menos de 100 ha;336;23136;191;145;14816;8321;296;40;162;29;134;11;4;22;0;11;;
Prudentópolis;De 100 a menos de 200 ha;99;13911;99;0;13911;0;85;14;85;14;0;0;0;9;0;0;;
Prudentópolis;De 200 a menos de 500 ha;48;14871;48;0;14871;0;37;11;37;11;0;0;0;8;0;0;;
Prudentópolis;De 500 a menos de 1.000 ha;16;0;16;0;0;0;13;3;13;3;0;0;0;3;0;0;;
Prudentópolis;De 1.000 a menos de 2.500 ha;6;0;6;0;0;0;4;2;4;2;0;0;1;1;0;0;;
Prudentópolis;De 2.500 a menos de 10.000 ha;0;0;0;0;0;0;0;0;0;0;0;0;0;0;0;0;;
Prudentópolis;De 10.000 ha e mais;0;0;0;0;0;0;0;0;0;0;0;0;0;0;0;0;;
Prudentópolis;Produtor sem área;18;0;7;11;0;0;3;1;2;0;1;1;0;0;1;0;;
Quarto Centenário;Mais de 0 a menos de 0,1 ha;0;0;0;0;0;0;0;0;0;0;0;0;0;0;0;0;;
Quarto Centenário;De 0,1 a menos de 0,2 ha;1;0;1;0;0;0;1;0;1;0;0;0;0;0;0;0;;
Quarto Centenário;De 0,2 a menos de 0,5 ha;37;17;0;37;0;17;5;32;0;0;5;32;0;0;4;23;;
Quarto Centenário;De 0,5 a menos de 1 ha;0;0;0;0;0;0;0;0;0;0;0;0;0;0;0;0;;
Quarto Centenário;De 1 a menos de 2 ha;4;0;1;3;0;0;2;2;0;1;2;1;0;1;0;1;;
Quarto Centenário;De 2 a menos de 3 ha;13;32;1;12;0;0;7;6;0;1;7;5;0;1;1;4;;
Quarto Centenário;De 3 a menos de 4 ha;6;21;0;6;0;21;3;3;0;0;3;3;0;0;0;3;;
Quarto Centenário;De 4 a menos de 5 ha;7;34;0;7;0;34;5;2;0;0;5;2;0;0;0;2;;
Quarto Centenário;De 5 a menos de 10 ha;27;209;2;25;0;0;22;5;1;1;21;4;1;0;0;3;;
Quarto Centenário;De 10 a menos de 20 ha;22;349;1;21;0;0;20;2;1;0;19;2;0;0;0;1;;
Quarto Centenário;De 20 a menos de 50 ha;46;1393;7;39;222;1171;46;0;7;0;39;0;0;0;0;0;;
Quarto Centenário;De 50 a menos de 100 ha;16;1172;7;9;613;559;15;1;7;0;8;1;0;0;0;0;;
Quarto Centenário;De 100 a menos de 200 ha;16;2437;16;0;2437;0;16;0;16;0;0;0;0;0;0;0;;
Quarto Centenário;De 200 a menos de 500 ha;13;4047;13;0;4047;0;13;0;13;0;0;0;0;0;0;0;;
Quarto Centenário;De 500 a menos de 1.000 ha;5;2986;5;0;2986;0;5;0;5;0;0;0;0;0;0;0;;
Quarto Centenário;De 1.000 a menos de 2.500 ha;5;7293;5;0;7293;0;5;0;5;0;0;0;0;0;0;0;;
Quarto Centenário;De 2.500 a menos de 10.000 ha;1;0;1;0;0;0;1;0;1;0;0;0;0;0;0;0;;
Quarto Centenário;De 10.000 ha e mais;0;0;0;0;0;0;0;0;0;0;0;0;0;0;0;0;;
Quarto Centenário;Produtor sem área;0;0;0;0;0;0;0;0;0;0;0;0;0;0;0;0;;
Quatiguá;Mais de 0 a menos de 0,1 ha;1;0;0;1;0;0;0;1;0;0;0;1;0;0;0;1;;
Quatiguá;De 0,1 a menos de 0,2 ha;4;0;1;3;0;0;1;3;0;1;1;2;0;1;0;2;;
Quatiguá;De 0,2 a menos de 0,5 ha;3;0;0;3;0;0;0;3;0;0;0;3;0;0;0;2;;
Quatiguá;De 0,5 a menos de 1 ha;9;6;1;8;0;0;0;9;0;1;0;8;0;1;1;6;;
Quatiguá;De 1 a menos de 2 ha;14;20;2;12;0;0;1;13;0;2;1;11;0;2;0;6;;
Quatiguá;De 2 a menos de 3 ha;14;33;0;14;0;33;4;10;0;0;4;10;0;0;0;6;;
Quatiguá;De 3 a menos de 4 ha;17;60;1;16;0;0;3;14;0;1;3;13;0;0;0;9;;
Quatiguá;De 4 a menos de 5 ha;16;76;0;16;0;76;5;11;0;0;5;11;0;0;0;9;;
Quatiguá;De 5 a menos de 10 ha;41;312;3;38;19;293;6;35;0;3;6;32;0;3;0;21;;
Quatiguá;De 10 a menos de 20 ha;54;794;5;49;71;722;14;40;1;4;13;36;0;3;0;27;;
Quatiguá;De 20 a menos de 50 ha;82;2592;5;77;182;2410;23;59;3;2;20;57;0;2;0;49;;
Quatiguá;De 50 a menos de 100 ha;25;1826;14;11;1168;658;7;18;4;10;3;8;0;7;0;8;;
Quatiguá;De 100 a menos de 200 ha;15;2139;15;0;2139;0;6;9;6;9;0;0;0;7;0;0;;
Quatiguá;De 200 a menos de 500 ha;9;2735;9;0;2735;0;1;8;1;8;0;0;0;5;0;0;;
Quatiguá;De 500 a menos de 1.000 ha;0;0;0;0;0;0;0;0;0;0;0;0;0;0;0;0;;
Quatiguá;De 1.000 a menos de 2.500 ha;0;0;0;0;0;0;0;0;0;0;0;0;0;0;0;0;;
Quatiguá;De 2.500 a menos de 10.000 ha;0;0;0;0;0;0;0;0;0;0;0;0;0;0;0;0;;
Quatiguá;De 10.000 ha e mais;0;0;0;0;0;0;0;0;0;0;0;0;0;0;0;0;;
Quatiguá;Produtor sem área;0;0;0;0;0;0;0;0;0;0;0;0;0;0;0;0;;
Quatro Barras;Mais de 0 a menos de 0,1 ha;1;0;0;1;0;0;0;1;0;0;0;1;0;0;0;1;;
Quatro Barras;De 0,1 a menos de 0,2 ha;2;0;1;1;0;0;0;2;0;1;0;1;0;1;0;1;;
Quatro Barras;De 0,2 a menos de 0,5 ha;4;1;1;3;0;0;0;4;0;1;0;3;0;1;0;3;;
Quatro Barras;De 0,5 a menos de 1 ha;12;7;8;4;4;3;0;12;0;8;0;4;1;5;0;4;;
Quatro Barras;De 1 a menos de 2 ha;16;21;9;7;13;8;0;16;0;9;0;7;1;8;2;4;;
Quatro Barras;De 2 a menos de 3 ha;11;25;8;3;0;0;0;11;0;8;0;3;0;7;0;3;;
Quatro Barras;De 3 a menos de 4 ha;8;29;3;5;11;18;0;8;0;3;0;5;1;2;1;3;;
Quatro Barras;De 4 a menos de 5 ha;15;71;7;8;33;38;0;15;0;7;0;8;0;7;1;7;;
Quatro Barras;De 5 a menos de 10 ha;23;168;14;9;104;64;1;22;1;13;0;9;1;10;1;6;;
Quatro Barras;De 10 a menos de 20 ha;11;149;5;6;68;81;1;10;1;4;0;6;1;2;1;5;;
Quatro Barras;De 20 a menos de 50 ha;16;517;12;4;419;98;1;15;0;12;1;3;0;11;0;2;;
Quatro Barras;De 50 a menos de 100 ha;5;335;5;0;335;0;0;5;0;5;0;0;0;5;0;0;;
Quatro Barras;De 100 a menos de 200 ha;3;0;3;0;0;0;0;3;0;3;0;0;0;2;0;0;;
Quatro Barras;De 200 a menos de 500 ha;6;2073;6;0;2073;0;0;6;0;6;0;0;0;5;0;0;;
Quatro Barras;De 500 a menos de 1.000 ha;0;0;0;0;0;0;0;0;0;0;0;0;0;0;0;0;;
Quatro Barras;De 1.000 a menos de 2.500 ha;0;0;0;0;0;0;0;0;0;0;0;0;0;0;0;0;;
Quatro Barras;De 2.500 a menos de 10.000 ha;0;0;0;0;0;0;0;0;0;0;0;0;0;0;0;0;;
Quatro Barras;De 10.000 ha e mais;0;0;0;0;0;0;0;0;0;0;0;0;0;0;0;0;;
Quatro Barras;Produtor sem área;0;0;0;0;0;0;0;0;0;0;0;0;0;0;0;0;;
Quatro Pontes;Mais de 0 a menos de 0,1 ha;1;0;1;0;0;0;1;0;1;0;0;0;0;0;0;0;;
Quatro Pontes;De 0,1 a menos de 0,2 ha;1;0;1;0;0;0;0;1;0;1;0;0;0;1;0;0;;
Quatro Pontes;De 0,2 a menos de 0,5 ha;0;0;0;0;0;0;0;0;0;0;0;0;0;0;0;0;;
Quatro Pontes;De 0,5 a menos de 1 ha;1;0;0;1;0;0;0;1;0;0;0;1;0;0;0;1;;
Quatro Pontes;De 1 a menos de 2 ha;11;14;8;3;0;0;2;9;2;6;0;3;0;5;0;2;;
Quatro Pontes;De 2 a menos de 3 ha;14;33;7;7;17;17;2;12;0;7;2;5;1;6;0;4;;
Quatro Pontes;De 3 a menos de 4 ha;19;65;7;12;25;40;9;10;3;4;6;6;0;4;0;6;;
Quatro Pontes;De 4 a menos de 5 ha;14;63;5;9;22;41;7;7;3;2;4;5;1;1;0;4;;
Quatro Pontes;De 5 a menos de 10 ha;54;414;9;45;57;357;35;19;5;4;30;15;0;4;0;14;;
Quatro Pontes;De 10 a menos de 20 ha;103;1465;15;88;222;1243;83;20;10;5;73;15;0;3;2;11;;
Quatro Pontes;De 20 a menos de 50 ha;92;2735;9;83;250;2485;87;5;6;3;81;2;0;3;0;2;;
Quatro Pontes;De 50 a menos de 100 ha;43;2945;21;22;1645;1300;43;0;21;0;22;0;0;0;0;0;;
Quatro Pontes;De 100 a menos de 200 ha;9;1131;9;0;1131;0;9;0;9;0;0;0;0;0;0;0;;
Quatro Pontes;De 200 a menos de 500 ha;2;0;2;0;0;0;2;0;2;0;0;0;0;0;0;0;;
Quatro Pontes;De 500 a menos de 1.000 ha;0;0;0;0;0;0;0;0;0;0;0;0;0;0;0;0;;
Quatro Pontes;De 1.000 a menos de 2.500 ha;0;0;0;0;0;0;0;0;0;0;0;0;0;0;0;0;;
Quatro Pontes;De 2.500 a menos de 10.000 ha;0;0;0;0;0;0;0;0;0;0;0;0;0;0;0;0;;
Quatro Pontes;De 10.000 ha e mais;0;0;0;0;0;0;0;0;0;0;0;0;0;0;0;0;;
Quatro Pontes;Produtor sem área;1;0;1;0;0;0;0;0;0;0;0;0;0;0;0;0;;
Quedas do Iguaçu;Mais de 0 a menos de 0,1 ha;56;4;25;31;0;0;2;54;1;24;1;30;7;17;11;17;;
Quedas do Iguaçu;De 0,1 a menos de 0,2 ha;75;9;25;50;3;6;11;64;3;22;8;42;8;14;26;16;;
Quedas do Iguaçu;De 0,2 a menos de 0,5 ha;74;23;22;52;7;16;8;66;3;19;5;47;9;10;22;25;;
Quedas do Iguaçu;De 0,5 a menos de 1 ha;345;219;74;271;47;172;86;259;20;54;66;205;32;19;101;92;;
Quedas do Iguaçu;De 1 a menos de 2 ha;320;406;27;293;34;372;53;267;4;23;49;244;10;12;91;149;;
Quedas do Iguaçu;De 2 a menos de 3 ha;132;316;22;110;52;264;55;77;10;12;45;65;4;8;22;42;;
Quedas do Iguaçu;De 3 a menos de 4 ha;46;161;7;39;25;136;29;17;3;4;26;13;0;4;3;10;;
Quedas do Iguaçu;De 4 a menos de 5 ha;89;425;14;75;68;357;59;30;8;6;51;24;0;4;6;16;;
Quedas do Iguaçu;De 5 a menos de 10 ha;278;2224;36;242;285;1940;218;60;28;8;190;52;0;8;2;41;;
Quedas do Iguaçu;De 10 a menos de 20 ha;1286;17178;59;1227;791;16386;1038;248;45;14;993;234;0;14;28;165;;
Quedas do Iguaçu;De 20 a menos de 50 ha;333;9429;17;316;528;8901;286;47;15;2;271;45;0;1;1;35;;
Quedas do Iguaçu;De 50 a menos de 100 ha;53;3551;10;43;797;2754;49;4;10;0;39;4;0;0;0;3;;
Quedas do Iguaçu;De 100 a menos de 200 ha;28;4048;28;0;4048;0;27;1;27;1;0;0;0;1;0;0;;
Quedas do Iguaçu;De 200 a menos de 500 ha;19;6179;19;0;6179;0;18;1;18;1;0;0;0;1;0;0;;
Quedas do Iguaçu;De 500 a menos de 1.000 ha;5;0;5;0;0;0;4;1;4;1;0;0;0;0;0;0;;
Quedas do Iguaçu;De 1.000 a menos de 2.500 ha;0;0;0;0;0;0;0;0;0;0;0;0;0;0;0;0;;
Quedas do Iguaçu;De 2.500 a menos de 10.000 ha;0;0;0;0;0;0;0;0;0;0;0;0;0;0;0;0;;
Quedas do Iguaçu;De 10.000 ha e mais;1;0;1;0;0;0;0;1;0;1;0;0;0;0;0;0;;
Quedas do Iguaçu;Produtor sem área;3;0;0;3;0;0;0;2;0;0;0;2;0;0;0;2;;
Querência do Norte;Mais de 0 a menos de 0,1 ha;0;0;0;0;0;0;0;0;0;0;0;0;0;0;0;0;;
Querência do Norte;De 0,1 a menos de 0,2 ha;0;0;0;0;0;0;0;0;0;0;0;0;0;0;0;0;;
Querência do Norte;De 0,2 a menos de 0,5 ha;0;0;0;0;0;0;0;0;0;0;0;0;0;0;0;0;;
Querência do Norte;De 0,5 a menos de 1 ha;15;8;8;7;5;4;3;12;3;5;0;7;4;0;1;2;;
Querência do Norte;De 1 a menos de 2 ha;5;0;4;1;0;0;0;5;0;4;0;1;0;3;0;1;;
Querência do Norte;De 2 a menos de 3 ha;16;38;2;14;0;0;2;14;0;2;2;12;0;2;0;10;;
Querência do Norte;De 3 a menos de 4 ha;12;43;4;8;14;29;1;11;0;4;1;7;0;2;0;7;;
Querência do Norte;De 4 a menos de 5 ha;20;95;5;15;24;71;4;16;1;4;3;12;1;3;0;12;;
Querência do Norte;De 5 a menos de 10 ha;102;870;6;96;45;825;19;83;2;4;17;79;0;4;6;69;;
Querência do Norte;De 10 a menos de 20 ha;275;4544;27;248;451;4093;85;190;12;15;73;175;0;14;0;152;;
Querência do Norte;De 20 a menos de 50 ha;442;11772;23;419;590;11183;187;255;7;16;180;239;0;12;19;190;;
Querência do Norte;De 50 a menos de 100 ha;42;2755;2;40;0;0;25;17;2;0;23;17;0;0;0;13;;
Querência do Norte;De 100 a menos de 200 ha;29;4242;24;5;3699;542;17;12;14;10;3;2;0;9;0;2;;
Querência do Norte;De 200 a menos de 500 ha;39;13044;39;0;13044;0;22;17;22;17;0;0;0;14;0;0;;
Querência do Norte;De 500 a menos de 1.000 ha;19;13574;19;0;13574;0;9;10;9;10;0;0;0;8;0;0;;
Querência do Norte;De 1.000 a menos de 2.500 ha;10;16264;10;0;16264;0;6;4;6;4;0;0;1;2;0;0;;
Querência do Norte;De 2.500 a menos de 10.000 ha;1;0;1;0;0;0;0;1;0;1;0;0;0;0;0;0;;
Querência do Norte;De 10.000 ha e mais;0;0;0;0;0;0;0;0;0;0;0;0;0;0;0;0;;
Querência do Norte;Produtor sem área;8;0;5;3;0;0;0;8;0;5;0;3;0;4;0;3;;
Quinta do Sol;Mais de 0 a menos de 0,1 ha;0;0;0;0;0;0;0;0;0;0;0;0;0;0;0;0;;
Quinta do Sol;De 0,1 a menos de 0,2 ha;0;0;0;0;0;0;0;0;0;0;0;0;0;0;0;0;;
Quinta do Sol;De 0,2 a menos de 0,5 ha;0;0;0;0;0;0;0;0;0;0;0;0;0;0;0;0;;
Quinta do Sol;De 0,5 a menos de 1 ha;9;5;0;9;0;5;4;5;0;0;4;5;0;0;0;2;;
Quinta do Sol;De 1 a menos de 2 ha;4;6;2;2;0;0;2;2;1;1;1;1;0;0;0;0;;
Quinta do Sol;De 2 a menos de 3 ha;6;14;2;4;0;0;4;2;1;1;3;1;0;1;0;1;;
Quinta do Sol;De 3 a menos de 4 ha;4;0;0;4;0;0;2;2;0;0;2;2;0;0;0;1;;
Quinta do Sol;De 4 a menos de 5 ha;9;42;2;7;0;0;6;3;0;2;6;1;0;2;0;0;;
Quinta do Sol;De 5 a menos de 10 ha;11;83;3;8;22;61;10;1;2;1;8;0;0;1;0;0;;
Quinta do Sol;De 10 a menos de 20 ha;106;1482;3;103;39;1443;104;2;2;1;102;1;0;1;0;0;;
Quinta do Sol;De 20 a menos de 50 ha;40;1242;1;39;0;0;36;4;1;0;35;4;0;0;0;4;;
Quinta do Sol;De 50 a menos de 100 ha;12;844;3;9;237;608;10;2;3;0;7;2;0;0;0;1;;
Quinta do Sol;De 100 a menos de 200 ha;21;3121;21;0;3121;0;21;0;21;0;0;0;0;0;0;0;;
Quinta do Sol;De 200 a menos de 500 ha;17;5376;17;0;5376;0;16;1;16;1;0;0;0;1;0;0;;
Quinta do Sol;De 500 a menos de 1.000 ha;15;10830;15;0;10830;0;15;0;15;0;0;0;0;0;0;0;;
Quinta do Sol;De 1.000 a menos de 2.500 ha;3;0;3;0;0;0;3;0;3;0;0;0;0;0;0;0;;
Quinta do Sol;De 2.500 a menos de 10.000 ha;1;0;1;0;0;0;1;0;1;0;0;0;0;0;0;0;;
Quinta do Sol;De 10.000 ha e mais;0;0;0;0;0;0;0;0;0;0;0;0;0;0;0;0;;
Quinta do Sol;Produtor sem área;0;0;0;0;0;0;0;0;0;0;0;0;0;0;0;0;;
Quitandinha;Mais de 0 a menos de 0,1 ha;5;0;0;5;0;0;2;3;0;0;2;3;0;0;0;2;;
Quitandinha;De 0,1 a menos de 0,2 ha;8;1;0;8;0;1;2;6;0;0;2;6;0;0;0;3;;
Quitandinha;De 0,2 a menos de 0,5 ha;40;14;4;36;2;13;18;22;2;2;16;20;0;1;1;7;;
Quitandinha;De 0,5 a menos de 1 ha;76;56;8;68;6;50;43;33;6;2;37;31;0;1;5;15;;
Quitandinha;De 1 a menos de 2 ha;111;160;9;102;13;147;87;24;7;2;80;22;0;2;2;12;;
Quitandinha;De 2 a menos de 3 ha;154;376;12;142;30;346;118;36;6;6;112;30;1;4;1;12;;
Quitandinha;De 3 a menos de 4 ha;131;458;6;125;21;437;117;14;6;0;111;14;0;0;2;4;;
Quitandinha;De 4 a menos de 5 ha;135;632;4;131;17;615;125;10;2;2;123;8;0;2;2;3;;
Quitandinha;De 5 a menos de 10 ha;299;2247;8;291;61;2186;275;24;7;1;268;23;0;1;1;15;;
Quitandinha;De 10 a menos de 20 ha;275;3951;3;272;45;3906;260;15;2;1;258;14;0;1;1;11;;
Quitandinha;De 20 a menos de 50 ha;177;5512;4;173;131;5381;167;10;3;1;164;9;0;1;1;4;;
Quitandinha;De 50 a menos de 100 ha;50;3468;15;35;1262;2206;37;13;9;6;28;7;0;4;2;5;;
Quitandinha;De 100 a menos de 200 ha;18;2356;18;0;2356;0;13;5;13;5;0;0;0;4;0;0;;
Quitandinha;De 200 a menos de 500 ha;4;0;4;0;0;0;2;2;2;2;0;0;0;1;0;0;;
Quitandinha;De 500 a menos de 1.000 ha;2;0;2;0;0;0;1;1;1;1;0;0;0;1;0;0;;
Quitandinha;De 1.000 a menos de 2.500 ha;1;0;1;0;0;0;1;0;1;0;0;0;0;0;0;0;;
Quitandinha;De 2.500 a menos de 10.000 ha;0;0;0;0;0;0;0;0;0;0;0;0;0;0;0;0;;
Quitandinha;De 10.000 ha e mais;0;0;0;0;0;0;0;0;0;0;0;0;0;0;0;0;;
Quitandinha;Produtor sem área;2;0;0;2;0;0;0;0;0;0;0;0;0;0;0;0;;
Ramilândia;Mais de 0 a menos de 0,1 ha;2;0;0;2;0;0;1;1;0;0;1;1;0;0;0;1;;
Ramilândia;De 0,1 a menos de 0,2 ha;2;0;1;1;0;0;1;1;1;0;0;1;0;0;0;1;;
Ramilândia;De 0,2 a menos de 0,5 ha;3;1;1;2;0;0;0;3;0;1;0;2;0;1;0;2;;
Ramilândia;De 0,5 a menos de 1 ha;3;2;1;2;0;0;0;3;0;1;0;2;0;1;0;2;;
Ramilândia;De 1 a menos de 2 ha;9;12;3;6;4;9;1;8;0;3;1;5;0;3;0;5;;
Ramilândia;De 2 a menos de 3 ha;8;20;1;7;0;0;2;6;0;1;2;5;0;1;1;4;;
Ramilândia;De 3 a menos de 4 ha;6;22;1;5;0;0;2;4;0;1;2;3;0;0;0;2;;
Ramilândia;De 4 a menos de 5 ha;37;175;5;32;24;151;12;25;2;3;10;22;0;2;4;14;;
Ramilândia;De 5 a menos de 10 ha;121;809;5;116;38;771;53;68;2;3;51;65;0;3;31;27;;
Ramilândia;De 10 a menos de 20 ha;279;4052;25;254;343;3709;175;104;14;11;161;93;0;5;11;40;;
Ramilândia;De 20 a menos de 50 ha;67;1916;11;56;378;1538;43;24;7;4;36;20;0;2;0;17;;
Ramilândia;De 50 a menos de 100 ha;17;1182;7;10;624;558;10;7;3;4;7;3;0;4;0;2;;
Ramilândia;De 100 a menos de 200 ha;20;2830;20;0;2830;0;15;5;15;5;0;0;1;4;0;0;;
Ramilândia;De 200 a menos de 500 ha;21;6371;21;0;6371;0;12;9;12;9;0;0;1;8;0;0;;
Ramilândia;De 500 a menos de 1.000 ha;4;2511;4;0;2511;0;4;0;4;0;0;0;0;0;0;0;;
Ramilândia;De 1.000 a menos de 2.500 ha;2;0;2;0;0;0;1;1;1;1;0;0;0;1;0;0;;
Ramilândia;De 2.500 a menos de 10.000 ha;0;0;0;0;0;0;0;0;0;0;0;0;0;0;0;0;;
Ramilândia;De 10.000 ha e mais;0;0;0;0;0;0;0;0;0;0;0;0;0;0;0;0;;
Ramilândia;Produtor sem área;0;0;0;0;0;0;0;0;0;0;0;0;0;0;0;0;;
Rancho Alegre;Mais de 0 a menos de 0,1 ha;0;0;0;0;0;0;0;0;0;0;0;0;0;0;0;0;;
Rancho Alegre;De 0,1 a menos de 0,2 ha;0;0;0;0;0;0;0;0;0;0;0;0;0;0;0;0;;
Rancho Alegre;De 0,2 a menos de 0,5 ha;1;0;0;1;0;0;0;1;0;0;0;1;0;0;1;0;;
Rancho Alegre;De 0,5 a menos de 1 ha;1;0;0;1;0;0;1;0;0;0;1;0;0;0;0;0;;
Rancho Alegre;De 1 a menos de 2 ha;6;8;0;6;0;8;5;1;0;0;5;1;0;0;0;1;;
Rancho Alegre;De 2 a menos de 3 ha;1;0;0;1;0;0;1;0;0;0;1;0;0;0;0;0;;
Rancho Alegre;De 3 a menos de 4 ha;7;22;0;7;0;22;4;3;0;0;4;3;0;0;1;2;;
Rancho Alegre;De 4 a menos de 5 ha;11;52;1;10;0;0;7;4;1;0;6;4;0;0;0;2;;
Rancho Alegre;De 5 a menos de 10 ha;45;363;5;40;38;326;44;1;5;0;39;1;0;0;0;0;;
Rancho Alegre;De 10 a menos de 20 ha;56;815;9;47;147;668;55;1;9;0;46;1;0;0;0;1;;
Rancho Alegre;De 20 a menos de 50 ha;59;1749;11;48;382;1367;57;2;11;0;46;2;0;0;0;2;;
Rancho Alegre;De 50 a menos de 100 ha;21;1487;14;7;1076;411;21;0;14;0;7;0;0;0;0;0;;
Rancho Alegre;De 100 a menos de 200 ha;14;1878;14;0;1878;0;14;0;14;0;0;0;0;0;0;0;;
Rancho Alegre;De 200 a menos de 500 ha;9;2131;9;0;2131;0;9;0;9;0;0;0;0;0;0;0;;
Rancho Alegre;De 500 a menos de 1.000 ha;2;0;2;0;0;0;2;0;2;0;0;0;0;0;0;0;;
Rancho Alegre;De 1.000 a menos de 2.500 ha;1;0;1;0;0;0;1;0;1;0;0;0;0;0;0;0;;
Rancho Alegre;De 2.500 a menos de 10.000 ha;0;0;0;0;0;0;0;0;0;0;0;0;0;0;0;0;;
Rancho Alegre;De 10.000 ha e mais;0;0;0;0;0;0;0;0;0;0;0;0;0;0;0;0;;
Rancho Alegre;Produtor sem área;0;0;0;0;0;0;0;0;0;0;0;0;0;0;0;0;;
Rancho Alegre D'Oeste;Mais de 0 a menos de 0,1 ha;2;0;0;2;0;0;0;2;0;0;0;2;0;0;1;1;;
Rancho Alegre D'Oeste;De 0,1 a menos de 0,2 ha;0;0;0;0;0;0;0;0;0;0;0;0;0;0;0;0;;
Rancho Alegre D'Oeste;De 0,2 a menos de 0,5 ha;1;0;0;1;0;0;0;1;0;0;0;1;0;0;0;1;;
Rancho Alegre D'Oeste;De 0,5 a menos de 1 ha;6;3;0;6;0;3;4;2;0;0;4;2;0;0;1;0;;
Rancho Alegre D'Oeste;De 1 a menos de 2 ha;1;0;0;1;0;0;1;0;0;0;1;0;0;0;0;0;;
Rancho Alegre D'Oeste;De 2 a menos de 3 ha;2;0;1;1;0;0;2;0;1;0;1;0;0;0;0;0;;
Rancho Alegre D'Oeste;De 3 a menos de 4 ha;4;14;2;2;0;0;1;3;0;2;1;1;2;0;1;0;;
Rancho Alegre D'Oeste;De 4 a menos de 5 ha;10;48;1;9;0;0;4;6;0;1;4;5;0;1;3;2;;
Rancho Alegre D'Oeste;De 5 a menos de 10 ha;26;201;3;23;23;177;20;6;2;1;18;5;0;0;2;1;;
Rancho Alegre D'Oeste;De 10 a menos de 20 ha;44;640;1;43;0;0;41;3;0;1;41;2;0;1;0;2;;
Rancho Alegre D'Oeste;De 20 a menos de 50 ha;68;2165;2;66;0;0;66;2;2;0;64;2;0;0;1;1;;
Rancho Alegre D'Oeste;De 50 a menos de 100 ha;29;2125;10;19;891;1234;28;1;10;0;18;1;0;0;1;0;;
Rancho Alegre D'Oeste;De 100 a menos de 200 ha;23;3497;23;0;3497;0;22;1;22;1;0;0;0;1;0;0;;
Rancho Alegre D'Oeste;De 200 a menos de 500 ha;18;6027;18;0;6027;0;17;1;17;1;0;0;1;0;0;0;;
Rancho Alegre D'Oeste;De 500 a menos de 1.000 ha;3;2495;3;0;2495;0;3;0;3;0;0;0;0;0;0;0;;
Rancho Alegre D'Oeste;De 1.000 a menos de 2.500 ha;2;0;2;0;0;0;2;0;2;0;0;0;0;0;0;0;;
Rancho Alegre D'Oeste;De 2.500 a menos de 10.000 ha;1;0;1;0;0;0;1;0;1;0;0;0;0;0;0;0;;
Rancho Alegre D'Oeste;De 10.000 ha e mais;0;0;0;0;0;0;0;0;0;0;0;0;0;0;0;0;;
Rancho Alegre D'Oeste;Produtor sem área;0;0;0;0;0;0;0;0;0;0;0;0;0;0;0;0;;
Realeza;Mais de 0 a menos de 0,1 ha;8;0;1;7;0;0;2;6;0;1;2;5;0;1;0;5;;
Realeza;De 0,1 a menos de 0,2 ha;11;1;6;5;0;0;3;8;2;4;1;4;0;4;1;2;;
Realeza;De 0,2 a menos de 0,5 ha;12;4;2;10;0;0;3;9;1;1;2;8;0;1;1;4;;
Realeza;De 0,5 a menos de 1 ha;9;5;2;7;0;0;1;8;1;1;0;7;0;1;1;5;;
Realeza;De 1 a menos de 2 ha;31;43;8;23;10;33;7;24;2;6;5;18;0;4;1;15;;
Realeza;De 2 a menos de 3 ha;40;97;7;33;17;80;19;21;4;3;15;18;0;3;3;10;;
Realeza;De 3 a menos de 4 ha;36;122;7;29;24;99;16;20;4;3;12;17;1;2;1;16;;
Realeza;De 4 a menos de 5 ha;54;254;11;43;51;203;41;13;7;4;34;9;0;3;2;6;;
Realeza;De 5 a menos de 10 ha;166;1264;25;141;195;1069;127;39;14;11;113;28;1;9;1;21;;
Realeza;De 10 a menos de 20 ha;199;2895;6;193;89;2806;171;28;3;3;168;25;0;2;0;20;;
Realeza;De 20 a menos de 50 ha;224;6995;16;208;520;6475;217;7;13;3;204;4;0;3;0;3;;
Realeza;De 50 a menos de 100 ha;74;4927;19;55;1594;3333;72;2;19;0;53;2;0;0;0;1;;
Realeza;De 100 a menos de 200 ha;32;4255;32;0;4255;0;32;0;32;0;0;0;0;0;0;0;;
Realeza;De 200 a menos de 500 ha;11;3043;11;0;3043;0;9;2;9;2;0;0;0;2;0;0;;
Realeza;De 500 a menos de 1.000 ha;8;0;8;0;0;0;7;1;7;1;0;0;0;0;0;0;;
Realeza;De 1.000 a menos de 2.500 ha;1;0;1;0;0;0;1;0;1;0;0;0;0;0;0;0;;
Realeza;De 2.500 a menos de 10.000 ha;1;0;1;0;0;0;1;0;1;0;0;0;0;0;0;0;;
Realeza;De 10.000 ha e mais;0;0;0;0;0;0;0;0;0;0;0;0;0;0;0;0;;
Realeza;Produtor sem área;0;0;0;0;0;0;0;0;0;0;0;0;0;0;0;0;;
Rebouças;Mais de 0 a menos de 0,1 ha;5;0;3;2;0;0;2;3;1;2;1;1;0;1;1;0;;
Rebouças;De 0,1 a menos de 0,2 ha;11;2;7;4;0;0;3;8;2;5;1;3;0;3;0;1;;
Rebouças;De 0,2 a menos de 0,5 ha;38;15;9;29;4;11;18;20;7;2;11;18;0;0;4;7;;
Rebouças;De 0,5 a menos de 1 ha;49;35;13;36;9;26;28;21;9;4;19;17;0;4;3;3;;
Rebouças;De 1 a menos de 2 ha;79;115;10;69;13;102;58;21;7;3;51;18;0;2;1;11;;
Rebouças;De 2 a menos de 3 ha;98;242;14;84;33;208;82;16;9;5;73;11;0;3;3;3;;
Rebouças;De 3 a menos de 4 ha;90;307;8;82;30;277;77;13;5;3;72;10;0;1;0;4;;
Rebouças;De 4 a menos de 5 ha;99;469;11;88;52;418;88;11;8;3;80;8;1;1;1;2;;
Rebouças;De 5 a menos de 10 ha;252;1866;16;236;109;1757;224;28;12;4;212;24;0;2;4;6;;
Rebouças;De 10 a menos de 20 ha;226;3309;12;214;193;3116;210;16;12;0;198;16;0;0;2;10;;
Rebouças;De 20 a menos de 50 ha;185;6061;14;171;490;5571;174;11;9;5;165;6;0;3;1;3;;
Rebouças;De 50 a menos de 100 ha;61;4144;36;25;2720;1424;57;4;33;3;24;1;0;1;1;0;;
Rebouças;De 100 a menos de 200 ha;24;3529;24;0;3529;0;24;0;24;0;0;0;0;0;0;0;;
Rebouças;De 200 a menos de 500 ha;17;5264;17;0;5264;0;14;3;14;3;0;0;0;3;0;0;;
Rebouças;De 500 a menos de 1.000 ha;7;4591;7;0;4591;0;7;0;7;0;0;0;0;0;0;0;;
Rebouças;De 1.000 a menos de 2.500 ha;1;0;1;0;0;0;1;0;1;0;0;0;0;0;0;0;;
Rebouças;De 2.500 a menos de 10.000 ha;0;0;0;0;0;0;0;0;0;0;0;0;0;0;0;0;;
Rebouças;De 10.000 ha e mais;0;0;0;0;0;0;0;0;0;0;0;0;0;0;0;0;;
Rebouças;Produtor sem área;0;0;0;0;0;0;0;0;0;0;0;0;0;0;0;0;;
Renascença;Mais de 0 a menos de 0,1 ha;1;0;1;0;0;0;0;1;0;1;0;0;0;1;0;0;;
Renascença;De 0,1 a menos de 0,2 ha;1;0;0;1;0;0;0;1;0;0;0;1;0;0;0;1;;
Renascença;De 0,2 a menos de 0,5 ha;4;1;1;3;0;0;2;2;1;0;1;2;0;0;0;2;;
Renascença;De 0,5 a menos de 1 ha;6;4;1;5;0;0;1;5;0;1;1;4;0;1;0;4;;
Renascença;De 1 a menos de 2 ha;17;23;2;15;0;0;5;12;1;1;4;11;0;1;0;10;;
Renascença;De 2 a menos de 3 ha;18;44;6;12;15;30;6;12;2;4;4;8;0;4;0;8;;
Renascença;De 3 a menos de 4 ha;14;51;4;10;14;36;10;4;3;1;7;3;0;1;0;3;;
Renascença;De 4 a menos de 5 ha;41;196;2;39;0;0;21;20;1;1;20;19;0;1;0;18;;
Renascença;De 5 a menos de 10 ha;113;908;10;103;76;832;85;28;7;3;78;25;0;3;0;18;;
Renascença;De 10 a menos de 20 ha;288;4023;6;282;76;3946;264;24;3;3;261;21;0;2;1;12;;
Renascença;De 20 a menos de 50 ha;138;4378;8;130;269;4110;132;6;6;2;126;4;0;2;0;3;;
Renascença;De 50 a menos de 100 ha;71;4933;24;47;2044;2889;70;1;24;0;46;1;0;0;0;1;;
Renascença;De 100 a menos de 200 ha;44;6011;44;0;6011;0;44;0;44;0;0;0;0;0;0;0;;
Renascença;De 200 a menos de 500 ha;20;7032;20;0;7032;0;20;0;20;0;0;0;0;0;0;0;;
Renascença;De 500 a menos de 1.000 ha;2;0;2;0;0;0;2;0;2;0;0;0;0;0;0;0;;
Renascença;De 1.000 a menos de 2.500 ha;5;8614;5;0;8614;0;5;0;5;0;0;0;0;0;0;0;;
Renascença;De 2.500 a menos de 10.000 ha;0;0;0;0;0;0;0;0;0;0;0;0;0;0;0;0;;
Renascença;De 10.000 ha e mais;0;0;0;0;0;0;0;0;0;0;0;0;0;0;0;0;;
Renascença;Produtor sem área;4;0;0;4;0;0;0;3;0;0;0;3;0;0;0;2;;
Reserva;Mais de 0 a menos de 0,1 ha;8;0;0;8;0;0;2;6;0;0;2;6;0;0;0;5;;
Reserva;De 0,1 a menos de 0,2 ha;21;3;4;17;1;2;4;17;2;2;2;15;1;1;1;13;;
Reserva;De 0,2 a menos de 0,5 ha;25;9;7;18;2;7;9;16;1;6;8;10;1;5;4;4;;
Reserva;De 0,5 a menos de 1 ha;21;13;4;17;0;0;7;14;1;3;6;11;0;3;5;6;;
Reserva;De 1 a menos de 2 ha;39;53;13;26;18;35;23;16;8;5;15;11;0;5;2;5;;
Reserva;De 2 a menos de 3 ha;76;185;15;61;36;148;38;38;8;7;30;31;0;6;4;23;;
Reserva;De 3 a menos de 4 ha;62;220;14;48;49;171;42;20;11;3;31;17;0;3;1;8;;
Reserva;De 4 a menos de 5 ha;98;471;12;86;58;412;46;52;8;4;38;48;0;4;1;34;;
Reserva;De 5 a menos de 10 ha;176;1370;20;156;155;1215;96;80;8;12;88;68;0;10;0;50;;
Reserva;De 10 a menos de 20 ha;314;4714;46;268;712;4001;191;123;21;25;170;98;0;19;5;69;;
Reserva;De 20 a menos de 50 ha;363;11198;43;320;1341;9857;226;137;28;15;198;122;1;13;3;89;;
Reserva;De 50 a menos de 100 ha;121;8654;42;79;3601;5053;79;42;28;14;51;28;0;10;1;23;;
Reserva;De 100 a menos de 200 ha;56;7902;56;0;7902;0;37;19;37;19;0;0;0;18;0;0;;
Reserva;De 200 a menos de 500 ha;64;20659;64;0;20659;0;31;33;31;33;0;0;0;27;0;0;;
Reserva;De 500 a menos de 1.000 ha;18;11812;18;0;11812;0;13;5;13;5;0;0;0;4;0;0;;
Reserva;De 1.000 a menos de 2.500 ha;7;0;7;0;0;0;4;3;4;3;0;0;0;3;0;0;;
Reserva;De 2.500 a menos de 10.000 ha;1;0;1;0;0;0;1;0;1;0;0;0;0;0;0;0;;
Reserva;De 10.000 ha e mais;1;0;1;0;0;0;1;0;1;0;0;0;0;0;0;0;;
Reserva;Produtor sem área;0;0;0;0;0;0;0;0;0;0;0;0;0;0;0;0;;
Reserva do Iguaçu;Mais de 0 a menos de 0,1 ha;0;0;0;0;0;0;0;0;0;0;0;0;0;0;0;0;;
Reserva do Iguaçu;De 0,1 a menos de 0,2 ha;2;0;1;1;0;0;0;2;0;1;0;1;0;0;0;1;;
Reserva do Iguaçu;De 0,2 a menos de 0,5 ha;15;6;6;9;3;4;5;10;3;3;2;7;0;1;0;5;;
Reserva do Iguaçu;De 0,5 a menos de 1 ha;22;13;11;11;6;7;9;13;5;6;4;7;1;5;1;1;;
Reserva do Iguaçu;De 1 a menos de 2 ha;68;84;10;58;13;71;9;59;1;9;8;50;0;9;2;43;;
Reserva do Iguaçu;De 2 a menos de 3 ha;17;41;7;10;17;24;7;10;3;4;4;6;0;3;1;4;;
Reserva do Iguaçu;De 3 a menos de 4 ha;19;67;7;12;24;43;11;8;3;4;8;4;1;3;1;3;;
Reserva do Iguaçu;De 4 a menos de 5 ha;19;88;9;10;41;47;10;9;4;5;6;4;0;2;0;3;;
Reserva do Iguaçu;De 5 a menos de 10 ha;99;799;19;80;142;657;76;23;11;8;65;15;0;8;1;14;;
Reserva do Iguaçu;De 10 a menos de 20 ha;214;3201;36;178;508;2693;162;52;25;11;137;41;0;10;1;37;;
Reserva do Iguaçu;De 20 a menos de 50 ha;111;3424;14;97;432;2992;81;30;6;8;75;22;0;7;1;17;;
Reserva do Iguaçu;De 50 a menos de 100 ha;25;1835;11;14;953;881;23;2;11;0;12;2;0;0;0;2;;
Reserva do Iguaçu;De 100 a menos de 200 ha;36;5425;34;2;0;0;26;10;25;9;1;1;2;4;0;1;;
Reserva do Iguaçu;De 200 a menos de 500 ha;28;8762;28;0;8762;0;18;10;18;10;0;0;0;10;0;0;;
Reserva do Iguaçu;De 500 a menos de 1.000 ha;12;7681;11;1;0;0;9;3;9;2;0;1;0;1;0;1;;
Reserva do Iguaçu;De 1.000 a menos de 2.500 ha;4;0;4;0;0;0;4;0;4;0;0;0;0;0;0;0;;
Reserva do Iguaçu;De 2.500 a menos de 10.000 ha;1;0;1;0;0;0;0;1;0;1;0;0;0;1;0;0;;
Reserva do Iguaçu;De 10.000 ha e mais;0;0;0;0;0;0;0;0;0;0;0;0;0;0;0;0;;
Reserva do Iguaçu;Produtor sem área;1;0;1;0;0;0;1;0;1;0;0;0;0;0;0;0;;
Ribeirão Claro;Mais de 0 a menos de 0,1 ha;2;0;1;1;0;0;0;2;0;1;0;1;0;1;0;1;;
Ribeirão Claro;De 0,1 a menos de 0,2 ha;1;0;0;1;0;0;1;0;0;0;1;0;0;0;0;0;;
Ribeirão Claro;De 0,2 a menos de 0,5 ha;4;0;0;4;0;0;1;3;0;0;1;3;0;0;0;2;;
Ribeirão Claro;De 0,5 a menos de 1 ha;27;16;2;25;0;0;5;22;0;2;5;20;1;0;3;14;;
Ribeirão Claro;De 1 a menos de 2 ha;23;30;2;21;0;0;1;22;0;2;1;20;0;1;1;13;;
Ribeirão Claro;De 2 a menos de 3 ha;41;101;9;32;22;79;7;34;0;9;7;25;1;4;1;16;;
Ribeirão Claro;De 3 a menos de 4 ha;97;337;16;81;54;283;32;65;6;10;26;55;0;4;1;39;;
Ribeirão Claro;De 4 a menos de 5 ha;54;255;12;42;57;198;10;44;3;9;7;35;2;4;2;26;;
Ribeirão Claro;De 5 a menos de 10 ha;173;1273;8;165;57;1216;43;130;2;6;41;124;0;4;1;100;;
Ribeirão Claro;De 10 a menos de 20 ha;140;2022;18;122;282;1740;32;108;5;13;27;95;2;8;4;68;;
Ribeirão Claro;De 20 a menos de 50 ha;94;2835;11;83;354;2481;18;76;4;7;14;69;0;5;1;54;;
Ribeirão Claro;De 50 a menos de 100 ha;53;3740;29;24;2279;1462;12;41;9;20;3;21;0;18;0;20;;
Ribeirão Claro;De 100 a menos de 200 ha;38;5518;38;0;5518;0;8;30;8;30;0;0;0;25;0;0;;
Ribeirão Claro;De 200 a menos de 500 ha;33;9713;33;0;9713;0;5;28;5;28;0;0;0;20;0;0;;
Ribeirão Claro;De 500 a menos de 1.000 ha;17;12005;17;0;12005;0;3;14;3;14;0;0;0;12;0;0;;
Ribeirão Claro;De 1.000 a menos de 2.500 ha;2;0;2;0;0;0;1;1;1;1;0;0;0;0;0;0;;
Ribeirão Claro;De 2.500 a menos de 10.000 ha;0;0;0;0;0;0;0;0;0;0;0;0;0;0;0;0;;
Ribeirão Claro;De 10.000 ha e mais;0;0;0;0;0;0;0;0;0;0;0;0;0;0;0;0;;
Ribeirão Claro;Produtor sem área;0;0;0;0;0;0;0;0;0;0;0;0;0;0;0;0;;
Ribeirão do Pinhal;Mais de 0 a menos de 0,1 ha;1;0;0;1;0;0;0;1;0;0;0;1;0;0;0;1;;
Ribeirão do Pinhal;De 0,1 a menos de 0,2 ha;5;0;2;3;0;0;1;4;0;2;1;2;0;2;0;1;;
Ribeirão do Pinhal;De 0,2 a menos de 0,5 ha;34;10;16;18;5;5;2;32;0;16;2;16;0;16;0;11;;
Ribeirão do Pinhal;De 0,5 a menos de 1 ha;75;39;33;42;17;22;2;73;0;33;2;40;0;33;1;32;;
Ribeirão do Pinhal;De 1 a menos de 2 ha;25;35;4;21;6;29;12;13;2;2;10;11;0;2;0;9;;
Ribeirão do Pinhal;De 2 a menos de 3 ha;25;62;4;21;9;54;4;21;0;4;4;17;0;3;0;10;;
Ribeirão do Pinhal;De 3 a menos de 4 ha;36;126;13;23;45;81;11;25;3;10;8;15;0;9;2;6;;
Ribeirão do Pinhal;De 4 a menos de 5 ha;46;218;13;33;63;155;10;36;1;12;9;24;0;12;1;17;;
Ribeirão do Pinhal;De 5 a menos de 10 ha;98;739;15;83;111;628;36;62;3;12;33;50;0;10;0;37;;
Ribeirão do Pinhal;De 10 a menos de 20 ha;126;1761;24;102;321;1440;39;87;5;19;34;68;0;14;1;47;;
Ribeirão do Pinhal;De 20 a menos de 50 ha;51;1504;9;42;255;1249;21;30;6;3;15;27;0;2;0;23;;
Ribeirão do Pinhal;De 50 a menos de 100 ha;23;1557;12;11;913;643;11;12;6;6;5;6;0;5;0;5;;
Ribeirão do Pinhal;De 100 a menos de 200 ha;18;2722;18;0;2722;0;12;6;12;6;0;0;0;5;0;0;;
Ribeirão do Pinhal;De 200 a menos de 500 ha;29;9773;29;0;9773;0;17;12;17;12;0;0;0;9;0;0;;
Ribeirão do Pinhal;De 500 a menos de 1.000 ha;7;4990;7;0;4990;0;6;1;6;1;0;0;0;1;0;0;;
Ribeirão do Pinhal;De 1.000 a menos de 2.500 ha;3;0;3;0;0;0;2;1;2;1;0;0;0;1;0;0;;
Ribeirão do Pinhal;De 2.500 a menos de 10.000 ha;0;0;0;0;0;0;0;0;0;0;0;0;0;0;0;0;;
Ribeirão do Pinhal;De 10.000 ha e mais;0;0;0;0;0;0;0;0;0;0;0;0;0;0;0;0;;
Ribeirão do Pinhal;Produtor sem área;0;0;0;0;0;0;0;0;0;0;0;0;0;0;0;0;;
Rio Azul;Mais de 0 a menos de 0,1 ha;0;0;0;0;0;0;0;0;0;0;0;0;0;0;0;0;;
Rio Azul;De 0,1 a menos de 0,2 ha;1;0;1;0;0;0;0;1;0;1;0;0;0;1;0;0;;
Rio Azul;De 0,2 a menos de 0,5 ha;3;0;0;3;0;0;2;1;0;0;2;1;0;0;0;0;;
Rio Azul;De 0,5 a menos de 1 ha;20;15;1;19;0;0;16;4;1;0;15;4;0;0;0;2;;
Rio Azul;De 1 a menos de 2 ha;81;123;8;73;12;111;71;10;6;2;65;8;0;1;0;2;;
Rio Azul;De 2 a menos de 3 ha;157;394;6;151;15;379;145;12;5;1;140;11;0;1;0;6;;
Rio Azul;De 3 a menos de 4 ha;184;643;3;181;0;0;174;10;2;1;172;9;0;1;0;5;;
Rio Azul;De 4 a menos de 5 ha;184;874;5;179;24;850;176;8;4;1;172;7;0;1;0;4;;
Rio Azul;De 5 a menos de 10 ha;479;3649;10;469;73;3576;458;21;8;2;450;19;0;0;0;15;;
Rio Azul;De 10 a menos de 20 ha;466;6879;11;455;151;6728;452;14;8;3;444;11;0;3;0;7;;
Rio Azul;De 20 a menos de 50 ha;374;11174;7;367;213;10961;364;10;6;1;358;9;0;0;0;6;;
Rio Azul;De 50 a menos de 100 ha;67;4450;34;33;2589;1861;61;6;30;4;31;2;0;4;0;1;;
Rio Azul;De 100 a menos de 200 ha;18;2412;18;0;2412;0;17;1;17;1;0;0;0;1;0;0;;
Rio Azul;De 200 a menos de 500 ha;4;1120;4;0;1120;0;4;0;4;0;0;0;0;0;0;0;;
Rio Azul;De 500 a menos de 1.000 ha;4;3506;4;0;3506;0;1;3;1;3;0;0;0;3;0;0;;
Rio Azul;De 1.000 a menos de 2.500 ha;0;0;0;0;0;0;0;0;0;0;0;0;0;0;0;0;;
Rio Azul;De 2.500 a menos de 10.000 ha;0;0;0;0;0;0;0;0;0;0;0;0;0;0;0;0;;
Rio Azul;De 10.000 ha e mais;0;0;0;0;0;0;0;0;0;0;0;0;0;0;0;0;;
Rio Azul;Produtor sem área;0;0;0;0;0;0;0;0;0;0;0;0;0;0;0;0;;
Rio Bom;Mais de 0 a menos de 0,1 ha;1;0;0;1;0;0;0;1;0;0;0;1;0;0;0;1;;
Rio Bom;De 0,1 a menos de 0,2 ha;0;0;0;0;0;0;0;0;0;0;0;0;0;0;0;0;;
Rio Bom;De 0,2 a menos de 0,5 ha;0;0;0;0;0;0;0;0;0;0;0;0;0;0;0;0;;
Rio Bom;De 0,5 a menos de 1 ha;3;0;0;3;0;0;2;1;0;0;2;1;0;0;0;1;;
Rio Bom;De 1 a menos de 2 ha;10;14;0;10;0;14;4;6;0;0;4;6;0;0;0;5;;
Rio Bom;De 2 a menos de 3 ha;21;52;2;19;0;0;10;11;2;0;8;11;0;0;0;9;;
Rio Bom;De 3 a menos de 4 ha;14;51;0;14;0;51;10;4;0;0;10;4;0;0;0;4;;
Rio Bom;De 4 a menos de 5 ha;30;144;3;27;15;129;16;14;1;2;15;12;0;2;1;8;;
Rio Bom;De 5 a menos de 10 ha;61;479;4;57;31;447;42;19;2;2;40;17;0;2;1;12;;
Rio Bom;De 10 a menos de 20 ha;53;770;2;51;0;0;38;15;1;1;37;14;0;1;1;13;;
Rio Bom;De 20 a menos de 50 ha;57;1775;2;55;0;0;52;5;2;0;50;5;0;0;0;5;;
Rio Bom;De 50 a menos de 100 ha;27;1964;15;12;1204;760;17;10;10;5;7;5;1;4;1;3;;
Rio Bom;De 100 a menos de 200 ha;17;2389;17;0;2389;0;11;6;11;6;0;0;0;6;0;0;;
Rio Bom;De 200 a menos de 500 ha;14;3922;14;0;3922;0;13;1;13;1;0;0;0;1;0;0;;
Rio Bom;De 500 a menos de 1.000 ha;5;3088;5;0;3088;0;3;2;3;2;0;0;0;2;0;0;;
Rio Bom;De 1.000 a menos de 2.500 ha;0;0;0;0;0;0;0;0;0;0;0;0;0;0;0;0;;
Rio Bom;De 2.500 a menos de 10.000 ha;0;0;0;0;0;0;0;0;0;0;0;0;0;0;0;0;;
Rio Bom;De 10.000 ha e mais;0;0;0;0;0;0;0;0;0;0;0;0;0;0;0;0;;
Rio Bom;Produtor sem área;0;0;0;0;0;0;0;0;0;0;0;0;0;0;0;0;;
Rio Bonito do Iguaçu;Mais de 0 a menos de 0,1 ha;7;0;2;5;0;0;1;6;0;2;1;4;0;2;0;4;;
Rio Bonito do Iguaçu;De 0,1 a menos de 0,2 ha;13;2;1;12;0;0;2;11;0;1;2;10;0;1;2;7;;
Rio Bonito do Iguaçu;De 0,2 a menos de 0,5 ha;13;4;3;10;1;3;3;10;1;2;2;8;0;2;1;6;;
Rio Bonito do Iguaçu;De 0,5 a menos de 1 ha;37;26;3;34;2;23;6;31;0;3;6;28;0;3;2;25;;
Rio Bonito do Iguaçu;De 1 a menos de 2 ha;104;130;6;98;8;122;29;75;2;4;27;71;0;3;12;55;;
Rio Bonito do Iguaçu;De 2 a menos de 3 ha;289;698;14;275;34;665;137;152;5;9;132;143;5;4;26;114;;
Rio Bonito do Iguaçu;De 3 a menos de 4 ha;176;610;7;169;25;585;102;74;4;3;98;71;1;2;10;56;;
Rio Bonito do Iguaçu;De 4 a menos de 5 ha;131;629;7;124;34;595;96;35;3;4;93;31;0;3;7;22;;
Rio Bonito do Iguaçu;De 5 a menos de 10 ha;289;2100;7;282;48;2052;233;56;3;4;230;52;0;4;6;40;;
Rio Bonito do Iguaçu;De 10 a menos de 20 ha;1592;24290;24;1568;347;23943;1452;140;17;7;1435;133;2;5;15;88;;
Rio Bonito do Iguaçu;De 20 a menos de 50 ha;188;5686;3;185;106;5580;178;10;3;0;175;10;0;0;0;9;;
Rio Bonito do Iguaçu;De 50 a menos de 100 ha;46;3083;17;29;1338;1745;46;0;17;0;29;0;0;0;0;0;;
Rio Bonito do Iguaçu;De 100 a menos de 200 ha;17;2213;17;0;2213;0;16;1;16;1;0;0;0;1;0;0;;
Rio Bonito do Iguaçu;De 200 a menos de 500 ha;14;4109;14;0;4109;0;14;0;14;0;0;0;0;0;0;0;;
Rio Bonito do Iguaçu;De 500 a menos de 1.000 ha;2;0;2;0;0;0;2;0;2;0;0;0;0;0;0;0;;
Rio Bonito do Iguaçu;De 1.000 a menos de 2.500 ha;0;0;0;0;0;0;0;0;0;0;0;0;0;0;0;0;;
Rio Bonito do Iguaçu;De 2.500 a menos de 10.000 ha;0;0;0;0;0;0;0;0;0;0;0;0;0;0;0;0;;
Rio Bonito do Iguaçu;De 10.000 ha e mais;0;0;0;0;0;0;0;0;0;0;0;0;0;0;0;0;;
Rio Bonito do Iguaçu;Produtor sem área;1;0;1;0;0;0;0;1;0;1;0;0;0;1;0;0;;
Rio Branco do Ivaí;Mais de 0 a menos de 0,1 ha;5;0;2;3;0;0;3;2;0;2;3;0;0;2;0;0;;
Rio Branco do Ivaí;De 0,1 a menos de 0,2 ha;21;3;8;13;1;2;13;8;7;1;6;7;0;1;1;6;;
Rio Branco do Ivaí;De 0,2 a menos de 0,5 ha;71;32;37;34;17;15;55;16;29;8;26;8;0;5;0;6;;
Rio Branco do Ivaí;De 0,5 a menos de 1 ha;25;16;10;15;6;10;17;8;7;3;10;5;0;3;0;3;;
Rio Branco do Ivaí;De 1 a menos de 2 ha;21;27;8;13;10;17;14;7;4;4;10;3;0;3;0;2;;
Rio Branco do Ivaí;De 2 a menos de 3 ha;31;76;10;21;24;51;22;9;9;1;13;8;0;1;0;4;;
Rio Branco do Ivaí;De 3 a menos de 4 ha;16;58;1;15;0;0;12;4;0;1;12;3;0;1;0;2;;
Rio Branco do Ivaí;De 4 a menos de 5 ha;38;183;10;28;48;135;22;16;5;5;17;11;0;3;0;7;;
Rio Branco do Ivaí;De 5 a menos de 10 ha;197;1512;29;168;222;1290;139;58;17;12;122;46;0;8;0;33;;
Rio Branco do Ivaí;De 10 a menos de 20 ha;73;1012;10;63;148;864;54;19;4;6;50;13;0;3;1;10;;
Rio Branco do Ivaí;De 20 a menos de 50 ha;46;1363;10;36;271;1091;32;14;8;2;24;12;0;1;0;8;;
Rio Branco do Ivaí;De 50 a menos de 100 ha;10;715;5;5;413;303;6;4;4;1;2;3;0;1;0;2;;
Rio Branco do Ivaí;De 100 a menos de 200 ha;23;3387;23;0;3387;0;17;6;17;6;0;0;1;2;0;0;;
Rio Branco do Ivaí;De 200 a menos de 500 ha;16;4653;16;0;4653;0;13;3;13;3;0;0;1;2;0;0;;
Rio Branco do Ivaí;De 500 a menos de 1.000 ha;9;6585;9;0;6585;0;7;2;7;2;0;0;0;2;0;0;;
Rio Branco do Ivaí;De 1.000 a menos de 2.500 ha;3;0;3;0;0;0;3;0;3;0;0;0;0;0;0;0;;
Rio Branco do Ivaí;De 2.500 a menos de 10.000 ha;2;0;2;0;0;0;2;0;2;0;0;0;0;0;0;0;;
Rio Branco do Ivaí;De 10.000 ha e mais;0;0;0;0;0;0;0;0;0;0;0;0;0;0;0;0;;
Rio Branco do Ivaí;Produtor sem área;0;0;0;0;0;0;0;0;0;0;0;0;0;0;0;0;;
Rio Branco do Sul;Mais de 0 a menos de 0,1 ha;28;2;16;12;1;1;1;27;1;15;0;12;0;14;0;10;;
Rio Branco do Sul;De 0,1 a menos de 0,2 ha;23;3;14;9;0;0;2;21;2;12;0;9;0;11;0;9;;
Rio Branco do Sul;De 0,2 a menos de 0,5 ha;37;12;13;24;4;8;2;35;0;13;2;22;0;11;1;17;;
Rio Branco do Sul;De 0,5 a menos de 1 ha;83;54;32;51;21;33;13;70;10;22;3;48;0;21;0;44;;
Rio Branco do Sul;De 1 a menos de 2 ha;111;152;32;79;44;108;19;92;8;24;11;68;0;23;1;64;;
Rio Branco do Sul;De 2 a menos de 3 ha;115;280;30;85;73;207;23;92;9;21;14;71;0;20;1;61;;
Rio Branco do Sul;De 3 a menos de 4 ha;60;212;15;45;52;160;15;45;8;7;7;38;0;5;2;33;;
Rio Branco do Sul;De 4 a menos de 5 ha;58;276;18;40;86;190;9;49;3;15;6;34;0;15;0;33;;
Rio Branco do Sul;De 5 a menos de 10 ha;157;1208;34;123;261;947;34;123;4;30;30;93;0;24;0;90;;
Rio Branco do Sul;De 10 a menos de 20 ha;186;2732;36;150;514;2218;49;137;11;25;38;112;0;22;0;106;;
Rio Branco do Sul;De 20 a menos de 50 ha;153;4748;31;122;991;3757;42;111;8;23;34;88;0;23;1;80;;
Rio Branco do Sul;De 50 a menos de 100 ha;42;2947;37;5;0;0;11;31;10;27;1;4;0;23;0;4;;
Rio Branco do Sul;De 100 a menos de 200 ha;14;1871;14;0;1871;0;4;10;4;10;0;0;0;10;0;0;;
Rio Branco do Sul;De 200 a menos de 500 ha;8;2270;8;0;2270;0;2;6;2;6;0;0;0;5;0;0;;
Rio Branco do Sul;De 500 a menos de 1.000 ha;6;0;6;0;0;0;3;3;3;3;0;0;0;1;0;0;;
Rio Branco do Sul;De 1.000 a menos de 2.500 ha;1;0;1;0;0;0;1;0;1;0;0;0;0;0;0;0;;
Rio Branco do Sul;De 2.500 a menos de 10.000 ha;1;0;1;0;0;0;1;0;1;0;0;0;0;0;0;0;;
Rio Branco do Sul;De 10.000 ha e mais;0;0;0;0;0;0;0;0;0;0;0;0;0;0;0;0;;
Rio Branco do Sul;Produtor sem área;0;0;0;0;0;0;0;0;0;0;0;0;0;0;0;0;;
Rio Negro;Mais de 0 a menos de 0,1 ha;0;0;0;0;0;0;0;0;0;0;0;0;0;0;0;0;;
Rio Negro;De 0,1 a menos de 0,2 ha;0;0;0;0;0;0;0;0;0;0;0;0;0;0;0;0;;
Rio Negro;De 0,2 a menos de 0,5 ha;1;0;0;1;0;0;1;0;0;0;1;0;0;0;0;0;;
Rio Negro;De 0,5 a menos de 1 ha;11;7;2;9;0;0;7;4;2;0;5;4;0;0;0;3;;
Rio Negro;De 1 a menos de 2 ha;78;106;6;72;8;99;60;18;5;1;55;17;0;1;0;14;;
Rio Negro;De 2 a menos de 3 ha;126;279;5;121;12;267;106;20;4;1;102;19;0;1;0;12;;
Rio Negro;De 3 a menos de 4 ha;106;345;6;100;20;325;91;15;5;1;86;14;0;1;1;12;;
Rio Negro;De 4 a menos de 5 ha;87;379;4;83;18;360;74;13;2;2;72;11;0;2;0;7;;
Rio Negro;De 5 a menos de 10 ha;253;1811;17;236;129;1681;228;25;9;8;219;17;0;6;0;14;;
Rio Negro;De 10 a menos de 20 ha;196;2645;9;187;128;2517;178;18;5;4;173;14;0;4;0;9;;
Rio Negro;De 20 a menos de 50 ha;156;4633;4;152;142;4490;136;20;2;2;134;18;0;2;2;15;;
Rio Negro;De 50 a menos de 100 ha;53;3634;32;21;2461;1173;50;3;29;3;21;0;0;3;0;0;;
Rio Negro;De 100 a menos de 200 ha;12;1590;12;0;1590;0;7;5;7;5;0;0;0;4;0;0;;
Rio Negro;De 200 a menos de 500 ha;6;1462;6;0;1462;0;4;2;4;2;0;0;0;2;0;0;;
Rio Negro;De 500 a menos de 1.000 ha;3;2357;3;0;2357;0;2;1;2;1;0;0;0;1;0;0;;
Rio Negro;De 1.000 a menos de 2.500 ha;4;5307;4;0;5307;0;3;1;3;1;0;0;0;1;0;0;;
Rio Negro;De 2.500 a menos de 10.000 ha;2;0;2;0;0;0;1;1;1;1;0;0;0;1;0;0;;
Rio Negro;De 10.000 ha e mais;0;0;0;0;0;0;0;0;0;0;0;0;0;0;0;0;;
Rio Negro;Produtor sem área;0;0;0;0;0;0;0;0;0;0;0;0;0;0;0;0;;
Rolândia;Mais de 0 a menos de 0,1 ha;13;1;5;8;0;0;2;11;1;4;1;7;0;4;1;5;;
Rolândia;De 0,1 a menos de 0,2 ha;6;1;3;3;0;0;2;4;1;2;1;2;0;2;0;1;;
Rolândia;De 0,2 a menos de 0,5 ha;18;5;3;15;1;5;5;13;1;2;4;11;0;2;3;6;;
Rolândia;De 0,5 a menos de 1 ha;38;20;20;18;11;9;10;28;4;16;6;12;1;9;1;9;;
Rolândia;De 1 a menos de 2 ha;27;35;16;11;20;15;6;21;2;14;4;7;4;9;2;1;;
Rolândia;De 2 a menos de 3 ha;54;131;20;34;48;82;14;40;5;15;9;25;1;11;4;11;;
Rolândia;De 3 a menos de 4 ha;34;122;15;19;54;68;8;26;3;12;5;14;3;6;3;9;;
Rolândia;De 4 a menos de 5 ha;29;137;11;18;51;86;16;13;6;5;10;8;0;3;2;5;;
Rolândia;De 5 a menos de 10 ha;91;684;23;68;179;505;55;36;13;10;42;26;1;8;5;15;;
Rolândia;De 10 a menos de 20 ha;118;1673;24;94;349;1324;97;21;22;2;75;19;1;1;2;12;;
Rolândia;De 20 a menos de 50 ha;107;3520;34;73;1275;2245;97;10;33;1;64;9;0;0;0;6;;
Rolândia;De 50 a menos de 100 ha;53;3765;53;0;3765;0;52;1;52;1;0;0;0;1;0;0;;
Rolândia;De 100 a menos de 200 ha;38;5418;38;0;5418;0;37;1;37;1;0;0;0;1;0;0;;
Rolândia;De 200 a menos de 500 ha;31;9770;31;0;9770;0;31;0;31;0;0;0;0;0;0;0;;
Rolândia;De 500 a menos de 1.000 ha;6;0;6;0;0;0;6;0;6;0;0;0;0;0;0;0;;
Rolândia;De 1.000 a menos de 2.500 ha;3;0;3;0;0;0;3;0;3;0;0;0;0;0;0;0;;
Rolândia;De 2.500 a menos de 10.000 ha;0;0;0;0;0;0;0;0;0;0;0;0;0;0;0;0;;
Rolândia;De 10.000 ha e mais;0;0;0;0;0;0;0;0;0;0;0;0;0;0;0;0;;
Rolândia;Produtor sem área;0;0;0;0;0;0;0;0;0;0;0;0;0;0;0;0;;
Roncador;Mais de 0 a menos de 0,1 ha;3;0;0;3;0;0;2;1;0;0;2;1;0;0;0;1;;
Roncador;De 0,1 a menos de 0,2 ha;4;0;0;4;0;0;3;1;0;0;3;1;0;0;0;0;;
Roncador;De 0,2 a menos de 0,5 ha;33;14;11;22;5;9;11;22;3;8;8;14;0;7;0;6;;
Roncador;De 0,5 a menos de 1 ha;24;16;4;20;3;13;9;15;1;3;8;12;1;2;0;9;;
Roncador;De 1 a menos de 2 ha;44;59;7;37;10;50;16;28;2;5;14;23;0;4;2;16;;
Roncador;De 2 a menos de 3 ha;54;132;3;51;7;126;25;29;1;2;24;27;0;2;0;18;;
Roncador;De 3 a menos de 4 ha;42;148;1;41;0;0;14;28;0;1;14;27;0;1;2;21;;
Roncador;De 4 a menos de 5 ha;73;350;10;63;48;302;38;35;4;6;34;29;0;3;0;22;;
Roncador;De 5 a menos de 10 ha;147;1126;8;139;62;1064;72;75;2;6;70;69;0;6;5;49;;
Roncador;De 10 a menos de 20 ha;172;2419;12;160;175;2244;113;59;3;9;110;50;0;7;1;33;;
Roncador;De 20 a menos de 50 ha;127;4038;10;117;296;3742;102;25;8;2;94;23;0;2;0;16;;
Roncador;De 50 a menos de 100 ha;73;5069;20;53;1675;3395;59;14;15;5;44;9;0;3;2;6;;
Roncador;De 100 a menos de 200 ha;45;6257;45;0;6257;0;33;12;33;12;0;0;0;10;0;0;;
Roncador;De 200 a menos de 500 ha;40;11530;40;0;11530;0;32;8;32;8;0;0;1;6;0;0;;
Roncador;De 500 a menos de 1.000 ha;13;9835;13;0;9835;0;12;1;12;1;0;0;0;0;0;0;;
Roncador;De 1.000 a menos de 2.500 ha;7;9646;7;0;9646;0;7;0;7;0;0;0;0;0;0;0;;
Roncador;De 2.500 a menos de 10.000 ha;2;0;2;0;0;0;2;0;2;0;0;0;0;0;0;0;;
Roncador;De 10.000 ha e mais;0;0;0;0;0;0;0;0;0;0;0;0;0;0;0;0;;
Roncador;Produtor sem área;2;0;0;2;0;0;0;0;0;0;0;0;0;0;0;0;;
Rondon;Mais de 0 a menos de 0,1 ha;4;0;2;2;0;0;0;4;0;2;0;2;0;1;0;1;;
Rondon;De 0,1 a menos de 0,2 ha;2;0;1;1;0;0;0;2;0;1;0;1;0;1;0;1;;
Rondon;De 0,2 a menos de 0,5 ha;11;3;3;8;1;2;2;9;0;3;2;6;0;3;0;6;;
Rondon;De 0,5 a menos de 1 ha;59;32;26;33;14;18;19;40;12;14;7;26;0;12;0;24;;
Rondon;De 1 a menos de 2 ha;9;12;2;7;0;0;3;6;1;1;2;5;0;0;0;5;;
Rondon;De 2 a menos de 3 ha;31;77;8;23;20;57;13;18;0;8;13;10;0;6;0;8;;
Rondon;De 3 a menos de 4 ha;26;87;11;15;38;50;8;18;3;8;5;10;0;7;0;8;;
Rondon;De 4 a menos de 5 ha;37;175;13;24;62;113;13;24;8;5;5;19;0;4;0;15;;
Rondon;De 5 a menos de 10 ha;86;647;18;68;135;512;41;45;7;11;34;34;0;10;0;20;;
Rondon;De 10 a menos de 20 ha;69;984;14;55;190;795;38;31;6;8;32;23;0;6;0;18;;
Rondon;De 20 a menos de 50 ha;86;2918;21;65;754;2164;54;32;15;6;39;26;0;4;0;21;;
Rondon;De 50 a menos de 100 ha;29;1973;8;21;592;1381;18;11;4;4;14;7;0;3;0;4;;
Rondon;De 100 a menos de 200 ha;24;3485;24;0;3485;0;10;14;10;14;0;0;0;9;0;0;;
Rondon;De 200 a menos de 500 ha;24;7408;24;0;7408;0;14;10;14;10;0;0;0;6;0;0;;
Rondon;De 500 a menos de 1.000 ha;8;5038;8;0;5038;0;3;5;3;5;0;0;0;3;0;0;;
Rondon;De 1.000 a menos de 2.500 ha;1;0;1;0;0;0;1;0;1;0;0;0;0;0;0;0;;
Rondon;De 2.500 a menos de 10.000 ha;0;0;0;0;0;0;0;0;0;0;0;0;0;0;0;0;;
Rondon;De 10.000 ha e mais;1;0;1;0;0;0;1;0;1;0;0;0;0;0;0;0;;
Rondon;Produtor sem área;1;0;1;0;0;0;0;0;0;0;0;0;0;0;0;0;;
Rosário do Ivaí;Mais de 0 a menos de 0,1 ha;3;0;0;3;0;0;2;1;0;0;2;1;0;0;0;1;;
Rosário do Ivaí;De 0,1 a menos de 0,2 ha;6;1;0;6;0;1;4;2;0;0;4;2;0;0;0;0;;
Rosário do Ivaí;De 0,2 a menos de 0,5 ha;19;6;3;16;0;0;13;6;3;0;10;6;0;0;1;5;;
Rosário do Ivaí;De 0,5 a menos de 1 ha;47;35;11;36;7;28;33;14;6;5;27;9;0;5;0;5;;
Rosário do Ivaí;De 1 a menos de 2 ha;41;60;7;34;10;50;33;8;5;2;28;6;0;2;0;5;;
Rosário do Ivaí;De 2 a menos de 3 ha;28;68;10;18;24;44;15;13;3;7;12;6;0;6;0;6;;
Rosário do Ivaí;De 3 a menos de 4 ha;44;150;8;36;27;123;23;21;2;6;21;15;0;6;0;11;;
Rosário do Ivaí;De 4 a menos de 5 ha;58;277;17;41;81;196;37;21;8;9;29;12;0;6;1;11;;
Rosário do Ivaí;De 5 a menos de 10 ha;129;962;25;104;187;776;65;64;5;20;60;44;0;17;3;37;;
Rosário do Ivaí;De 10 a menos de 20 ha;189;2703;32;157;447;2256;116;73;15;17;101;56;0;16;0;48;;
Rosário do Ivaí;De 20 a menos de 50 ha;137;4370;26;111;816;3554;89;48;10;16;79;32;0;13;0;18;;
Rosário do Ivaí;De 50 a menos de 100 ha;58;4214;34;24;2804;1410;39;19;20;14;19;5;0;13;0;2;;
Rosário do Ivaí;De 100 a menos de 200 ha;40;5782;40;0;5782;0;23;17;23;17;0;0;0;14;0;0;;
Rosário do Ivaí;De 200 a menos de 500 ha;29;8341;29;0;8341;0;24;5;24;5;0;0;0;4;0;0;;
Rosário do Ivaí;De 500 a menos de 1.000 ha;7;4438;7;0;4438;0;6;1;6;1;0;0;0;1;0;0;;
Rosário do Ivaí;De 1.000 a menos de 2.500 ha;1;0;1;0;0;0;1;0;1;0;0;0;0;0;0;0;;
Rosário do Ivaí;De 2.500 a menos de 10.000 ha;0;0;0;0;0;0;0;0;0;0;0;0;0;0;0;0;;
Rosário do Ivaí;De 10.000 ha e mais;0;0;0;0;0;0;0;0;0;0;0;0;0;0;0;0;;
Rosário do Ivaí;Produtor sem área;3;0;1;2;0;0;0;2;0;1;0;1;0;1;0;1;;
Sabáudia;Mais de 0 a menos de 0,1 ha;0;0;0;0;0;0;0;0;0;0;0;0;0;0;0;0;;
Sabáudia;De 0,1 a menos de 0,2 ha;0;0;0;0;0;0;0;0;0;0;0;0;0;0;0;0;;
Sabáudia;De 0,2 a menos de 0,5 ha;3;0;0;3;0;0;1;2;0;0;1;2;0;0;0;2;;
Sabáudia;De 0,5 a menos de 1 ha;3;0;2;1;0;0;0;3;0;2;0;1;2;0;0;1;;
Sabáudia;De 1 a menos de 2 ha;6;8;0;6;0;8;2;4;0;0;2;4;0;0;1;3;;
Sabáudia;De 2 a menos de 3 ha;14;35;5;9;12;23;6;8;2;3;4;5;0;3;1;4;;
Sabáudia;De 3 a menos de 4 ha;16;55;3;13;11;44;8;8;0;3;8;5;1;2;0;5;;
Sabáudia;De 4 a menos de 5 ha;27;129;12;15;57;72;17;10;6;6;11;4;1;3;0;4;;
Sabáudia;De 5 a menos de 10 ha;38;286;8;30;59;227;24;14;5;3;19;11;2;1;0;8;;
Sabáudia;De 10 a menos de 20 ha;61;850;4;57;56;794;51;10;2;2;49;8;1;1;0;5;;
Sabáudia;De 20 a menos de 50 ha;77;2509;11;66;390;2119;65;12;8;3;57;9;0;3;1;7;;
Sabáudia;De 50 a menos de 100 ha;39;2851;28;11;2231;620;35;4;24;4;11;0;1;2;0;0;;
Sabáudia;De 100 a menos de 200 ha;19;2814;19;0;2814;0;16;3;16;3;0;0;1;1;0;0;;
Sabáudia;De 200 a menos de 500 ha;22;6714;22;0;6714;0;19;3;19;3;0;0;0;3;0;0;;
Sabáudia;De 500 a menos de 1.000 ha;0;0;0;0;0;0;0;0;0;0;0;0;0;0;0;0;;
Sabáudia;De 1.000 a menos de 2.500 ha;1;0;1;0;0;0;0;1;0;1;0;0;0;1;0;0;;
Sabáudia;De 2.500 a menos de 10.000 ha;0;0;0;0;0;0;0;0;0;0;0;0;0;0;0;0;;
Sabáudia;De 10.000 ha e mais;0;0;0;0;0;0;0;0;0;0;0;0;0;0;0;0;;
Sabáudia;Produtor sem área;0;0;0;0;0;0;0;0;0;0;0;0;0;0;0;0;;
Salgado Filho;Mais de 0 a menos de 0,1 ha;2;0;1;1;0;0;0;2;0;1;0;1;0;1;0;1;;
Salgado Filho;De 0,1 a menos de 0,2 ha;2;0;1;1;0;0;0;2;0;1;0;1;0;1;0;1;;
Salgado Filho;De 0,2 a menos de 0,5 ha;3;1;2;1;0;0;2;1;1;1;1;0;0;1;0;0;;
Salgado Filho;De 0,5 a menos de 1 ha;25;16;4;21;3;13;11;14;3;1;8;13;0;1;0;13;;
Salgado Filho;De 1 a menos de 2 ha;26;35;6;20;9;27;10;16;3;3;7;13;0;2;0;9;;
Salgado Filho;De 2 a menos de 3 ha;17;42;5;12;11;31;10;7;3;2;7;5;0;1;0;5;;
Salgado Filho;De 3 a menos de 4 ha;22;74;6;16;20;54;12;10;2;4;10;6;0;3;0;4;;
Salgado Filho;De 4 a menos de 5 ha;27;126;2;25;0;0;22;5;1;1;21;4;0;1;0;2;;
Salgado Filho;De 5 a menos de 10 ha;90;687;14;76;109;577;66;24;8;6;58;18;0;6;0;16;;
Salgado Filho;De 10 a menos de 20 ha;130;1863;19;111;260;1603;106;24;12;7;94;17;0;7;1;12;;
Salgado Filho;De 20 a menos de 50 ha;141;4263;11;130;306;3957;123;18;7;4;116;14;0;4;1;10;;
Salgado Filho;De 50 a menos de 100 ha;44;3051;13;31;1103;1948;44;0;13;0;31;0;0;0;0;0;;
Salgado Filho;De 100 a menos de 200 ha;13;1939;13;0;1939;0;11;2;11;2;0;0;0;2;0;0;;
Salgado Filho;De 200 a menos de 500 ha;5;1611;5;0;1611;0;5;0;5;0;0;0;0;0;0;0;;
Salgado Filho;De 500 a menos de 1.000 ha;3;2080;3;0;2080;0;3;0;3;0;0;0;0;0;0;0;;
Salgado Filho;De 1.000 a menos de 2.500 ha;2;0;2;0;0;0;2;0;2;0;0;0;0;0;0;0;;
Salgado Filho;De 2.500 a menos de 10.000 ha;0;0;0;0;0;0;0;0;0;0;0;0;0;0;0;0;;
Salgado Filho;De 10.000 ha e mais;0;0;0;0;0;0;0;0;0;0;0;0;0;0;0;0;;
Salgado Filho;Produtor sem área;0;0;0;0;0;0;0;0;0;0;0;0;0;0;0;0;;
Salto do Itararé;Mais de 0 a menos de 0,1 ha;1;0;1;0;0;0;0;1;0;1;0;0;0;0;0;0;;
Salto do Itararé;De 0,1 a menos de 0,2 ha;2;0;0;2;0;0;1;1;0;0;1;1;0;0;0;1;;
Salto do Itararé;De 0,2 a menos de 0,5 ha;1;0;0;1;0;0;0;1;0;0;0;1;0;0;0;1;;
Salto do Itararé;De 0,5 a menos de 1 ha;13;12;3;10;3;9;0;13;0;3;0;10;0;3;0;6;;
Salto do Itararé;De 1 a menos de 2 ha;15;20;3;12;4;15;0;15;0;3;0;12;0;3;0;9;;
Salto do Itararé;De 2 a menos de 3 ha;19;46;2;17;0;0;1;18;0;2;1;16;0;1;0;11;;
Salto do Itararé;De 3 a menos de 4 ha;25;90;5;20;18;72;0;25;0;5;0;20;0;3;0;12;;
Salto do Itararé;De 4 a menos de 5 ha;29;139;2;27;0;0;0;29;0;2;0;27;0;1;0;14;;
Salto do Itararé;De 5 a menos de 10 ha;91;722;7;84;59;663;6;85;0;7;6;78;0;6;0;56;;
Salto do Itararé;De 10 a menos de 20 ha;109;1634;6;103;85;1548;3;106;0;6;3;100;0;5;0;68;;
Salto do Itararé;De 20 a menos de 50 ha;104;3273;4;100;174;3099;13;91;2;2;11;89;0;2;1;54;;
Salto do Itararé;De 50 a menos de 100 ha;33;2402;19;14;1591;811;2;31;1;18;1;13;0;12;0;7;;
Salto do Itararé;De 100 a menos de 200 ha;17;2360;17;0;2360;0;3;14;3;14;0;0;0;13;0;0;;
Salto do Itararé;De 200 a menos de 500 ha;8;2357;8;0;2357;0;0;8;0;8;0;0;0;6;0;0;;
Salto do Itararé;De 500 a menos de 1.000 ha;2;0;2;0;0;0;1;1;1;1;0;0;0;1;0;0;;
Salto do Itararé;De 1.000 a menos de 2.500 ha;0;0;0;0;0;0;0;0;0;0;0;0;0;0;0;0;;
Salto do Itararé;De 2.500 a menos de 10.000 ha;0;0;0;0;0;0;0;0;0;0;0;0;0;0;0;0;;
Salto do Itararé;De 10.000 ha e mais;0;0;0;0;0;0;0;0;0;0;0;0;0;0;0;0;;
Salto do Itararé;Produtor sem área;0;0;0;0;0;0;0;0;0;0;0;0;0;0;0;0;;
Salto do Lontra;Mais de 0 a menos de 0,1 ha;12;0;7;5;0;0;4;8;3;4;1;4;1;3;1;3;;
Salto do Lontra;De 0,1 a menos de 0,2 ha;16;2;6;10;0;0;1;15;1;5;0;10;0;4;1;9;;
Salto do Lontra;De 0,2 a menos de 0,5 ha;41;13;17;24;5;7;11;30;3;14;8;16;1;13;0;15;;
Salto do Lontra;De 0,5 a menos de 1 ha;73;45;25;48;17;29;34;39;13;12;21;27;0;10;0;22;;
Salto do Lontra;De 1 a menos de 2 ha;62;86;20;42;27;59;26;36;13;7;13;29;0;5;1;23;;
Salto do Lontra;De 2 a menos de 3 ha;73;179;13;60;33;145;34;39;4;9;30;30;0;9;2;26;;
Salto do Lontra;De 3 a menos de 4 ha;82;280;17;65;58;222;45;37;10;7;35;30;0;4;0;25;;
Salto do Lontra;De 4 a menos de 5 ha;121;570;18;103;86;484;76;45;11;7;65;38;1;5;3;29;;
Salto do Lontra;De 5 a menos de 10 ha;294;2273;45;249;333;1939;227;67;28;17;199;50;1;12;1;35;;
Salto do Lontra;De 10 a menos de 20 ha;310;4521;22;288;306;4215;283;27;17;5;266;22;0;5;2;14;;
Salto do Lontra;De 20 a menos de 50 ha;233;7003;14;219;426;6577;216;17;10;4;206;13;0;4;2;9;;
Salto do Lontra;De 50 a menos de 100 ha;60;4038;14;46;1202;2836;59;1;13;1;46;0;0;1;0;0;;
Salto do Lontra;De 100 a menos de 200 ha;25;3717;25;0;3717;0;23;2;23;2;0;0;0;2;0;0;;
Salto do Lontra;De 200 a menos de 500 ha;14;3941;14;0;3941;0;14;0;14;0;0;0;0;0;0;0;;
Salto do Lontra;De 500 a menos de 1.000 ha;0;0;0;0;0;0;0;0;0;0;0;0;0;0;0;0;;
Salto do Lontra;De 1.000 a menos de 2.500 ha;1;0;1;0;0;0;1;0;1;0;0;0;0;0;0;0;;
Salto do Lontra;De 2.500 a menos de 10.000 ha;0;0;0;0;0;0;0;0;0;0;0;0;0;0;0;0;;
Salto do Lontra;De 10.000 ha e mais;0;0;0;0;0;0;0;0;0;0;0;0;0;0;0;0;;
Salto do Lontra;Produtor sem área;0;0;0;0;0;0;0;0;0;0;0;0;0;0;0;0;;
Santa Amélia;Mais de 0 a menos de 0,1 ha;0;0;0;0;0;0;0;0;0;0;0;0;0;0;0;0;;
Santa Amélia;De 0,1 a menos de 0,2 ha;0;0;0;0;0;0;0;0;0;0;0;0;0;0;0;0;;
Santa Amélia;De 0,2 a menos de 0,5 ha;6;2;1;5;0;0;6;0;1;0;5;0;0;0;0;0;;
Santa Amélia;De 0,5 a menos de 1 ha;13;7;6;7;3;4;7;6;1;5;6;1;3;0;0;0;;
Santa Amélia;De 1 a menos de 2 ha;4;0;0;4;0;0;3;1;0;0;3;1;0;0;0;1;;
Santa Amélia;De 2 a menos de 3 ha;8;19;1;7;0;0;6;2;1;0;5;2;0;0;0;0;;
Santa Amélia;De 3 a menos de 4 ha;12;42;1;11;0;0;10;2;1;0;9;2;0;0;0;1;;
Santa Amélia;De 4 a menos de 5 ha;13;62;0;13;0;62;10;3;0;0;10;3;0;0;0;3;;
Santa Amélia;De 5 a menos de 10 ha;39;288;1;38;0;0;32;7;0;1;32;6;0;0;0;1;;
Santa Amélia;De 10 a menos de 20 ha;27;378;3;24;36;341;26;1;3;0;23;1;0;0;0;0;;
Santa Amélia;De 20 a menos de 50 ha;26;763;8;18;271;492;20;6;6;2;14;4;1;0;0;3;;
Santa Amélia;De 50 a menos de 100 ha;11;804;10;1;0;0;10;1;9;1;1;0;1;0;0;0;;
Santa Amélia;De 100 a menos de 200 ha;9;1374;9;0;1374;0;9;0;9;0;0;0;0;0;0;0;;
Santa Amélia;De 200 a menos de 500 ha;2;0;2;0;0;0;1;1;1;1;0;0;0;1;0;0;;
Santa Amélia;De 500 a menos de 1.000 ha;1;0;1;0;0;0;1;0;1;0;0;0;0;0;0;0;;
Santa Amélia;De 1.000 a menos de 2.500 ha;1;0;1;0;0;0;1;0;1;0;0;0;0;0;0;0;;
Santa Amélia;De 2.500 a menos de 10.000 ha;0;0;0;0;0;0;0;0;0;0;0;0;0;0;0;0;;
Santa Amélia;De 10.000 ha e mais;0;0;0;0;0;0;0;0;0;0;0;0;0;0;0;0;;
Santa Amélia;Produtor sem área;0;0;0;0;0;0;0;0;0;0;0;0;0;0;0;0;;
Santa Cecília do Pavão;Mais de 0 a menos de 0,1 ha;0;0;0;0;0;0;0;0;0;0;0;0;0;0;0;0;;
Santa Cecília do Pavão;De 0,1 a menos de 0,2 ha;0;0;0;0;0;0;0;0;0;0;0;0;0;0;0;0;;
Santa Cecília do Pavão;De 0,2 a menos de 0,5 ha;0;0;0;0;0;0;0;0;0;0;0;0;0;0;0;0;;
Santa Cecília do Pavão;De 0,5 a menos de 1 ha;3;2;0;3;0;2;0;3;0;0;0;3;0;0;1;2;;
Santa Cecília do Pavão;De 1 a menos de 2 ha;5;6;1;4;0;0;1;4;0;1;1;3;0;1;0;3;;
Santa Cecília do Pavão;De 2 a menos de 3 ha;4;10;1;3;0;0;2;2;1;0;1;2;0;0;1;1;;
Santa Cecília do Pavão;De 3 a menos de 4 ha;6;20;0;6;0;20;4;2;0;0;4;2;0;0;0;2;;
Santa Cecília do Pavão;De 4 a menos de 5 ha;11;52;1;10;0;0;8;3;1;0;7;3;0;0;0;3;;
Santa Cecília do Pavão;De 5 a menos de 10 ha;37;281;3;34;25;256;28;9;2;1;26;8;1;0;1;5;;
Santa Cecília do Pavão;De 10 a menos de 20 ha;41;587;2;39;0;0;34;7;2;0;32;7;0;0;4;3;;
Santa Cecília do Pavão;De 20 a menos de 50 ha;33;1113;4;29;114;999;27;6;3;1;24;5;0;0;1;3;;
Santa Cecília do Pavão;De 50 a menos de 100 ha;17;1168;8;9;0;0;15;2;8;0;7;2;0;0;0;2;;
Santa Cecília do Pavão;De 100 a menos de 200 ha;13;1966;13;0;1966;0;12;1;12;1;0;0;0;0;0;0;;
Santa Cecília do Pavão;De 200 a menos de 500 ha;10;3212;10;0;3212;0;8;2;8;2;0;0;0;2;0;0;;
Santa Cecília do Pavão;De 500 a menos de 1.000 ha;0;0;0;0;0;0;0;0;0;0;0;0;0;0;0;0;;
Santa Cecília do Pavão;De 1.000 a menos de 2.500 ha;0;0;0;0;0;0;0;0;0;0;0;0;0;0;0;0;;
Santa Cecília do Pavão;De 2.500 a menos de 10.000 ha;0;0;0;0;0;0;0;0;0;0;0;0;0;0;0;0;;
Santa Cecília do Pavão;De 10.000 ha e mais;0;0;0;0;0;0;0;0;0;0;0;0;0;0;0;0;;
Santa Cecília do Pavão;Produtor sem área;0;0;0;0;0;0;0;0;0;0;0;0;0;0;0;0;;
Santa Cruz de Monte Castelo;Mais de 0 a menos de 0,1 ha;6;0;2;4;0;0;0;6;0;2;0;4;0;1;0;4;;
Santa Cruz de Monte Castelo;De 0,1 a menos de 0,2 ha;1;0;0;1;0;0;1;0;0;0;1;0;0;0;0;0;;
Santa Cruz de Monte Castelo;De 0,2 a menos de 0,5 ha;0;0;0;0;0;0;0;0;0;0;0;0;0;0;0;0;;
Santa Cruz de Monte Castelo;De 0,5 a menos de 1 ha;2;0;0;2;0;0;1;1;0;0;1;1;0;0;0;0;;
Santa Cruz de Monte Castelo;De 1 a menos de 2 ha;2;0;0;2;0;0;0;2;0;0;0;2;0;0;0;2;;
Santa Cruz de Monte Castelo;De 2 a menos de 3 ha;16;39;4;12;10;29;0;16;0;4;0;12;0;3;0;12;;
Santa Cruz de Monte Castelo;De 3 a menos de 4 ha;6;21;1;5;0;0;0;6;0;1;0;5;0;1;0;4;;
Santa Cruz de Monte Castelo;De 4 a menos de 5 ha;22;106;1;21;0;0;0;22;0;1;0;21;0;1;1;19;;
Santa Cruz de Monte Castelo;De 5 a menos de 10 ha;46;363;7;39;48;314;5;41;2;5;3;36;0;5;0;28;;
Santa Cruz de Monte Castelo;De 10 a menos de 20 ha;85;1424;5;80;64;1360;7;78;0;5;7;73;0;5;0;56;;
Santa Cruz de Monte Castelo;De 20 a menos de 50 ha;178;4958;8;170;239;4719;22;156;3;5;19;151;0;1;1;107;;
Santa Cruz de Monte Castelo;De 50 a menos de 100 ha;25;1866;5;20;420;1446;5;20;2;3;3;17;0;2;0;10;;
Santa Cruz de Monte Castelo;De 100 a menos de 200 ha;22;3142;22;0;3142;0;2;20;2;20;0;0;1;18;0;0;;
Santa Cruz de Monte Castelo;De 200 a menos de 500 ha;23;8492;23;0;8492;0;9;14;9;14;0;0;0;10;0;0;;
Santa Cruz de Monte Castelo;De 500 a menos de 1.000 ha;6;3799;6;0;3799;0;2;4;2;4;0;0;0;1;0;0;;
Santa Cruz de Monte Castelo;De 1.000 a menos de 2.500 ha;5;5672;5;0;5672;0;2;3;2;3;0;0;0;0;0;0;;
Santa Cruz de Monte Castelo;De 2.500 a menos de 10.000 ha;0;0;0;0;0;0;0;0;0;0;0;0;0;0;0;0;;
Santa Cruz de Monte Castelo;De 10.000 ha e mais;0;0;0;0;0;0;0;0;0;0;0;0;0;0;0;0;;
Santa Cruz de Monte Castelo;Produtor sem área;0;0;0;0;0;0;0;0;0;0;0;0;0;0;0;0;;
Santa Fé;Mais de 0 a menos de 0,1 ha;1;0;0;1;0;0;0;1;0;0;0;1;0;0;0;1;;
Santa Fé;De 0,1 a menos de 0,2 ha;0;0;0;0;0;0;0;0;0;0;0;0;0;0;0;0;;
Santa Fé;De 0,2 a menos de 0,5 ha;2;0;0;2;0;0;1;1;0;0;1;1;0;0;0;1;;
Santa Fé;De 0,5 a menos de 1 ha;38;19;8;30;4;15;16;22;2;6;14;16;0;5;0;13;;
Santa Fé;De 1 a menos de 2 ha;10;13;1;9;0;0;3;7;0;1;3;6;0;1;0;5;;
Santa Fé;De 2 a menos de 3 ha;21;50;8;13;19;31;5;16;2;6;3;10;0;5;1;6;;
Santa Fé;De 3 a menos de 4 ha;21;75;5;16;18;58;4;17;1;4;3;13;0;4;3;9;;
Santa Fé;De 4 a menos de 5 ha;32;152;7;25;34;118;13;19;2;5;11;14;0;4;2;12;;
Santa Fé;De 5 a menos de 10 ha;71;548;13;58;97;451;19;52;4;9;15;43;2;6;5;28;;
Santa Fé;De 10 a menos de 20 ha;70;1009;11;59;163;846;34;36;7;4;27;32;1;1;4;20;;
Santa Fé;De 20 a menos de 50 ha;82;2626;29;53;978;1648;47;35;15;14;32;21;2;6;3;11;;
Santa Fé;De 50 a menos de 100 ha;33;2330;16;17;1293;1038;25;8;13;3;12;5;0;2;1;2;;
Santa Fé;De 100 a menos de 200 ha;29;4217;29;0;4217;0;20;9;20;9;0;0;0;6;0;0;;
Santa Fé;De 200 a menos de 500 ha;20;5604;20;0;5604;0;17;3;17;3;0;0;0;1;0;0;;
Santa Fé;De 500 a menos de 1.000 ha;2;0;2;0;0;0;2;0;2;0;0;0;0;0;0;0;;
Santa Fé;De 1.000 a menos de 2.500 ha;1;0;1;0;0;0;0;1;0;1;0;0;0;0;0;0;;
Santa Fé;De 2.500 a menos de 10.000 ha;1;0;1;0;0;0;1;0;1;0;0;0;0;0;0;0;;
Santa Fé;De 10.000 ha e mais;0;0;0;0;0;0;0;0;0;0;0;0;0;0;0;0;;
Santa Fé;Produtor sem área;2;0;1;1;0;0;0;0;0;0;0;0;0;0;0;0;;
Santa Helena;Mais de 0 a menos de 0,1 ha;22;1;4;18;0;0;1;21;1;3;0;18;1;2;1;16;;
Santa Helena;De 0,1 a menos de 0,2 ha;46;6;14;32;2;4;2;44;1;13;1;31;3;10;5;23;;
Santa Helena;De 0,2 a menos de 0,5 ha;41;11;14;27;4;7;7;34;2;12;5;22;0;12;3;13;;
Santa Helena;De 0,5 a menos de 1 ha;51;33;11;40;7;26;13;38;3;8;10;30;0;6;7;18;;
Santa Helena;De 1 a menos de 2 ha;84;113;18;66;24;89;37;47;5;13;32;34;0;12;5;21;;
Santa Helena;De 2 a menos de 3 ha;115;280;25;90;61;218;61;54;13;12;48;42;0;9;3;35;;
Santa Helena;De 3 a menos de 4 ha;103;358;13;90;46;312;57;46;2;11;55;35;0;10;5;22;;
Santa Helena;De 4 a menos de 5 ha;96;446;15;81;70;377;64;32;10;5;54;27;1;4;3;18;;
Santa Helena;De 5 a menos de 10 ha;293;2182;23;270;168;2015;239;54;13;10;226;44;2;8;10;24;;
Santa Helena;De 10 a menos de 20 ha;308;4517;24;284;402;4116;287;21;20;4;267;17;1;2;4;8;;
Santa Helena;De 20 a menos de 50 ha;258;8256;23;235;729;7527;250;8;20;3;230;5;1;2;1;2;;
Santa Helena;De 50 a menos de 100 ha;109;7635;46;63;3861;3774;105;4;45;1;60;3;1;0;0;2;;
Santa Helena;De 100 a menos de 200 ha;39;5290;39;0;5290;0;38;1;38;1;0;0;1;0;0;0;;
Santa Helena;De 200 a menos de 500 ha;16;5023;16;0;5023;0;14;2;14;2;0;0;0;2;0;0;;
Santa Helena;De 500 a menos de 1.000 ha;4;0;4;0;0;0;2;2;2;2;0;0;0;2;0;0;;
Santa Helena;De 1.000 a menos de 2.500 ha;3;0;3;0;0;0;3;0;3;0;0;0;0;0;0;0;;
Santa Helena;De 2.500 a menos de 10.000 ha;0;0;0;0;0;0;0;0;0;0;0;0;0;0;0;0;;
Santa Helena;De 10.000 ha e mais;0;0;0;0;0;0;0;0;0;0;0;0;0;0;0;0;;
Santa Helena;Produtor sem área;11;0;2;9;0;0;0;9;0;2;0;7;0;2;0;7;;
Santa Inês;Mais de 0 a menos de 0,1 ha;0;0;0;0;0;0;0;0;0;0;0;0;0;0;0;0;;
Santa Inês;De 0,1 a menos de 0,2 ha;0;0;0;0;0;0;0;0;0;0;0;0;0;0;0;0;;
Santa Inês;De 0,2 a menos de 0,5 ha;0;0;0;0;0;0;0;0;0;0;0;0;0;0;0;0;;
Santa Inês;De 0,5 a menos de 1 ha;0;0;0;0;0;0;0;0;0;0;0;0;0;0;0;0;;
Santa Inês;De 1 a menos de 2 ha;1;0;1;0;0;0;1;0;1;0;0;0;0;0;0;0;;
Santa Inês;De 2 a menos de 3 ha;3;7;1;2;0;0;2;1;1;0;1;1;0;0;0;1;;
Santa Inês;De 3 a menos de 4 ha;0;0;0;0;0;0;0;0;0;0;0;0;0;0;0;0;;
Santa Inês;De 4 a menos de 5 ha;6;29;3;3;0;0;1;5;0;3;1;2;0;3;0;2;;
Santa Inês;De 5 a menos de 10 ha;16;122;6;10;45;76;1;15;0;6;1;9;0;4;0;6;;
Santa Inês;De 10 a menos de 20 ha;22;312;11;11;159;154;3;19;0;11;3;8;0;8;0;5;;
Santa Inês;De 20 a menos de 50 ha;15;480;2;13;0;0;4;11;0;2;4;9;0;1;0;4;;
Santa Inês;De 50 a menos de 100 ha;11;777;7;4;522;255;4;7;3;4;1;3;0;4;0;2;;
Santa Inês;De 100 a menos de 200 ha;6;865;6;0;865;0;4;2;4;2;0;0;0;1;0;0;;
Santa Inês;De 200 a menos de 500 ha;6;1748;6;0;1748;0;2;4;2;4;0;0;0;3;0;0;;
Santa Inês;De 500 a menos de 1.000 ha;1;0;1;0;0;0;1;0;1;0;0;0;0;0;0;0;;
Santa Inês;De 1.000 a menos de 2.500 ha;0;0;0;0;0;0;0;0;0;0;0;0;0;0;0;0;;
Santa Inês;De 2.500 a menos de 10.000 ha;1;0;1;0;0;0;1;0;1;0;0;0;0;0;0;0;;
Santa Inês;De 10.000 ha e mais;0;0;0;0;0;0;0;0;0;0;0;0;0;0;0;0;;
Santa Inês;Produtor sem área;0;0;0;0;0;0;0;0;0;0;0;0;0;0;0;0;;
Santa Isabel do Ivaí;Mais de 0 a menos de 0,1 ha;5;0;2;3;0;0;1;4;0;2;1;2;0;2;0;2;;
Santa Isabel do Ivaí;De 0,1 a menos de 0,2 ha;1;0;0;1;0;0;0;1;0;0;0;1;0;0;0;0;;
Santa Isabel do Ivaí;De 0,2 a menos de 0,5 ha;0;0;0;0;0;0;0;0;0;0;0;0;0;0;0;0;;
Santa Isabel do Ivaí;De 0,5 a menos de 1 ha;4;2;2;2;0;0;1;3;0;2;1;1;0;1;0;1;;
Santa Isabel do Ivaí;De 1 a menos de 2 ha;2;0;1;1;0;0;0;2;0;1;0;1;0;0;0;0;;
Santa Isabel do Ivaí;De 2 a menos de 3 ha;24;58;5;19;12;46;6;18;2;3;4;15;1;1;8;4;;
Santa Isabel do Ivaí;De 3 a menos de 4 ha;4;14;0;4;0;14;1;3;0;0;1;3;0;0;1;1;;
Santa Isabel do Ivaí;De 4 a menos de 5 ha;39;188;5;34;24;164;12;27;1;4;11;23;0;4;9;7;;
Santa Isabel do Ivaí;De 5 a menos de 10 ha;82;655;17;65;135;520;25;57;2;15;23;42;1;11;14;20;;
Santa Isabel do Ivaí;De 10 a menos de 20 ha;90;1216;13;77;178;1038;26;64;4;9;22;55;0;7;5;43;;
Santa Isabel do Ivaí;De 20 a menos de 50 ha;88;2838;10;78;306;2531;32;56;2;8;30;48;0;6;5;31;;
Santa Isabel do Ivaí;De 50 a menos de 100 ha;49;3528;13;36;1120;2408;27;22;9;4;18;18;0;3;0;9;;
Santa Isabel do Ivaí;De 100 a menos de 200 ha;37;5160;37;0;5160;0;19;18;19;18;0;0;1;14;0;0;;
Santa Isabel do Ivaí;De 200 a menos de 500 ha;36;10939;36;0;10939;0;19;17;19;17;0;0;1;7;0;0;;
Santa Isabel do Ivaí;De 500 a menos de 1.000 ha;3;1829;3;0;1829;0;1;2;1;2;0;0;0;0;0;0;;
Santa Isabel do Ivaí;De 1.000 a menos de 2.500 ha;2;0;2;0;0;0;1;1;1;1;0;0;0;0;0;0;;
Santa Isabel do Ivaí;De 2.500 a menos de 10.000 ha;0;0;0;0;0;0;0;0;0;0;0;0;0;0;0;0;;
Santa Isabel do Ivaí;De 10.000 ha e mais;0;0;0;0;0;0;0;0;0;0;0;0;0;0;0;0;;
Santa Isabel do Ivaí;Produtor sem área;1;0;1;0;0;0;0;1;0;1;0;0;0;1;0;0;;
Santa Izabel do Oeste;Mais de 0 a menos de 0,1 ha;7;0;4;3;0;0;1;6;0;4;1;2;0;4;0;2;;
Santa Izabel do Oeste;De 0,1 a menos de 0,2 ha;9;1;7;2;0;0;4;5;3;4;1;1;1;3;0;1;;
Santa Izabel do Oeste;De 0,2 a menos de 0,5 ha;14;4;7;7;2;2;3;11;1;6;2;5;0;5;0;5;;
Santa Izabel do Oeste;De 0,5 a menos de 1 ha;39;25;17;22;10;14;10;29;4;13;6;16;0;10;0;13;;
Santa Izabel do Oeste;De 1 a menos de 2 ha;42;56;10;32;13;43;17;25;5;5;12;20;0;4;1;14;;
Santa Izabel do Oeste;De 2 a menos de 3 ha;44;107;8;36;19;88;20;24;4;4;16;20;0;4;1;14;;
Santa Izabel do Oeste;De 3 a menos de 4 ha;59;200;14;45;47;153;37;22;8;6;29;16;0;3;2;10;;
Santa Izabel do Oeste;De 4 a menos de 5 ha;76;359;13;63;61;298;48;28;8;5;40;23;1;3;1;14;;
Santa Izabel do Oeste;De 5 a menos de 10 ha;211;1583;22;189;165;1417;154;57;7;15;147;42;1;13;2;28;;
Santa Izabel do Oeste;De 10 a menos de 20 ha;249;3569;26;223;359;3210;217;32;16;10;201;22;1;9;2;12;;
Santa Izabel do Oeste;De 20 a menos de 50 ha;209;6464;12;197;360;6104;200;9;10;2;190;7;0;2;1;5;;
Santa Izabel do Oeste;De 50 a menos de 100 ha;68;4812;22;46;1888;2924;65;3;21;1;44;2;0;1;0;2;;
Santa Izabel do Oeste;De 100 a menos de 200 ha;27;3818;27;0;3818;0;26;1;26;1;0;0;0;1;0;0;;
Santa Izabel do Oeste;De 200 a menos de 500 ha;17;4553;17;0;4553;0;17;0;17;0;0;0;0;0;0;0;;
Santa Izabel do Oeste;De 500 a menos de 1.000 ha;3;0;3;0;0;0;2;1;2;1;0;0;0;1;0;0;;
Santa Izabel do Oeste;De 1.000 a menos de 2.500 ha;1;0;1;0;0;0;1;0;1;0;0;0;0;0;0;0;;
Santa Izabel do Oeste;De 2.500 a menos de 10.000 ha;0;0;0;0;0;0;0;0;0;0;0;0;0;0;0;0;;
Santa Izabel do Oeste;De 10.000 ha e mais;0;0;0;0;0;0;0;0;0;0;0;0;0;0;0;0;;
Santa Izabel do Oeste;Produtor sem área;2;0;0;2;0;0;2;0;0;0;2;0;0;0;0;0;;
Santa Lúcia;Mais de 0 a menos de 0,1 ha;1;0;0;1;0;0;0;1;0;0;0;1;0;0;0;1;;
Santa Lúcia;De 0,1 a menos de 0,2 ha;1;0;0;1;0;0;0;1;0;0;0;1;0;0;0;1;;
Santa Lúcia;De 0,2 a menos de 0,5 ha;8;3;1;7;0;0;2;6;0;1;2;5;0;1;1;4;;
Santa Lúcia;De 0,5 a menos de 1 ha;9;6;2;7;0;0;4;5;1;1;3;4;0;1;0;4;;
Santa Lúcia;De 1 a menos de 2 ha;12;17;4;8;6;10;6;6;2;2;4;4;0;2;0;3;;
Santa Lúcia;De 2 a menos de 3 ha;36;88;11;25;27;61;17;19;3;8;14;11;1;6;0;11;;
Santa Lúcia;De 3 a menos de 4 ha;23;84;5;18;18;66;13;10;4;1;9;9;0;1;0;8;;
Santa Lúcia;De 4 a menos de 5 ha;30;143;10;20;48;94;19;11;5;5;14;6;1;4;0;5;;
Santa Lúcia;De 5 a menos de 10 ha;101;803;16;85;116;687;74;27;8;8;66;19;1;7;3;11;;
Santa Lúcia;De 10 a menos de 20 ha;110;1611;19;91;281;1330;87;23;9;10;78;13;2;7;0;13;;
Santa Lúcia;De 20 a menos de 50 ha;103;3170;10;93;260;2910;86;17;5;5;81;12;0;4;2;8;;
Santa Lúcia;De 50 a menos de 100 ha;36;2472;11;25;933;1539;33;3;9;2;24;1;0;2;0;1;;
Santa Lúcia;De 100 a menos de 200 ha;18;2595;18;0;2595;0;16;2;16;2;0;0;0;2;0;0;;
Santa Lúcia;De 200 a menos de 500 ha;4;1135;4;0;1135;0;4;0;4;0;0;0;0;0;0;0;;
Santa Lúcia;De 500 a menos de 1.000 ha;1;0;1;0;0;0;1;0;1;0;0;0;0;0;0;0;;
Santa Lúcia;De 1.000 a menos de 2.500 ha;0;0;0;0;0;0;0;0;0;0;0;0;0;0;0;0;;
Santa Lúcia;De 2.500 a menos de 10.000 ha;0;0;0;0;0;0;0;0;0;0;0;0;0;0;0;0;;
Santa Lúcia;De 10.000 ha e mais;0;0;0;0;0;0;0;0;0;0;0;0;0;0;0;0;;
Santa Lúcia;Produtor sem área;0;0;0;0;0;0;0;0;0;0;0;0;0;0;0;0;;
Santa Maria do Oeste;Mais de 0 a menos de 0,1 ha;30;2;16;14;0;0;1;29;1;15;0;14;5;10;1;12;;
Santa Maria do Oeste;De 0,1 a menos de 0,2 ha;43;6;20;23;3;3;3;40;0;20;3;20;3;15;6;11;;
Santa Maria do Oeste;De 0,2 a menos de 0,5 ha;58;20;23;35;8;12;8;50;2;21;6;29;6;9;5;17;;
Santa Maria do Oeste;De 0,5 a menos de 1 ha;61;43;18;43;13;31;22;39;6;12;16;27;5;3;4;15;;
Santa Maria do Oeste;De 1 a menos de 2 ha;95;135;21;74;29;105;39;56;7;14;32;42;4;6;5;23;;
Santa Maria do Oeste;De 2 a menos de 3 ha;136;332;31;105;76;256;48;88;8;23;40;65;3;16;8;33;;
Santa Maria do Oeste;De 3 a menos de 4 ha;84;293;27;57;95;198;40;44;11;16;29;28;4;10;1;18;;
Santa Maria do Oeste;De 4 a menos de 5 ha;93;444;22;71;106;338;51;42;9;13;42;29;4;8;3;16;;
Santa Maria do Oeste;De 5 a menos de 10 ha;293;2280;44;249;347;1933;171;122;21;23;150;99;2;15;7;64;;
Santa Maria do Oeste;De 10 a menos de 20 ha;435;6289;64;371;913;5376;306;129;46;18;260;111;3;13;12;62;;
Santa Maria do Oeste;De 20 a menos de 50 ha;288;9030;32;256;1007;8023;201;87;14;18;187;69;1;16;7;49;;
Santa Maria do Oeste;De 50 a menos de 100 ha;134;9697;51;83;4395;5302;100;34;37;14;63;20;0;12;1;16;;
Santa Maria do Oeste;De 100 a menos de 200 ha;50;6720;50;0;6720;0;35;15;35;15;0;0;0;12;0;0;;
Santa Maria do Oeste;De 200 a menos de 500 ha;33;9391;33;0;9391;0;30;3;30;3;0;0;0;3;0;0;;
Santa Maria do Oeste;De 500 a menos de 1.000 ha;15;11007;15;0;11007;0;12;3;12;3;0;0;0;2;0;0;;
Santa Maria do Oeste;De 1.000 a menos de 2.500 ha;6;9962;6;0;9962;0;6;0;6;0;0;0;0;0;0;0;;
Santa Maria do Oeste;De 2.500 a menos de 10.000 ha;1;0;1;0;0;0;1;0;1;0;0;0;0;0;0;0;;
Santa Maria do Oeste;De 10.000 ha e mais;0;0;0;0;0;0;0;0;0;0;0;0;0;0;0;0;;
Santa Maria do Oeste;Produtor sem área;6;0;4;2;0;0;0;4;0;2;0;2;0;2;0;2;;
Santa Mariana;Mais de 0 a menos de 0,1 ha;2;0;2;0;0;0;0;2;0;2;0;0;1;1;0;0;;
Santa Mariana;De 0,1 a menos de 0,2 ha;1;0;0;1;0;0;0;1;0;0;0;1;0;0;1;0;;
Santa Mariana;De 0,2 a menos de 0,5 ha;5;2;3;2;0;0;2;3;1;2;1;1;0;1;0;0;;
Santa Mariana;De 0,5 a menos de 1 ha;34;18;2;32;0;0;8;26;0;2;8;24;0;1;1;20;;
Santa Mariana;De 1 a menos de 2 ha;9;10;3;6;4;7;3;6;1;2;2;4;0;2;1;3;;
Santa Mariana;De 2 a menos de 3 ha;9;22;0;9;0;22;5;4;0;0;5;4;0;0;1;2;;
Santa Mariana;De 3 a menos de 4 ha;4;13;0;4;0;13;2;2;0;0;2;2;0;0;1;1;;
Santa Mariana;De 4 a menos de 5 ha;10;47;3;7;14;33;4;6;2;1;2;5;0;1;0;4;;
Santa Mariana;De 5 a menos de 10 ha;34;255;3;31;19;236;28;6;2;1;26;5;0;1;0;3;;
Santa Mariana;De 10 a menos de 20 ha;36;559;7;29;110;449;33;3;7;0;26;3;0;0;0;3;;
Santa Mariana;De 20 a menos de 50 ha;39;1308;9;30;304;1004;34;5;9;0;25;5;0;0;0;5;;
Santa Mariana;De 50 a menos de 100 ha;32;2335;21;11;1667;668;28;4;18;3;10;1;0;3;0;1;;
Santa Mariana;De 100 a menos de 200 ha;33;4773;33;0;4773;0;31;2;31;2;0;0;0;2;0;0;;
Santa Mariana;De 200 a menos de 500 ha;31;10752;31;0;10752;0;31;0;31;0;0;0;0;0;0;0;;
Santa Mariana;De 500 a menos de 1.000 ha;14;10250;14;0;10250;0;12;2;12;2;0;0;0;2;0;0;;
Santa Mariana;De 1.000 a menos de 2.500 ha;6;7873;6;0;7873;0;6;0;6;0;0;0;0;0;0;0;;
Santa Mariana;De 2.500 a menos de 10.000 ha;0;0;0;0;0;0;0;0;0;0;0;0;0;0;0;0;;
Santa Mariana;De 10.000 ha e mais;0;0;0;0;0;0;0;0;0;0;0;0;0;0;0;0;;
Santa Mariana;Produtor sem área;0;0;0;0;0;0;0;0;0;0;0;0;0;0;0;0;;
Santa Mônica;Mais de 0 a menos de 0,1 ha;4;0;2;2;0;0;1;3;0;2;1;1;0;2;0;1;;
Santa Mônica;De 0,1 a menos de 0,2 ha;0;0;0;0;0;0;0;0;0;0;0;0;0;0;0;0;;
Santa Mônica;De 0,2 a menos de 0,5 ha;1;0;0;1;0;0;0;1;0;0;0;1;0;0;0;1;;
Santa Mônica;De 0,5 a menos de 1 ha;36;18;10;26;5;13;4;32;2;8;2;24;0;6;1;16;;
Santa Mônica;De 1 a menos de 2 ha;0;0;0;0;0;0;0;0;0;0;0;0;0;0;0;0;;
Santa Mônica;De 2 a menos de 3 ha;12;29;3;9;7;21;0;12;0;3;0;9;0;2;1;6;;
Santa Mônica;De 3 a menos de 4 ha;12;44;5;7;18;25;2;10;2;3;0;7;0;2;0;4;;
Santa Mônica;De 4 a menos de 5 ha;17;82;5;12;23;58;5;12;3;2;2;10;0;2;0;8;;
Santa Mônica;De 5 a menos de 10 ha;40;308;7;33;56;252;6;34;1;6;5;28;0;2;4;22;;
Santa Mônica;De 10 a menos de 20 ha;73;1189;3;70;42;1146;15;58;1;2;14;56;0;0;6;30;;
Santa Mônica;De 20 a menos de 50 ha;34;1040;5;29;201;839;13;21;1;4;12;17;0;4;1;6;;
Santa Mônica;De 50 a menos de 100 ha;10;787;4;6;0;0;1;9;1;3;0;6;2;0;0;6;;
Santa Mônica;De 100 a menos de 200 ha;6;796;6;0;796;0;5;1;5;1;0;0;0;1;0;0;;
Santa Mônica;De 200 a menos de 500 ha;17;5039;17;0;5039;0;11;6;11;6;0;0;0;3;0;0;;
Santa Mônica;De 500 a menos de 1.000 ha;9;5928;9;0;5928;0;5;4;5;4;0;0;0;3;0;0;;
Santa Mônica;De 1.000 a menos de 2.500 ha;6;7960;6;0;7960;0;5;1;5;1;0;0;0;0;0;0;;
Santa Mônica;De 2.500 a menos de 10.000 ha;1;0;1;0;0;0;1;0;1;0;0;0;0;0;0;0;;
Santa Mônica;De 10.000 ha e mais;0;0;0;0;0;0;0;0;0;0;0;0;0;0;0;0;;
Santa Mônica;Produtor sem área;0;0;0;0;0;0;0;0;0;0;0;0;0;0;0;0;;
Santana do Itararé;Mais de 0 a menos de 0,1 ha;0;0;0;0;0;0;0;0;0;0;0;0;0;0;0;0;;
Santana do Itararé;De 0,1 a menos de 0,2 ha;0;0;0;0;0;0;0;0;0;0;0;0;0;0;0;0;;
Santana do Itararé;De 0,2 a menos de 0,5 ha;3;0;0;3;0;0;1;2;0;0;1;2;0;0;0;2;;
Santana do Itararé;De 0,5 a menos de 1 ha;3;2;2;1;0;0;1;2;1;1;0;1;0;0;0;1;;
Santana do Itararé;De 1 a menos de 2 ha;18;25;2;16;0;0;4;14;1;1;3;13;0;1;0;8;;
Santana do Itararé;De 2 a menos de 3 ha;18;44;4;14;10;34;3;15;0;4;3;11;0;4;0;8;;
Santana do Itararé;De 3 a menos de 4 ha;25;87;7;18;24;63;9;16;2;5;7;11;0;5;0;11;;
Santana do Itararé;De 4 a menos de 5 ha;31;148;4;27;19;129;12;19;0;4;12;15;0;2;0;10;;
Santana do Itararé;De 5 a menos de 10 ha;81;640;7;74;51;589;46;35;3;4;43;31;0;3;0;22;;
Santana do Itararé;De 10 a menos de 20 ha;100;1446;9;91;115;1331;55;45;1;8;54;37;0;8;0;20;;
Santana do Itararé;De 20 a menos de 50 ha;74;2215;5;69;147;2069;42;32;4;1;38;31;0;0;0;24;;
Santana do Itararé;De 50 a menos de 100 ha;26;1947;19;7;1551;396;20;6;14;5;6;1;0;3;0;1;;
Santana do Itararé;De 100 a menos de 200 ha;15;2199;15;0;2199;0;6;9;6;9;0;0;0;7;0;0;;
Santana do Itararé;De 200 a menos de 500 ha;11;3486;11;0;3486;0;7;4;7;4;0;0;0;1;0;0;;
Santana do Itararé;De 500 a menos de 1.000 ha;7;4593;7;0;4593;0;7;0;7;0;0;0;0;0;0;0;;
Santana do Itararé;De 1.000 a menos de 2.500 ha;3;0;3;0;0;0;3;0;3;0;0;0;0;0;0;0;;
Santana do Itararé;De 2.500 a menos de 10.000 ha;0;0;0;0;0;0;0;0;0;0;0;0;0;0;0;0;;
Santana do Itararé;De 10.000 ha e mais;0;0;0;0;0;0;0;0;0;0;0;0;0;0;0;0;;
Santana do Itararé;Produtor sem área;4;0;1;3;0;0;0;0;0;0;0;0;0;0;0;0;;
Santa Tereza do Oeste;Mais de 0 a menos de 0,1 ha;1;0;0;1;0;0;0;1;0;0;0;1;0;0;0;1;;
Santa Tereza do Oeste;De 0,1 a menos de 0,2 ha;5;1;1;4;0;0;1;4;0;1;1;3;0;1;0;1;;
Santa Tereza do Oeste;De 0,2 a menos de 0,5 ha;6;2;1;5;0;0;2;4;0;1;2;3;0;1;0;2;;
Santa Tereza do Oeste;De 0,5 a menos de 1 ha;24;13;2;22;0;0;7;17;0;2;7;15;0;2;1;5;;
Santa Tereza do Oeste;De 1 a menos de 2 ha;3;4;1;2;0;0;1;2;1;0;0;2;0;0;0;1;;
Santa Tereza do Oeste;De 2 a menos de 3 ha;9;22;3;6;0;0;3;6;2;1;1;5;0;0;1;2;;
Santa Tereza do Oeste;De 3 a menos de 4 ha;11;38;4;7;14;24;3;8;0;4;3;4;0;4;0;3;;
Santa Tereza do Oeste;De 4 a menos de 5 ha;15;71;1;14;0;0;9;6;1;0;8;6;0;0;0;6;;
Santa Tereza do Oeste;De 5 a menos de 10 ha;63;452;10;53;71;381;38;25;4;6;34;19;0;6;3;11;;
Santa Tereza do Oeste;De 10 a menos de 20 ha;84;1228;7;77;99;1128;68;16;4;3;64;13;0;3;0;9;;
Santa Tereza do Oeste;De 20 a menos de 50 ha;81;2383;10;71;337;2046;72;9;6;4;66;5;0;3;0;4;;
Santa Tereza do Oeste;De 50 a menos de 100 ha;30;2168;15;15;1275;892;27;3;13;2;14;1;0;2;0;1;;
Santa Tereza do Oeste;De 100 a menos de 200 ha;14;1965;14;0;1965;0;13;1;13;1;0;0;0;0;0;0;;
Santa Tereza do Oeste;De 200 a menos de 500 ha;32;9832;32;0;9832;0;32;0;32;0;0;0;0;0;0;0;;
Santa Tereza do Oeste;De 500 a menos de 1.000 ha;8;4804;8;0;4804;0;8;0;8;0;0;0;0;0;0;0;;
Santa Tereza do Oeste;De 1.000 a menos de 2.500 ha;3;0;3;0;0;0;3;0;3;0;0;0;0;0;0;0;;
Santa Tereza do Oeste;De 2.500 a menos de 10.000 ha;0;0;0;0;0;0;0;0;0;0;0;0;0;0;0;0;;
Santa Tereza do Oeste;De 10.000 ha e mais;0;0;0;0;0;0;0;0;0;0;0;0;0;0;0;0;;
Santa Tereza do Oeste;Produtor sem área;0;0;0;0;0;0;0;0;0;0;0;0;0;0;0;0;;
Santa Terezinha de Itaipu;Mais de 0 a menos de 0,1 ha;28;1;2;26;0;0;0;28;0;2;0;26;0;2;0;26;;
Santa Terezinha de Itaipu;De 0,1 a menos de 0,2 ha;6;0;0;6;0;0;0;6;0;0;0;6;0;0;0;6;;
Santa Terezinha de Itaipu;De 0,2 a menos de 0,5 ha;27;8;6;21;2;6;3;24;2;4;1;20;0;3;1;16;;
Santa Terezinha de Itaipu;De 0,5 a menos de 1 ha;39;21;10;29;5;16;0;39;0;10;0;29;1;6;0;25;;
Santa Terezinha de Itaipu;De 1 a menos de 2 ha;30;38;5;25;7;32;4;26;0;5;4;21;1;4;4;16;;
Santa Terezinha de Itaipu;De 2 a menos de 3 ha;26;62;10;16;25;37;8;18;2;8;6;10;1;6;1;9;;
Santa Terezinha de Itaipu;De 3 a menos de 4 ha;13;44;2;11;0;0;7;6;0;2;7;4;0;2;1;3;;
Santa Terezinha de Itaipu;De 4 a menos de 5 ha;21;99;6;15;27;72;5;16;0;6;5;10;0;5;2;8;;
Santa Terezinha de Itaipu;De 5 a menos de 10 ha;31;232;6;25;43;189;16;15;2;4;14;11;1;2;1;9;;
Santa Terezinha de Itaipu;De 10 a menos de 20 ha;69;985;13;56;162;823;53;16;4;9;49;7;0;8;1;6;;
Santa Terezinha de Itaipu;De 20 a menos de 50 ha;72;2370;5;67;176;2194;71;1;5;0;66;1;0;0;0;1;;
Santa Terezinha de Itaipu;De 50 a menos de 100 ha;28;2061;13;15;1147;914;28;0;13;0;15;0;0;0;0;0;;
Santa Terezinha de Itaipu;De 100 a menos de 200 ha;22;3207;22;0;3207;0;21;1;21;1;0;0;1;0;0;0;;
Santa Terezinha de Itaipu;De 200 a menos de 500 ha;20;6261;20;0;6261;0;20;0;20;0;0;0;0;0;0;0;;
Santa Terezinha de Itaipu;De 500 a menos de 1.000 ha;5;0;5;0;0;0;5;0;5;0;0;0;0;0;0;0;;
Santa Terezinha de Itaipu;De 1.000 a menos de 2.500 ha;1;0;1;0;0;0;0;1;0;1;0;0;0;0;0;0;;
Santa Terezinha de Itaipu;De 2.500 a menos de 10.000 ha;0;0;0;0;0;0;0;0;0;0;0;0;0;0;0;0;;
Santa Terezinha de Itaipu;De 10.000 ha e mais;0;0;0;0;0;0;0;0;0;0;0;0;0;0;0;0;;
Santa Terezinha de Itaipu;Produtor sem área;0;0;0;0;0;0;0;0;0;0;0;0;0;0;0;0;;
Santo Antônio da Platina;Mais de 0 a menos de 0,1 ha;14;1;5;9;0;0;3;11;0;5;3;6;0;5;1;4;;
Santo Antônio da Platina;De 0,1 a menos de 0,2 ha;36;4;15;21;2;3;1;35;0;15;1;20;0;15;0;18;;
Santo Antônio da Platina;De 0,2 a menos de 0,5 ha;46;13;10;36;3;11;3;43;1;9;2;34;0;9;3;28;;
Santo Antônio da Platina;De 0,5 a menos de 1 ha;69;40;27;42;15;24;17;52;4;23;13;29;1;21;1;25;;
Santo Antônio da Platina;De 1 a menos de 2 ha;75;102;19;56;26;77;8;67;2;17;6;50;0;15;1;36;;
Santo Antônio da Platina;De 2 a menos de 3 ha;124;301;29;95;70;230;21;103;6;23;15;80;0;17;3;60;;
Santo Antônio da Platina;De 3 a menos de 4 ha;89;310;21;68;74;236;28;61;6;15;22;46;0;12;0;31;;
Santo Antônio da Platina;De 4 a menos de 5 ha;149;711;23;126;110;601;40;109;4;19;36;90;0;18;2;63;;
Santo Antônio da Platina;De 5 a menos de 10 ha;320;2383;38;282;268;2115;109;211;13;25;96;186;0;20;4;136;;
Santo Antônio da Platina;De 10 a menos de 20 ha;303;4296;36;267;534;3762;112;191;14;22;98;169;0;19;3;124;;
Santo Antônio da Platina;De 20 a menos de 50 ha;216;6916;18;198;585;6331;76;140;5;13;71;127;0;12;1;96;;
Santo Antônio da Platina;De 50 a menos de 100 ha;79;5468;43;36;3332;2136;41;38;22;21;19;17;0;19;0;9;;
Santo Antônio da Platina;De 100 a menos de 200 ha;55;8054;55;0;8054;0;28;27;28;27;0;0;1;20;0;0;;
Santo Antônio da Platina;De 200 a menos de 500 ha;42;12440;42;0;12440;0;18;24;18;24;0;0;0;18;0;0;;
Santo Antônio da Platina;De 500 a menos de 1.000 ha;13;8635;13;0;8635;0;6;7;6;7;0;0;0;2;0;0;;
Santo Antônio da Platina;De 1.000 a menos de 2.500 ha;5;0;5;0;0;0;2;3;2;3;0;0;0;2;0;0;;
Santo Antônio da Platina;De 2.500 a menos de 10.000 ha;1;0;1;0;0;0;0;1;0;1;0;0;0;1;0;0;;
Santo Antônio da Platina;De 10.000 ha e mais;0;0;0;0;0;0;0;0;0;0;0;0;0;0;0;0;;
Santo Antônio da Platina;Produtor sem área;2;0;1;1;0;0;0;1;0;1;0;0;0;1;0;0;;
Santo Antônio do Caiuá;Mais de 0 a menos de 0,1 ha;22;1;10;12;0;0;0;22;0;10;0;12;0;10;0;12;;
Santo Antônio do Caiuá;De 0,1 a menos de 0,2 ha;0;0;0;0;0;0;0;0;0;0;0;0;0;0;0;0;;
Santo Antônio do Caiuá;De 0,2 a menos de 0,5 ha;1;0;0;1;0;0;0;1;0;0;0;1;0;0;0;1;;
Santo Antônio do Caiuá;De 0,5 a menos de 1 ha;48;24;29;19;15;10;6;42;2;27;4;15;0;26;2;11;;
Santo Antônio do Caiuá;De 1 a menos de 2 ha;5;6;0;5;0;6;1;4;0;0;1;4;0;0;0;4;;
Santo Antônio do Caiuá;De 2 a menos de 3 ha;16;39;9;7;22;17;0;16;0;9;0;7;0;8;0;3;;
Santo Antônio do Caiuá;De 3 a menos de 4 ha;8;29;1;7;0;0;1;7;0;1;1;6;0;0;0;5;;
Santo Antônio do Caiuá;De 4 a menos de 5 ha;7;34;4;3;0;0;0;7;0;4;0;3;0;2;0;2;;
Santo Antônio do Caiuá;De 5 a menos de 10 ha;29;216;8;21;59;158;2;27;1;7;1;20;0;6;0;12;;
Santo Antônio do Caiuá;De 10 a menos de 20 ha;19;312;7;12;123;189;3;16;2;5;1;11;0;3;0;9;;
Santo Antônio do Caiuá;De 20 a menos de 50 ha;20;684;7;13;289;396;1;19;1;6;0;13;0;3;0;7;;
Santo Antônio do Caiuá;De 50 a menos de 100 ha;21;1427;11;10;812;615;8;13;4;7;4;6;0;6;1;4;;
Santo Antônio do Caiuá;De 100 a menos de 200 ha;11;1713;11;0;1713;0;3;8;3;8;0;0;0;7;0;0;;
Santo Antônio do Caiuá;De 200 a menos de 500 ha;16;4930;16;0;4930;0;4;12;4;12;0;0;0;7;0;0;;
Santo Antônio do Caiuá;De 500 a menos de 1.000 ha;6;4237;6;0;4237;0;4;2;4;2;0;0;0;1;0;0;;
Santo Antônio do Caiuá;De 1.000 a menos de 2.500 ha;1;0;1;0;0;0;1;0;1;0;0;0;0;0;0;0;;
Santo Antônio do Caiuá;De 2.500 a menos de 10.000 ha;1;0;1;0;0;0;0;1;0;1;0;0;0;1;0;0;;
Santo Antônio do Caiuá;De 10.000 ha e mais;0;0;0;0;0;0;0;0;0;0;0;0;0;0;0;0;;
Santo Antônio do Caiuá;Produtor sem área;0;0;0;0;0;0;0;0;0;0;0;0;0;0;0;0;;
Santo Antônio do Paraíso;Mais de 0 a menos de 0,1 ha;0;0;0;0;0;0;0;0;0;0;0;0;0;0;0;0;;
Santo Antônio do Paraíso;De 0,1 a menos de 0,2 ha;2;0;0;2;0;0;0;2;0;0;0;2;0;0;0;2;;
Santo Antônio do Paraíso;De 0,2 a menos de 0,5 ha;4;0;0;4;0;0;1;3;0;0;1;3;0;0;0;2;;
Santo Antônio do Paraíso;De 0,5 a menos de 1 ha;41;21;14;27;7;14;11;30;7;7;4;23;0;3;0;12;;
Santo Antônio do Paraíso;De 1 a menos de 2 ha;3;0;0;3;0;0;2;1;0;0;2;1;0;0;0;1;;
Santo Antônio do Paraíso;De 2 a menos de 3 ha;7;17;2;5;0;0;6;1;1;1;5;0;0;1;0;0;;
Santo Antônio do Paraíso;De 3 a menos de 4 ha;6;22;1;5;0;0;4;2;0;1;4;1;0;1;0;1;;
Santo Antônio do Paraíso;De 4 a menos de 5 ha;10;48;1;9;0;0;8;2;1;0;7;2;0;0;0;1;;
Santo Antônio do Paraíso;De 5 a menos de 10 ha;13;101;0;13;0;101;11;2;0;0;11;2;0;0;0;1;;
Santo Antônio do Paraíso;De 10 a menos de 20 ha;21;280;5;16;69;211;19;2;4;1;15;1;0;1;0;1;;
Santo Antônio do Paraíso;De 20 a menos de 50 ha;27;871;2;25;0;0;26;1;2;0;24;1;0;0;0;0;;
Santo Antônio do Paraíso;De 50 a menos de 100 ha;8;587;4;4;343;244;7;1;3;1;4;0;0;1;0;0;;
Santo Antônio do Paraíso;De 100 a menos de 200 ha;13;1750;13;0;1750;0;11;2;11;2;0;0;0;2;0;0;;
Santo Antônio do Paraíso;De 200 a menos de 500 ha;19;5887;19;0;5887;0;16;3;16;3;0;0;0;2;0;0;;
Santo Antônio do Paraíso;De 500 a menos de 1.000 ha;4;3161;4;0;3161;0;3;1;3;1;0;0;0;1;0;0;;
Santo Antônio do Paraíso;De 1.000 a menos de 2.500 ha;1;0;1;0;0;0;1;0;1;0;0;0;0;0;0;0;;
Santo Antônio do Paraíso;De 2.500 a menos de 10.000 ha;0;0;0;0;0;0;0;0;0;0;0;0;0;0;0;0;;
Santo Antônio do Paraíso;De 10.000 ha e mais;0;0;0;0;0;0;0;0;0;0;0;0;0;0;0;0;;
Santo Antônio do Paraíso;Produtor sem área;0;0;0;0;0;0;0;0;0;0;0;0;0;0;0;0;;
Santo Antônio do Sudoeste;Mais de 0 a menos de 0,1 ha;11;1;6;5;0;0;2;9;1;5;1;4;0;5;0;3;;
Santo Antônio do Sudoeste;De 0,1 a menos de 0,2 ha;19;2;9;10;1;1;1;18;1;8;0;10;0;7;0;7;;
Santo Antônio do Sudoeste;De 0,2 a menos de 0,5 ha;44;13;23;21;6;6;8;36;5;18;3;18;0;16;1;14;;
Santo Antônio do Sudoeste;De 0,5 a menos de 1 ha;46;31;6;40;4;27;14;32;0;6;14;26;0;5;2;18;;
Santo Antônio do Sudoeste;De 1 a menos de 2 ha;47;64;16;31;22;42;13;34;6;10;7;24;0;8;1;17;;
Santo Antônio do Sudoeste;De 2 a menos de 3 ha;80;193;8;72;20;173;39;41;5;3;34;38;0;2;1;27;;
Santo Antônio do Sudoeste;De 3 a menos de 4 ha;67;231;11;56;38;194;38;29;5;6;33;23;0;5;3;14;;
Santo Antônio do Sudoeste;De 4 a menos de 5 ha;108;510;10;98;47;463;63;45;5;5;58;40;0;4;3;29;;
Santo Antônio do Sudoeste;De 5 a menos de 10 ha;342;2540;31;311;226;2314;223;119;10;21;213;98;0;18;3;59;;
Santo Antônio do Sudoeste;De 10 a menos de 20 ha;278;3918;18;260;245;3673;217;61;9;9;208;52;1;6;4;24;;
Santo Antônio do Sudoeste;De 20 a menos de 50 ha;206;6201;14;192;408;5793;178;28;6;8;172;20;0;6;1;12;;
Santo Antônio do Sudoeste;De 50 a menos de 100 ha;70;4818;18;52;1526;3292;63;7;15;3;48;4;0;2;0;2;;
Santo Antônio do Sudoeste;De 100 a menos de 200 ha;16;2051;16;0;2051;0;13;3;13;3;0;0;0;2;0;0;;
Santo Antônio do Sudoeste;De 200 a menos de 500 ha;10;2815;10;0;2815;0;10;0;10;0;0;0;0;0;0;0;;
Santo Antônio do Sudoeste;De 500 a menos de 1.000 ha;4;0;4;0;0;0;4;0;4;0;0;0;0;0;0;0;;
Santo Antônio do Sudoeste;De 1.000 a menos de 2.500 ha;1;0;1;0;0;0;1;0;1;0;0;0;0;0;0;0;;
Santo Antônio do Sudoeste;De 2.500 a menos de 10.000 ha;0;0;0;0;0;0;0;0;0;0;0;0;0;0;0;0;;
Santo Antônio do Sudoeste;De 10.000 ha e mais;0;0;0;0;0;0;0;0;0;0;0;0;0;0;0;0;;
Santo Antônio do Sudoeste;Produtor sem área;1;0;0;1;0;0;1;0;0;0;1;0;0;0;0;0;;
Santo Inácio;Mais de 0 a menos de 0,1 ha;0;0;0;0;0;0;0;0;0;0;0;0;0;0;0;0;;
Santo Inácio;De 0,1 a menos de 0,2 ha;1;0;0;1;0;0;1;0;0;0;1;0;0;0;0;0;;
Santo Inácio;De 0,2 a menos de 0,5 ha;2;0;1;1;0;0;0;2;0;1;0;1;0;1;1;0;;
Santo Inácio;De 0,5 a menos de 1 ha;19;10;8;11;4;6;6;13;2;6;4;7;0;6;0;4;;
Santo Inácio;De 1 a menos de 2 ha;0;0;0;0;0;0;0;0;0;0;0;0;0;0;0;0;;
Santo Inácio;De 2 a menos de 3 ha;4;10;3;1;0;0;2;2;1;2;1;0;0;2;0;0;;
Santo Inácio;De 3 a menos de 4 ha;3;9;1;2;0;0;0;3;0;1;0;2;0;1;0;1;;
Santo Inácio;De 4 a menos de 5 ha;4;0;2;2;0;0;0;4;0;2;0;2;0;2;0;1;;
Santo Inácio;De 5 a menos de 10 ha;23;185;6;17;43;142;6;17;1;5;5;12;0;5;0;11;;
Santo Inácio;De 10 a menos de 20 ha;59;943;5;54;67;876;40;19;2;3;38;16;0;3;1;13;;
Santo Inácio;De 20 a menos de 50 ha;59;1874;9;50;333;1541;35;24;6;3;29;21;0;1;0;15;;
Santo Inácio;De 50 a menos de 100 ha;16;1127;8;8;627;500;9;7;8;0;1;7;0;0;0;3;;
Santo Inácio;De 100 a menos de 200 ha;17;2469;17;0;2469;0;8;9;8;9;0;0;0;6;0;0;;
Santo Inácio;De 200 a menos de 500 ha;16;4887;16;0;4887;0;12;4;12;4;0;0;0;2;0;0;;
Santo Inácio;De 500 a menos de 1.000 ha;0;0;0;0;0;0;0;0;0;0;0;0;0;0;0;0;;
Santo Inácio;De 1.000 a menos de 2.500 ha;1;0;1;0;0;0;1;0;1;0;0;0;0;0;0;0;;
Santo Inácio;De 2.500 a menos de 10.000 ha;0;0;0;0;0;0;0;0;0;0;0;0;0;0;0;0;;
Santo Inácio;De 10.000 ha e mais;1;0;1;0;0;0;1;0;1;0;0;0;0;0;0;0;;
Santo Inácio;Produtor sem área;0;0;0;0;0;0;0;0;0;0;0;0;0;0;0;0;;
São Carlos do Ivaí;Mais de 0 a menos de 0,1 ha;2;0;0;2;0;0;2;0;0;0;2;0;0;0;0;0;;
São Carlos do Ivaí;De 0,1 a menos de 0,2 ha;1;0;1;0;0;0;1;0;1;0;0;0;0;0;0;0;;
São Carlos do Ivaí;De 0,2 a menos de 0,5 ha;2;0;1;1;0;0;0;2;0;1;0;1;0;0;0;1;;
São Carlos do Ivaí;De 0,5 a menos de 1 ha;12;6;6;6;3;3;1;11;0;6;1;5;0;0;0;2;;
São Carlos do Ivaí;De 1 a menos de 2 ha;5;6;1;4;0;0;1;4;0;1;1;3;0;1;0;2;;
São Carlos do Ivaí;De 2 a menos de 3 ha;12;28;1;11;0;0;1;11;0;1;1;10;0;1;0;4;;
São Carlos do Ivaí;De 3 a menos de 4 ha;13;45;4;9;0;0;3;10;1;3;2;7;0;2;0;2;;
São Carlos do Ivaí;De 4 a menos de 5 ha;6;29;1;5;0;0;1;5;0;1;1;4;0;1;0;2;;
São Carlos do Ivaí;De 5 a menos de 10 ha;13;105;5;8;42;64;4;9;1;4;3;5;0;2;0;1;;
São Carlos do Ivaí;De 10 a menos de 20 ha;15;219;2;13;0;0;8;7;0;2;8;5;0;0;0;2;;
São Carlos do Ivaí;De 20 a menos de 50 ha;17;492;2;15;0;0;9;8;1;1;8;7;0;0;0;2;;
São Carlos do Ivaí;De 50 a menos de 100 ha;19;1417;14;5;1129;289;13;6;10;4;3;2;0;2;0;1;;
São Carlos do Ivaí;De 100 a menos de 200 ha;11;1501;11;0;1501;0;10;1;10;1;0;0;0;1;0;0;;
São Carlos do Ivaí;De 200 a menos de 500 ha;13;3736;13;0;3736;0;11;2;11;2;0;0;0;1;0;0;;
São Carlos do Ivaí;De 500 a menos de 1.000 ha;6;4535;6;0;4535;0;5;1;5;1;0;0;0;0;0;0;;
São Carlos do Ivaí;De 1.000 a menos de 2.500 ha;3;4278;3;0;4278;0;3;0;3;0;0;0;0;0;0;0;;
São Carlos do Ivaí;De 2.500 a menos de 10.000 ha;1;0;1;0;0;0;1;0;1;0;0;0;0;0;0;0;;
São Carlos do Ivaí;De 10.000 ha e mais;0;0;0;0;0;0;0;0;0;0;0;0;0;0;0;0;;
São Carlos do Ivaí;Produtor sem área;1;0;0;1;0;0;1;0;0;0;1;0;0;0;0;0;;
São Jerônimo da Serra;Mais de 0 a menos de 0,1 ha;4;0;0;4;0;0;0;4;0;0;0;4;0;0;0;4;;
São Jerônimo da Serra;De 0,1 a menos de 0,2 ha;2;0;0;2;0;0;0;2;0;0;0;2;0;0;0;2;;
São Jerônimo da Serra;De 0,2 a menos de 0,5 ha;2;0;2;0;0;0;0;2;0;2;0;0;0;2;0;0;;
São Jerônimo da Serra;De 0,5 a menos de 1 ha;53;29;9;44;5;24;22;31;5;4;17;27;1;3;2;18;;
São Jerônimo da Serra;De 1 a menos de 2 ha;90;114;27;63;33;81;18;72;7;20;11;52;5;15;4;40;;
São Jerônimo da Serra;De 2 a menos de 3 ha;116;274;35;81;80;194;72;44;21;14;51;30;8;1;13;13;;
São Jerônimo da Serra;De 3 a menos de 4 ha;53;185;5;48;17;168;27;26;2;3;25;23;0;3;2;15;;
São Jerônimo da Serra;De 4 a menos de 5 ha;76;364;12;64;58;305;45;31;5;7;40;24;0;7;1;20;;
São Jerônimo da Serra;De 5 a menos de 10 ha;163;1248;13;150;96;1151;94;69;7;6;87;63;0;5;7;38;;
São Jerônimo da Serra;De 10 a menos de 20 ha;454;6674;42;412;610;6063;264;190;15;27;249;163;1;21;11;119;;
São Jerônimo da Serra;De 20 a menos de 50 ha;148;4479;18;130;577;3902;89;59;9;9;80;50;2;5;9;30;;
São Jerônimo da Serra;De 50 a menos de 100 ha;76;5324;22;54;1885;3439;49;27;13;9;36;18;0;8;2;14;;
São Jerônimo da Serra;De 100 a menos de 200 ha;54;8075;52;2;0;0;36;18;35;17;1;1;2;12;0;1;;
São Jerônimo da Serra;De 200 a menos de 500 ha;48;14960;45;3;14099;862;29;19;27;18;2;1;3;14;0;1;;
São Jerônimo da Serra;De 500 a menos de 1.000 ha;13;9134;13;0;9134;0;10;3;10;3;0;0;0;1;0;0;;
São Jerônimo da Serra;De 1.000 a menos de 2.500 ha;5;0;5;0;0;0;4;1;4;1;0;0;0;1;0;0;;
São Jerônimo da Serra;De 2.500 a menos de 10.000 ha;0;0;0;0;0;0;0;0;0;0;0;0;0;0;0;0;;
São Jerônimo da Serra;De 10.000 ha e mais;0;0;0;0;0;0;0;0;0;0;0;0;0;0;0;0;;
São Jerônimo da Serra;Produtor sem área;0;0;0;0;0;0;0;0;0;0;0;0;0;0;0;0;;
São João;Mais de 0 a menos de 0,1 ha;2;0;1;1;0;0;1;1;0;1;1;0;1;0;0;0;;
São João;De 0,1 a menos de 0,2 ha;15;2;7;8;1;1;13;2;6;1;7;1;1;0;1;0;;
São João;De 0,2 a menos de 0,5 ha;26;7;11;15;3;4;17;9;6;5;11;4;2;2;0;4;;
São João;De 0,5 a menos de 1 ha;76;49;27;49;18;31;36;40;15;12;21;28;1;9;3;20;;
São João;De 1 a menos de 2 ha;49;65;13;36;17;48;27;22;6;7;21;15;1;4;3;9;;
São João;De 2 a menos de 3 ha;63;152;10;53;23;128;45;18;7;3;38;15;0;2;0;10;;
São João;De 3 a menos de 4 ha;46;163;9;37;32;131;34;12;7;2;27;10;0;2;0;6;;
São João;De 4 a menos de 5 ha;78;374;5;73;24;350;60;18;5;0;55;18;0;0;0;15;;
São João;De 5 a menos de 10 ha;202;1551;15;187;113;1438;181;21;6;9;175;12;1;4;2;9;;
São João;De 10 a menos de 20 ha;272;3896;9;263;140;3756;267;5;8;1;259;4;0;1;0;3;;
São João;De 20 a menos de 50 ha;231;7180;10;221;309;6871;230;1;10;0;220;1;0;0;0;0;;
São João;De 50 a menos de 100 ha;96;6461;19;77;1614;4846;93;3;17;2;76;1;0;1;0;0;;
São João;De 100 a menos de 200 ha;36;4881;36;0;4881;0;36;0;36;0;0;0;0;0;0;0;;
São João;De 200 a menos de 500 ha;18;5577;18;0;5577;0;16;2;16;2;0;0;0;1;0;0;;
São João;De 500 a menos de 1.000 ha;1;0;1;0;0;0;1;0;1;0;0;0;0;0;0;0;;
São João;De 1.000 a menos de 2.500 ha;1;0;1;0;0;0;1;0;1;0;0;0;0;0;0;0;;
São João;De 2.500 a menos de 10.000 ha;0;0;0;0;0;0;0;0;0;0;0;0;0;0;0;0;;
São João;De 10.000 ha e mais;0;0;0;0;0;0;0;0;0;0;0;0;0;0;0;0;;
São João;Produtor sem área;3;0;1;2;0;0;1;2;1;0;0;2;0;0;1;1;;
São João do Caiuá;Mais de 0 a menos de 0,1 ha;17;1;3;14;0;1;0;17;0;3;0;14;0;3;0;14;;
São João do Caiuá;De 0,1 a menos de 0,2 ha;2;0;2;0;0;0;0;2;0;2;0;0;0;2;0;0;;
São João do Caiuá;De 0,2 a menos de 0,5 ha;7;2;4;3;1;1;0;7;0;4;0;3;0;4;0;2;;
São João do Caiuá;De 0,5 a menos de 1 ha;42;21;21;21;11;11;3;39;1;20;2;19;1;19;1;17;;
São João do Caiuá;De 1 a menos de 2 ha;12;14;6;6;7;7;0;12;0;6;0;6;0;6;0;6;;
São João do Caiuá;De 2 a menos de 3 ha;8;19;5;3;12;7;2;6;1;4;1;2;0;4;0;1;;
São João do Caiuá;De 3 a menos de 4 ha;9;32;3;6;10;22;0;9;0;3;0;6;0;3;0;2;;
São João do Caiuá;De 4 a menos de 5 ha;11;53;8;3;0;0;1;10;1;7;0;3;0;7;0;2;;
São João do Caiuá;De 5 a menos de 10 ha;25;194;8;17;54;140;2;23;1;7;1;16;0;4;1;8;;
São João do Caiuá;De 10 a menos de 20 ha;56;914;10;46;167;748;11;45;1;9;10;36;0;7;1;23;;
São João do Caiuá;De 20 a menos de 50 ha;48;1597;10;38;341;1256;14;34;2;8;12;26;0;7;1;16;;
São João do Caiuá;De 50 a menos de 100 ha;19;1250;6;13;378;873;6;13;3;3;3;10;1;2;1;4;;
São João do Caiuá;De 100 a menos de 200 ha;18;2581;18;0;2581;0;7;11;7;11;0;0;0;9;0;0;;
São João do Caiuá;De 200 a menos de 500 ha;28;7672;28;0;7672;0;12;16;12;16;0;0;1;6;0;0;;
São João do Caiuá;De 500 a menos de 1.000 ha;7;5369;7;0;5369;0;2;5;2;5;0;0;0;2;0;0;;
São João do Caiuá;De 1.000 a menos de 2.500 ha;2;0;2;0;0;0;0;2;0;2;0;0;0;2;0;0;;
São João do Caiuá;De 2.500 a menos de 10.000 ha;3;8501;3;0;8501;0;3;0;3;0;0;0;0;0;0;0;;
São João do Caiuá;De 10.000 ha e mais;0;0;0;0;0;0;0;0;0;0;0;0;0;0;0;0;;
São João do Caiuá;Produtor sem área;5;0;2;3;0;0;0;4;0;2;0;2;0;2;0;2;;
São João do Ivaí;Mais de 0 a menos de 0,1 ha;3;0;2;1;0;0;1;2;0;2;1;0;0;2;0;0;;
São João do Ivaí;De 0,1 a menos de 0,2 ha;4;0;2;2;0;0;3;1;1;1;2;0;0;1;0;0;;
São João do Ivaí;De 0,2 a menos de 0,5 ha;10;4;4;6;2;2;1;9;1;3;0;6;0;2;0;5;;
São João do Ivaí;De 0,5 a menos de 1 ha;81;47;38;43;23;25;22;59;11;27;11;32;0;20;0;25;;
São João do Ivaí;De 1 a menos de 2 ha;34;45;14;20;20;25;14;20;4;10;10;10;0;9;0;8;;
São João do Ivaí;De 2 a menos de 3 ha;33;80;8;25;19;61;17;16;4;4;13;12;0;3;0;10;;
São João do Ivaí;De 3 a menos de 4 ha;41;143;11;30;38;105;27;14;6;5;21;9;0;5;0;9;;
São João do Ivaí;De 4 a menos de 5 ha;28;132;1;27;0;0;18;10;0;1;18;9;0;1;0;5;;
São João do Ivaí;De 5 a menos de 10 ha;94;705;9;85;69;635;76;18;2;7;74;11;0;5;0;8;;
São João do Ivaí;De 10 a menos de 20 ha;114;1650;11;103;157;1492;96;18;7;4;89;14;0;4;0;10;;
São João do Ivaí;De 20 a menos de 50 ha;116;3777;9;107;297;3480;104;12;5;4;99;8;1;3;0;8;;
São João do Ivaí;De 50 a menos de 100 ha;61;4264;27;34;2240;2024;58;3;26;1;32;2;0;1;0;2;;
São João do Ivaí;De 100 a menos de 200 ha;29;4136;29;0;4136;0;28;1;28;1;0;0;0;1;0;0;;
São João do Ivaí;De 200 a menos de 500 ha;19;5650;19;0;5650;0;19;0;19;0;0;0;0;0;0;0;;
São João do Ivaí;De 500 a menos de 1.000 ha;8;5876;8;0;5876;0;8;0;8;0;0;0;0;0;0;0;;
São João do Ivaí;De 1.000 a menos de 2.500 ha;2;0;2;0;0;0;2;0;2;0;0;0;0;0;0;0;;
São João do Ivaí;De 2.500 a menos de 10.000 ha;0;0;0;0;0;0;0;0;0;0;0;0;0;0;0;0;;
São João do Ivaí;De 10.000 ha e mais;0;0;0;0;0;0;0;0;0;0;0;0;0;0;0;0;;
São João do Ivaí;Produtor sem área;1;0;0;1;0;0;0;1;0;0;0;1;0;0;0;1;;
São João do Triunfo;Mais de 0 a menos de 0,1 ha;4;0;0;4;0;0;3;1;0;0;3;1;0;0;1;0;;
São João do Triunfo;De 0,1 a menos de 0,2 ha;5;1;3;2;0;0;3;2;2;1;1;1;0;1;0;1;;
São João do Triunfo;De 0,2 a menos de 0,5 ha;16;6;4;12;2;4;5;11;2;2;3;9;0;2;3;2;;
São João do Triunfo;De 0,5 a menos de 1 ha;38;29;8;30;6;23;22;16;3;5;19;11;2;3;2;7;;
São João do Triunfo;De 1 a menos de 2 ha;105;155;14;91;19;137;82;23;9;5;73;18;2;1;4;6;;
São João do Triunfo;De 2 a menos de 3 ha;204;514;26;178;66;448;185;19;22;4;163;15;1;2;6;8;;
São João do Triunfo;De 3 a menos de 4 ha;224;788;30;194;107;682;197;27;23;7;174;20;3;4;4;11;;
São João do Triunfo;De 4 a menos de 5 ha;229;1085;35;194;167;919;216;13;33;2;183;11;1;1;6;2;;
São João do Triunfo;De 5 a menos de 10 ha;556;4108;93;463;707;3400;515;41;88;5;427;36;1;1;17;13;;
São João do Triunfo;De 10 a menos de 20 ha;331;4692;39;292;526;4167;300;31;35;4;265;27;0;3;11;11;;
São João do Triunfo;De 20 a menos de 50 ha;175;5288;32;143;973;4315;148;27;28;4;120;23;2;2;9;11;;
São João do Triunfo;De 50 a menos de 100 ha;31;2098;17;14;1276;822;29;2;16;1;13;1;0;1;1;0;;
São João do Triunfo;De 100 a menos de 200 ha;18;2503;18;0;2503;0;17;1;17;1;0;0;0;1;0;0;;
São João do Triunfo;De 200 a menos de 500 ha;15;5163;15;0;5163;0;8;7;8;7;0;0;2;5;0;0;;
São João do Triunfo;De 500 a menos de 1.000 ha;4;2967;4;0;2967;0;3;1;3;1;0;0;0;1;0;0;;
São João do Triunfo;De 1.000 a menos de 2.500 ha;3;0;3;0;0;0;1;2;1;2;0;0;1;1;0;0;;
São João do Triunfo;De 2.500 a menos de 10.000 ha;1;0;1;0;0;0;1;0;1;0;0;0;0;0;0;0;;
São João do Triunfo;De 10.000 ha e mais;0;0;0;0;0;0;0;0;0;0;0;0;0;0;0;0;;
São João do Triunfo;Produtor sem área;0;0;0;0;0;0;0;0;0;0;0;0;0;0;0;0;;
São Jorge d'Oeste;Mais de 0 a menos de 0,1 ha;7;0;1;6;0;0;3;4;1;0;2;4;0;0;1;3;;
São Jorge d'Oeste;De 0,1 a menos de 0,2 ha;9;1;3;6;0;0;1;8;1;2;0;6;2;0;4;2;;
São Jorge d'Oeste;De 0,2 a menos de 0,5 ha;18;5;6;12;2;3;6;12;3;3;3;9;0;3;2;6;;
São Jorge d'Oeste;De 0,5 a menos de 1 ha;60;37;12;48;7;30;19;41;3;9;16;32;2;3;3;27;;
São Jorge d'Oeste;De 1 a menos de 2 ha;16;22;5;11;7;15;14;2;5;0;9;2;0;0;0;1;;
São Jorge d'Oeste;De 2 a menos de 3 ha;53;128;9;44;21;107;40;13;6;3;34;10;1;2;2;7;;
São Jorge d'Oeste;De 3 a menos de 4 ha;60;208;7;53;24;183;49;11;7;0;42;11;0;0;2;7;;
São Jorge d'Oeste;De 4 a menos de 5 ha;69;330;4;65;19;311;51;18;4;0;47;18;0;0;1;16;;
São Jorge d'Oeste;De 5 a menos de 10 ha;201;1559;13;188;107;1453;175;26;9;4;166;22;1;3;0;16;;
São Jorge d'Oeste;De 10 a menos de 20 ha;236;3342;19;217;268;3075;219;17;15;4;204;13;0;2;0;11;;
São Jorge d'Oeste;De 20 a menos de 50 ha;184;5770;15;169;483;5287;175;9;11;4;164;5;0;3;0;3;;
São Jorge d'Oeste;De 50 a menos de 100 ha;63;4292;14;49;1221;3071;62;1;13;1;49;0;0;1;0;0;;
São Jorge d'Oeste;De 100 a menos de 200 ha;27;3475;27;0;3475;0;23;4;23;4;0;0;0;3;0;0;;
São Jorge d'Oeste;De 200 a menos de 500 ha;14;4469;14;0;4469;0;12;2;12;2;0;0;0;2;0;0;;
São Jorge d'Oeste;De 500 a menos de 1.000 ha;5;0;5;0;0;0;5;0;5;0;0;0;0;0;0;0;;
São Jorge d'Oeste;De 1.000 a menos de 2.500 ha;2;0;2;0;0;0;2;0;2;0;0;0;0;0;0;0;;
São Jorge d'Oeste;De 2.500 a menos de 10.000 ha;0;0;0;0;0;0;0;0;0;0;0;0;0;0;0;0;;
São Jorge d'Oeste;De 10.000 ha e mais;0;0;0;0;0;0;0;0;0;0;0;0;0;0;0;0;;
São Jorge d'Oeste;Produtor sem área;0;0;0;0;0;0;0;0;0;0;0;0;0;0;0;0;;
São Jorge do Ivaí;Mais de 0 a menos de 0,1 ha;1;0;0;1;0;0;0;1;0;0;0;1;0;0;0;1;;
São Jorge do Ivaí;De 0,1 a menos de 0,2 ha;1;0;0;1;0;0;0;1;0;0;0;1;0;0;0;0;;
São Jorge do Ivaí;De 0,2 a menos de 0,5 ha;13;6;8;5;4;2;3;10;1;7;2;3;0;3;0;2;;
São Jorge do Ivaí;De 0,5 a menos de 1 ha;6;5;5;1;0;0;2;4;2;3;0;1;0;2;0;0;;
São Jorge do Ivaí;De 1 a menos de 2 ha;16;19;1;15;0;0;3;13;0;1;3;12;0;0;1;7;;
São Jorge do Ivaí;De 2 a menos de 3 ha;5;12;0;5;0;12;3;2;0;0;3;2;0;0;0;1;;
São Jorge do Ivaí;De 3 a menos de 4 ha;7;25;0;7;0;25;1;6;0;0;1;6;0;0;1;5;;
São Jorge do Ivaí;De 4 a menos de 5 ha;4;19;0;4;0;19;2;2;0;0;2;2;0;0;0;2;;
São Jorge do Ivaí;De 5 a menos de 10 ha;13;94;0;13;0;94;10;3;0;0;10;3;0;0;0;1;;
São Jorge do Ivaí;De 10 a menos de 20 ha;28;403;4;24;56;347;19;9;1;3;18;6;0;3;0;4;;
São Jorge do Ivaí;De 20 a menos de 50 ha;39;1331;11;28;356;975;34;5;6;5;28;0;0;4;0;0;;
São Jorge do Ivaí;De 50 a menos de 100 ha;38;2663;23;15;1834;829;37;1;22;1;15;0;0;1;0;0;;
São Jorge do Ivaí;De 100 a menos de 200 ha;41;6074;41;0;6074;0;40;1;40;1;0;0;0;0;0;0;;
São Jorge do Ivaí;De 200 a menos de 500 ha;26;8246;26;0;8246;0;26;0;26;0;0;0;0;0;0;0;;
São Jorge do Ivaí;De 500 a menos de 1.000 ha;12;8341;12;0;8341;0;12;0;12;0;0;0;0;0;0;0;;
São Jorge do Ivaí;De 1.000 a menos de 2.500 ha;3;0;3;0;0;0;3;0;3;0;0;0;0;0;0;0;;
São Jorge do Ivaí;De 2.500 a menos de 10.000 ha;0;0;0;0;0;0;0;0;0;0;0;0;0;0;0;0;;
São Jorge do Ivaí;De 10.000 ha e mais;0;0;0;0;0;0;0;0;0;0;0;0;0;0;0;0;;
São Jorge do Ivaí;Produtor sem área;0;0;0;0;0;0;0;0;0;0;0;0;0;0;0;0;;
São Jorge do Patrocínio;Mais de 0 a menos de 0,1 ha;0;0;0;0;0;0;0;0;0;0;0;0;0;0;0;0;;
São Jorge do Patrocínio;De 0,1 a menos de 0,2 ha;0;0;0;0;0;0;0;0;0;0;0;0;0;0;0;0;;
São Jorge do Patrocínio;De 0,2 a menos de 0,5 ha;7;3;4;3;0;0;4;3;3;1;1;2;0;0;0;0;;
São Jorge do Patrocínio;De 0,5 a menos de 1 ha;30;16;15;15;8;8;13;17;6;9;7;8;0;2;2;2;;
São Jorge do Patrocínio;De 1 a menos de 2 ha;10;15;4;6;6;9;3;7;1;3;2;4;0;1;0;0;;
São Jorge do Patrocínio;De 2 a menos de 3 ha;20;49;7;13;17;33;11;9;2;5;9;4;0;2;0;0;;
São Jorge do Patrocínio;De 3 a menos de 4 ha;34;123;9;25;32;91;15;19;4;5;11;14;0;2;0;3;;
São Jorge do Patrocínio;De 4 a menos de 5 ha;45;215;8;37;39;177;30;15;3;5;27;10;0;1;0;4;;
São Jorge do Patrocínio;De 5 a menos de 10 ha;158;1194;27;131;200;994;86;72;12;15;74;57;0;4;0;20;;
São Jorge do Patrocínio;De 10 a menos de 20 ha;153;2125;17;136;236;1888;81;72;5;12;76;60;0;5;0;16;;
São Jorge do Patrocínio;De 20 a menos de 50 ha;145;4452;24;121;786;3666;66;79;8;16;58;63;0;3;1;13;;
São Jorge do Patrocínio;De 50 a menos de 100 ha;50;3442;15;35;1216;2226;32;18;9;6;23;12;0;0;0;2;;
São Jorge do Patrocínio;De 100 a menos de 200 ha;23;3048;23;0;3048;0;12;11;12;11;0;0;0;4;0;0;;
São Jorge do Patrocínio;De 200 a menos de 500 ha;9;2401;9;0;2401;0;7;2;7;2;0;0;1;1;0;0;;
São Jorge do Patrocínio;De 500 a menos de 1.000 ha;3;0;3;0;0;0;1;2;1;2;0;0;0;1;0;0;;
São Jorge do Patrocínio;De 1.000 a menos de 2.500 ha;0;0;0;0;0;0;0;0;0;0;0;0;0;0;0;0;;
São Jorge do Patrocínio;De 2.500 a menos de 10.000 ha;0;0;0;0;0;0;0;0;0;0;0;0;0;0;0;0;;
São Jorge do Patrocínio;De 10.000 ha e mais;0;0;0;0;0;0;0;0;0;0;0;0;0;0;0;0;;
São Jorge do Patrocínio;Produtor sem área;1;0;0;1;0;0;0;0;0;0;0;0;0;0;0;0;;
São José da Boa Vista;Mais de 0 a menos de 0,1 ha;0;0;0;0;0;0;0;0;0;0;0;0;0;0;0;0;;
São José da Boa Vista;De 0,1 a menos de 0,2 ha;3;0;1;2;0;0;0;3;0;1;0;2;0;1;0;2;;
São José da Boa Vista;De 0,2 a menos de 0,5 ha;11;4;1;10;0;0;0;11;0;1;0;10;0;1;0;8;;
São José da Boa Vista;De 0,5 a menos de 1 ha;14;11;1;13;0;0;0;14;0;1;0;13;0;1;0;12;;
São José da Boa Vista;De 1 a menos de 2 ha;33;43;12;21;15;29;7;26;2;10;5;16;0;9;0;15;;
São José da Boa Vista;De 2 a menos de 3 ha;43;103;8;35;20;83;9;34;2;6;7;28;0;5;0;22;;
São José da Boa Vista;De 3 a menos de 4 ha;53;186;8;45;29;158;18;35;2;6;16;29;0;5;0;26;;
São José da Boa Vista;De 4 a menos de 5 ha;45;218;9;36;44;174;14;31;0;9;14;22;0;8;0;20;;
São José da Boa Vista;De 5 a menos de 10 ha;148;1133;23;125;179;954;59;89;5;18;54;71;0;16;0;62;;
São José da Boa Vista;De 10 a menos de 20 ha;188;2709;18;170;264;2445;86;102;1;17;85;85;0;16;0;78;;
São José da Boa Vista;De 20 a menos de 50 ha;131;3994;18;113;537;3457;60;71;4;14;56;57;0;12;0;51;;
São José da Boa Vista;De 50 a menos de 100 ha;46;3070;25;21;1827;1243;28;18;15;10;13;8;0;10;0;8;;
São José da Boa Vista;De 100 a menos de 200 ha;40;5458;40;0;5458;0;22;18;22;18;0;0;0;16;0;0;;
São José da Boa Vista;De 200 a menos de 500 ha;25;7242;25;0;7242;0;18;7;18;7;0;0;0;5;0;0;;
São José da Boa Vista;De 500 a menos de 1.000 ha;8;5119;8;0;5119;0;7;1;7;1;0;0;0;1;0;0;;
São José da Boa Vista;De 1.000 a menos de 2.500 ha;4;5911;4;0;5911;0;3;1;3;1;0;0;0;0;0;0;;
São José da Boa Vista;De 2.500 a menos de 10.000 ha;0;0;0;0;0;0;0;0;0;0;0;0;0;0;0;0;;
São José da Boa Vista;De 10.000 ha e mais;0;0;0;0;0;0;0;0;0;0;0;0;0;0;0;0;;
São José da Boa Vista;Produtor sem área;13;0;1;12;0;0;1;1;0;0;1;1;0;0;0;1;;
São José das Palmeiras;Mais de 0 a menos de 0,1 ha;0;0;0;0;0;0;0;0;0;0;0;0;0;0;0;0;;
São José das Palmeiras;De 0,1 a menos de 0,2 ha;2;0;1;1;0;0;0;2;0;1;0;1;0;1;0;1;;
São José das Palmeiras;De 0,2 a menos de 0,5 ha;1;0;0;1;0;0;0;1;0;0;0;1;0;0;0;1;;
São José das Palmeiras;De 0,5 a menos de 1 ha;13;7;8;5;4;3;8;5;6;2;2;3;0;1;0;1;;
São José das Palmeiras;De 1 a menos de 2 ha;19;26;8;11;10;16;6;13;3;5;3;8;0;4;0;7;;
São José das Palmeiras;De 2 a menos de 3 ha;20;50;5;15;13;37;12;8;4;1;8;7;0;1;1;4;;
São José das Palmeiras;De 3 a menos de 4 ha;22;75;3;19;11;64;8;14;0;3;8;11;0;2;0;7;;
São José das Palmeiras;De 4 a menos de 5 ha;48;227;11;37;53;174;33;15;7;4;26;11;0;3;1;1;;
São José das Palmeiras;De 5 a menos de 10 ha;86;654;11;75;84;569;56;30;6;5;50;25;0;2;2;12;;
São José das Palmeiras;De 10 a menos de 20 ha;95;1285;14;81;186;1099;76;19;7;7;69;12;0;3;0;7;;
São José das Palmeiras;De 20 a menos de 50 ha;43;1335;14;29;462;873;36;7;11;3;25;4;0;1;0;2;;
São José das Palmeiras;De 50 a menos de 100 ha;21;1461;13;8;1010;450;15;6;10;3;5;3;0;2;0;2;;
São José das Palmeiras;De 100 a menos de 200 ha;18;2618;18;0;2618;0;16;2;16;2;0;0;0;2;0;0;;
São José das Palmeiras;De 200 a menos de 500 ha;11;3282;11;0;3282;0;10;1;10;1;0;0;0;1;0;0;;
São José das Palmeiras;De 500 a menos de 1.000 ha;5;3436;5;0;3436;0;4;1;4;1;0;0;0;1;0;0;;
São José das Palmeiras;De 1.000 a menos de 2.500 ha;1;0;1;0;0;0;1;0;1;0;0;0;0;0;0;0;;
São José das Palmeiras;De 2.500 a menos de 10.000 ha;1;0;1;0;0;0;1;0;1;0;0;0;0;0;0;0;;
São José das Palmeiras;De 10.000 ha e mais;0;0;0;0;0;0;0;0;0;0;0;0;0;0;0;0;;
São José das Palmeiras;Produtor sem área;2;0;1;1;0;0;0;0;0;0;0;0;0;0;0;0;;
São José dos Pinhais;Mais de 0 a menos de 0,1 ha;8;0;0;8;0;0;3;5;0;0;3;5;0;0;1;3;;
São José dos Pinhais;De 0,1 a menos de 0,2 ha;9;1;1;8;0;0;0;9;0;1;0;8;1;0;1;4;;
São José dos Pinhais;De 0,2 a menos de 0,5 ha;39;12;9;30;3;9;8;31;4;5;4;26;2;3;6;7;;
São José dos Pinhais;De 0,5 a menos de 1 ha;80;54;15;65;10;44;18;62;1;14;17;48;1;8;6;26;;
São José dos Pinhais;De 1 a menos de 2 ha;121;157;25;96;34;123;46;75;6;19;40;56;0;13;6;31;;
São José dos Pinhais;De 2 a menos de 3 ha;176;415;33;143;79;336;81;95;13;20;68;75;1;13;9;36;;
São José dos Pinhais;De 3 a menos de 4 ha;106;355;26;80;86;269;46;60;7;19;39;41;2;14;5;16;;
São José dos Pinhais;De 4 a menos de 5 ha;120;558;22;98;102;455;73;47;9;13;64;34;0;8;4;17;;
São José dos Pinhais;De 5 a menos de 10 ha;344;2539;38;306;270;2268;238;106;18;20;220;86;1;13;14;30;;
São José dos Pinhais;De 10 a menos de 20 ha;297;4194;42;255;616;3578;221;76;22;20;199;56;3;9;14;19;;
São José dos Pinhais;De 20 a menos de 50 ha;138;4250;40;98;1439;2811;100;38;20;20;80;18;4;10;7;8;;
São José dos Pinhais;De 50 a menos de 100 ha;46;3245;46;0;3245;0;33;13;33;13;0;0;4;7;0;0;;
São José dos Pinhais;De 100 a menos de 200 ha;23;3185;23;0;3185;0;16;7;16;7;0;0;0;4;0;0;;
São José dos Pinhais;De 200 a menos de 500 ha;7;0;7;0;0;0;3;4;3;4;0;0;1;3;0;0;;
São José dos Pinhais;De 500 a menos de 1.000 ha;1;0;1;0;0;0;1;0;1;0;0;0;0;0;0;0;;
São José dos Pinhais;De 1.000 a menos de 2.500 ha;0;0;0;0;0;0;0;0;0;0;0;0;0;0;0;0;;
São José dos Pinhais;De 2.500 a menos de 10.000 ha;0;0;0;0;0;0;0;0;0;0;0;0;0;0;0;0;;
São José dos Pinhais;De 10.000 ha e mais;0;0;0;0;0;0;0;0;0;0;0;0;0;0;0;0;;
São José dos Pinhais;Produtor sem área;0;0;0;0;0;0;0;0;0;0;0;0;0;0;0;0;;
São Manoel do Paraná;Mais de 0 a menos de 0,1 ha;4;0;3;1;0;0;0;4;0;3;0;1;0;3;0;1;;
São Manoel do Paraná;De 0,1 a menos de 0,2 ha;2;0;1;1;0;0;0;2;0;1;0;1;0;1;0;1;;
São Manoel do Paraná;De 0,2 a menos de 0,5 ha;4;1;2;2;0;0;1;3;0;2;1;1;0;2;0;1;;
São Manoel do Paraná;De 0,5 a menos de 1 ha;22;13;11;11;0;0;5;17;2;9;3;8;0;9;0;3;;
São Manoel do Paraná;De 1 a menos de 2 ha;20;25;12;8;16;10;5;15;3;9;2;6;0;5;0;4;;
São Manoel do Paraná;De 2 a menos de 3 ha;17;42;6;11;15;27;3;14;0;6;3;8;0;4;0;7;;
São Manoel do Paraná;De 3 a menos de 4 ha;26;89;6;20;19;70;6;20;1;5;5;15;0;3;0;11;;
São Manoel do Paraná;De 4 a menos de 5 ha;18;85;5;13;24;62;7;11;2;3;5;8;0;3;0;5;;
São Manoel do Paraná;De 5 a menos de 10 ha;41;311;9;32;61;250;16;25;3;6;13;19;0;6;0;12;;
São Manoel do Paraná;De 10 a menos de 20 ha;28;393;4;24;52;341;11;17;2;2;9;15;0;2;0;5;;
São Manoel do Paraná;De 20 a menos de 50 ha;16;455;3;13;80;376;9;7;1;2;8;5;0;2;0;3;;
São Manoel do Paraná;De 50 a menos de 100 ha;6;467;3;3;273;195;5;1;2;1;3;0;0;0;0;0;;
São Manoel do Paraná;De 100 a menos de 200 ha;7;1037;7;0;1037;0;7;0;7;0;0;0;0;0;0;0;;
São Manoel do Paraná;De 200 a menos de 500 ha;2;0;2;0;0;0;2;0;2;0;0;0;0;0;0;0;;
São Manoel do Paraná;De 500 a menos de 1.000 ha;1;0;1;0;0;0;1;0;1;0;0;0;0;0;0;0;;
São Manoel do Paraná;De 1.000 a menos de 2.500 ha;0;0;0;0;0;0;0;0;0;0;0;0;0;0;0;0;;
São Manoel do Paraná;De 2.500 a menos de 10.000 ha;1;0;1;0;0;0;1;0;1;0;0;0;0;0;0;0;;
São Manoel do Paraná;De 10.000 ha e mais;0;0;0;0;0;0;0;0;0;0;0;0;0;0;0;0;;
São Manoel do Paraná;Produtor sem área;2;0;1;1;0;0;0;0;0;0;0;0;0;0;0;0;;
São Mateus do Sul;Mais de 0 a menos de 0,1 ha;18;1;8;10;1;1;3;15;1;7;2;8;1;5;1;6;;
São Mateus do Sul;De 0,1 a menos de 0,2 ha;54;8;22;32;3;5;9;45;2;20;7;25;4;14;3;18;;
São Mateus do Sul;De 0,2 a menos de 0,5 ha;135;49;61;74;23;26;22;113;14;47;8;66;6;31;6;39;;
São Mateus do Sul;De 0,5 a menos de 1 ha;229;168;103;126;73;95;74;155;35;68;39;87;9;44;8;57;;
São Mateus do Sul;De 1 a menos de 2 ha;321;452;109;212;151;301;121;200;37;72;84;128;5;46;14;72;;
São Mateus do Sul;De 2 a menos de 3 ha;294;731;87;207;216;515;153;141;31;56;122;85;7;33;8;55;;
São Mateus do Sul;De 3 a menos de 4 ha;234;816;49;185;168;647;140;94;19;30;121;64;7;18;3;37;;
São Mateus do Sul;De 4 a menos de 5 ha;258;1216;45;213;213;1003;160;98;17;28;143;70;3;21;6;50;;
São Mateus do Sul;De 5 a menos de 10 ha;629;4774;76;553;572;4202;451;178;36;40;415;138;3;31;11;91;;
São Mateus do Sul;De 10 a menos de 20 ha;542;7796;43;499;599;7196;416;126;25;18;391;108;3;12;6;67;;
São Mateus do Sul;De 20 a menos de 50 ha;419;12822;34;385;1080;11742;361;58;25;9;336;49;0;6;1;26;;
São Mateus do Sul;De 50 a menos de 100 ha;133;9260;84;49;6466;2794;122;11;77;7;45;4;0;5;0;3;;
São Mateus do Sul;De 100 a menos de 200 ha;76;10600;65;11;0;0;65;11;60;5;5;6;0;5;0;5;;
São Mateus do Sul;De 200 a menos de 500 ha;42;12980;39;3;0;0;35;7;33;6;2;1;2;3;0;0;;
São Mateus do Sul;De 500 a menos de 1.000 ha;12;9212;12;0;9212;0;12;0;12;0;0;0;0;0;0;0;;
São Mateus do Sul;De 1.000 a menos de 2.500 ha;7;8897;6;1;0;0;5;2;5;1;0;1;0;1;0;1;;
São Mateus do Sul;De 2.500 a menos de 10.000 ha;1;0;1;0;0;0;1;0;1;0;0;0;0;0;0;0;;
São Mateus do Sul;De 10.000 ha e mais;0;0;0;0;0;0;0;0;0;0;0;0;0;0;0;0;;
São Mateus do Sul;Produtor sem área;2;0;2;0;0;0;0;0;0;0;0;0;0;0;0;0;;
São Miguel do Iguaçu;Mais de 0 a menos de 0,1 ha;11;0;5;6;0;0;0;11;0;5;0;6;0;5;0;6;;
São Miguel do Iguaçu;De 0,1 a menos de 0,2 ha;3;0;0;3;0;0;0;3;0;0;0;3;0;0;0;3;;
São Miguel do Iguaçu;De 0,2 a menos de 0,5 ha;19;6;5;14;2;4;3;16;0;5;3;11;0;5;1;9;;
São Miguel do Iguaçu;De 0,5 a menos de 1 ha;90;51;28;62;16;35;6;84;2;26;4;58;0;24;5;46;;
São Miguel do Iguaçu;De 1 a menos de 2 ha;116;130;48;68;50;80;15;101;2;46;13;55;0;46;1;51;;
São Miguel do Iguaçu;De 2 a menos de 3 ha;96;226;16;80;36;190;34;62;4;12;30;50;0;12;3;42;;
São Miguel do Iguaçu;De 3 a menos de 4 ha;55;193;5;50;0;0;31;24;1;4;30;20;0;4;1;19;;
São Miguel do Iguaçu;De 4 a menos de 5 ha;79;375;8;71;37;338;42;37;1;7;41;30;0;7;2;26;;
São Miguel do Iguaçu;De 5 a menos de 10 ha;290;2363;24;266;191;2172;225;65;8;16;217;49;0;14;6;33;;
São Miguel do Iguaçu;De 10 a menos de 20 ha;284;4052;20;264;278;3774;239;45;7;13;232;32;0;10;0;26;;
São Miguel do Iguaçu;De 20 a menos de 50 ha;319;10021;21;298;618;9404;297;22;13;8;284;14;1;5;0;10;;
São Miguel do Iguaçu;De 50 a menos de 100 ha;89;6287;44;45;3632;2654;86;3;43;1;43;2;0;0;0;1;;
São Miguel do Iguaçu;De 100 a menos de 200 ha;69;9933;68;1;0;0;67;2;67;1;0;1;0;1;0;1;;
São Miguel do Iguaçu;De 200 a menos de 500 ha;56;16011;56;0;16011;0;56;0;56;0;0;0;0;0;0;0;;
São Miguel do Iguaçu;De 500 a menos de 1.000 ha;10;7465;10;0;7465;0;10;0;10;0;0;0;0;0;0;0;;
São Miguel do Iguaçu;De 1.000 a menos de 2.500 ha;2;0;2;0;0;0;2;0;2;0;0;0;0;0;0;0;;
São Miguel do Iguaçu;De 2.500 a menos de 10.000 ha;0;0;0;0;0;0;0;0;0;0;0;0;0;0;0;0;;
São Miguel do Iguaçu;De 10.000 ha e mais;0;0;0;0;0;0;0;0;0;0;0;0;0;0;0;0;;
São Miguel do Iguaçu;Produtor sem área;0;0;0;0;0;0;0;0;0;0;0;0;0;0;0;0;;
São Pedro do Iguaçu;Mais de 0 a menos de 0,1 ha;0;0;0;0;0;0;0;0;0;0;0;0;0;0;0;0;;
São Pedro do Iguaçu;De 0,1 a menos de 0,2 ha;0;0;0;0;0;0;0;0;0;0;0;0;0;0;0;0;;
São Pedro do Iguaçu;De 0,2 a menos de 0,5 ha;1;0;1;0;0;0;1;0;1;0;0;0;0;0;0;0;;
São Pedro do Iguaçu;De 0,5 a menos de 1 ha;18;10;6;12;3;7;4;14;1;5;3;9;0;3;0;8;;
São Pedro do Iguaçu;De 1 a menos de 2 ha;7;10;0;7;0;10;2;5;0;0;2;5;0;0;0;3;;
São Pedro do Iguaçu;De 2 a menos de 3 ha;10;24;0;10;0;24;5;5;0;0;5;5;0;0;1;3;;
São Pedro do Iguaçu;De 3 a menos de 4 ha;14;48;3;11;10;38;9;5;2;1;7;4;0;1;0;3;;
São Pedro do Iguaçu;De 4 a menos de 5 ha;26;120;5;21;23;97;10;16;3;2;7;14;1;1;1;10;;
São Pedro do Iguaçu;De 5 a menos de 10 ha;107;796;6;101;44;752;73;34;1;5;72;29;3;2;2;19;;
São Pedro do Iguaçu;De 10 a menos de 20 ha;112;1676;7;105;110;1567;94;18;5;2;89;16;0;1;3;8;;
São Pedro do Iguaçu;De 20 a menos de 50 ha;113;3385;7;106;218;3168;105;8;4;3;101;5;2;0;0;3;;
São Pedro do Iguaçu;De 50 a menos de 100 ha;49;3390;20;29;1639;1751;46;3;18;2;28;1;0;1;0;1;;
São Pedro do Iguaçu;De 100 a menos de 200 ha;26;3732;26;0;3732;0;23;3;23;3;0;0;2;1;0;0;;
São Pedro do Iguaçu;De 200 a menos de 500 ha;21;6589;21;0;6589;0;19;2;19;2;0;0;0;1;0;0;;
São Pedro do Iguaçu;De 500 a menos de 1.000 ha;3;2081;3;0;2081;0;3;0;3;0;0;0;0;0;0;0;;
São Pedro do Iguaçu;De 1.000 a menos de 2.500 ha;2;0;2;0;0;0;2;0;2;0;0;0;0;0;0;0;;
São Pedro do Iguaçu;De 2.500 a menos de 10.000 ha;0;0;0;0;0;0;0;0;0;0;0;0;0;0;0;0;;
São Pedro do Iguaçu;De 10.000 ha e mais;0;0;0;0;0;0;0;0;0;0;0;0;0;0;0;0;;
São Pedro do Iguaçu;Produtor sem área;0;0;0;0;0;0;0;0;0;0;0;0;0;0;0;0;;
São Pedro do Ivaí;Mais de 0 a menos de 0,1 ha;4;0;1;3;0;0;1;3;0;1;1;2;0;1;0;2;;
São Pedro do Ivaí;De 0,1 a menos de 0,2 ha;3;0;1;2;0;0;1;2;1;0;0;2;0;0;0;2;;
São Pedro do Ivaí;De 0,2 a menos de 0,5 ha;10;4;2;8;0;0;4;6;1;1;3;5;1;0;0;5;;
São Pedro do Ivaí;De 0,5 a menos de 1 ha;115;64;54;61;30;34;33;82;14;40;19;42;2;30;0;28;;
São Pedro do Ivaí;De 1 a menos de 2 ha;11;15;6;5;7;8;3;8;1;5;2;3;0;5;0;1;;
São Pedro do Ivaí;De 2 a menos de 3 ha;13;30;7;6;16;14;4;9;2;5;2;4;1;4;0;3;;
São Pedro do Ivaí;De 3 a menos de 4 ha;10;34;5;5;17;18;6;4;1;4;5;0;0;2;0;0;;
São Pedro do Ivaí;De 4 a menos de 5 ha;10;46;5;5;23;24;7;3;2;3;5;0;0;2;0;0;;
São Pedro do Ivaí;De 5 a menos de 10 ha;26;197;8;18;56;141;15;11;3;5;12;6;0;4;0;3;;
São Pedro do Ivaí;De 10 a menos de 20 ha;29;438;2;27;0;0;23;6;0;2;23;4;0;2;0;4;;
São Pedro do Ivaí;De 20 a menos de 50 ha;36;1118;3;33;94;1024;32;4;0;3;32;1;1;2;0;1;;
São Pedro do Ivaí;De 50 a menos de 100 ha;33;2501;21;12;1768;733;28;5;16;5;12;0;0;4;0;0;;
São Pedro do Ivaí;De 100 a menos de 200 ha;20;3263;20;0;3263;0;17;3;17;3;0;0;0;2;0;0;;
São Pedro do Ivaí;De 200 a menos de 500 ha;20;6339;20;0;6339;0;19;1;19;1;0;0;0;1;0;0;;
São Pedro do Ivaí;De 500 a menos de 1.000 ha;5;3585;5;0;3585;0;5;0;5;0;0;0;0;0;0;0;;
São Pedro do Ivaí;De 1.000 a menos de 2.500 ha;1;0;1;0;0;0;1;0;1;0;0;0;0;0;0;0;;
São Pedro do Ivaí;De 2.500 a menos de 10.000 ha;1;0;1;0;0;0;1;0;1;0;0;0;0;0;0;0;;
São Pedro do Ivaí;De 10.000 ha e mais;0;0;0;0;0;0;0;0;0;0;0;0;0;0;0;0;;
São Pedro do Ivaí;Produtor sem área;0;0;0;0;0;0;0;0;0;0;0;0;0;0;0;0;;
São Pedro do Paraná;Mais de 0 a menos de 0,1 ha;0;0;0;0;0;0;0;0;0;0;0;0;0;0;0;0;;
São Pedro do Paraná;De 0,1 a menos de 0,2 ha;0;0;0;0;0;0;0;0;0;0;0;0;0;0;0;0;;
São Pedro do Paraná;De 0,2 a menos de 0,5 ha;0;0;0;0;0;0;0;0;0;0;0;0;0;0;0;0;;
São Pedro do Paraná;De 0,5 a menos de 1 ha;0;0;0;0;0;0;0;0;0;0;0;0;0;0;0;0;;
São Pedro do Paraná;De 1 a menos de 2 ha;0;0;0;0;0;0;0;0;0;0;0;0;0;0;0;0;;
São Pedro do Paraná;De 2 a menos de 3 ha;26;63;11;15;26;36;1;25;0;11;1;14;0;10;0;12;;
São Pedro do Paraná;De 3 a menos de 4 ha;22;75;12;10;42;34;1;21;1;11;0;10;0;9;1;9;;
São Pedro do Paraná;De 4 a menos de 5 ha;21;100;9;12;43;57;0;21;0;9;0;12;0;7;0;9;;
São Pedro do Paraná;De 5 a menos de 10 ha;55;392;14;41;99;293;3;52;0;14;3;38;0;13;0;26;;
São Pedro do Paraná;De 10 a menos de 20 ha;85;1196;28;57;418;777;3;82;0;28;3;54;0;21;0;41;;
São Pedro do Paraná;De 20 a menos de 50 ha;54;1772;7;47;243;1529;6;48;1;6;5;42;0;3;0;34;;
São Pedro do Paraná;De 50 a menos de 100 ha;29;1900;7;22;444;1456;6;23;1;6;5;17;0;4;0;11;;
São Pedro do Paraná;De 100 a menos de 200 ha;17;2361;17;0;2361;0;1;16;1;16;0;0;0;13;0;0;;
São Pedro do Paraná;De 200 a menos de 500 ha;22;7206;22;0;7206;0;4;18;4;18;0;0;0;9;0;0;;
São Pedro do Paraná;De 500 a menos de 1.000 ha;12;7551;12;0;7551;0;1;11;1;11;0;0;0;6;0;0;;
São Pedro do Paraná;De 1.000 a menos de 2.500 ha;0;0;0;0;0;0;0;0;0;0;0;0;0;0;0;0;;
São Pedro do Paraná;De 2.500 a menos de 10.000 ha;0;0;0;0;0;0;0;0;0;0;0;0;0;0;0;0;;
São Pedro do Paraná;De 10.000 ha e mais;0;0;0;0;0;0;0;0;0;0;0;0;0;0;0;0;;
São Pedro do Paraná;Produtor sem área;0;0;0;0;0;0;0;0;0;0;0;0;0;0;0;0;;
São Sebastião da Amoreira;Mais de 0 a menos de 0,1 ha;0;0;0;0;0;0;0;0;0;0;0;0;0;0;0;0;;
São Sebastião da Amoreira;De 0,1 a menos de 0,2 ha;0;0;0;0;0;0;0;0;0;0;0;0;0;0;0;0;;
São Sebastião da Amoreira;De 0,2 a menos de 0,5 ha;1;0;0;1;0;0;0;1;0;0;0;1;0;0;1;0;;
São Sebastião da Amoreira;De 0,5 a menos de 1 ha;33;17;0;33;0;17;17;16;0;0;17;16;0;0;2;6;;
São Sebastião da Amoreira;De 1 a menos de 2 ha;1;0;0;1;0;0;1;0;0;0;1;0;0;0;0;0;;
São Sebastião da Amoreira;De 2 a menos de 3 ha;6;15;1;5;0;0;3;3;1;0;2;3;0;0;2;1;;
São Sebastião da Amoreira;De 3 a menos de 4 ha;7;25;1;6;0;0;4;3;1;0;3;3;0;0;1;1;;
São Sebastião da Amoreira;De 4 a menos de 5 ha;5;23;2;3;0;0;0;5;0;2;0;3;0;1;1;2;;
São Sebastião da Amoreira;De 5 a menos de 10 ha;10;81;0;10;0;81;6;4;0;0;6;4;0;0;1;2;;
São Sebastião da Amoreira;De 10 a menos de 20 ha;24;361;0;24;0;361;21;3;0;0;21;3;0;0;0;3;;
São Sebastião da Amoreira;De 20 a menos de 50 ha;52;1699;2;50;0;0;44;8;1;1;43;7;0;1;1;6;;
São Sebastião da Amoreira;De 50 a menos de 100 ha;18;1126;3;15;229;897;17;1;3;0;14;1;0;0;0;1;;
São Sebastião da Amoreira;De 100 a menos de 200 ha;16;2398;16;0;2398;0;16;0;16;0;0;0;0;0;0;0;;
São Sebastião da Amoreira;De 200 a menos de 500 ha;7;2456;7;0;2456;0;7;0;7;0;0;0;0;0;0;0;;
São Sebastião da Amoreira;De 500 a menos de 1.000 ha;1;0;1;0;0;0;1;0;1;0;0;0;0;0;0;0;;
São Sebastião da Amoreira;De 1.000 a menos de 2.500 ha;2;0;2;0;0;0;2;0;2;0;0;0;0;0;0;0;;
São Sebastião da Amoreira;De 2.500 a menos de 10.000 ha;1;0;1;0;0;0;1;0;1;0;0;0;0;0;0;0;;
São Sebastião da Amoreira;De 10.000 ha e mais;0;0;0;0;0;0;0;0;0;0;0;0;0;0;0;0;;
São Sebastião da Amoreira;Produtor sem área;0;0;0;0;0;0;0;0;0;0;0;0;0;0;0;0;;
São Tomé;Mais de 0 a menos de 0,1 ha;0;0;0;0;0;0;0;0;0;0;0;0;0;0;0;0;;
São Tomé;De 0,1 a menos de 0,2 ha;1;0;0;1;0;0;0;1;0;0;0;1;0;0;0;1;;
São Tomé;De 0,2 a menos de 0,5 ha;1;0;0;1;0;0;1;0;0;0;1;0;0;0;0;0;;
São Tomé;De 0,5 a menos de 1 ha;4;0;0;4;0;0;0;4;0;0;0;4;0;0;0;3;;
São Tomé;De 1 a menos de 2 ha;21;26;5;16;7;20;4;17;0;5;4;12;0;4;0;11;;
São Tomé;De 2 a menos de 3 ha;26;64;5;21;12;52;6;20;0;5;6;15;0;5;0;13;;
São Tomé;De 3 a menos de 4 ha;19;65;5;14;16;48;4;15;2;3;2;12;0;1;0;9;;
São Tomé;De 4 a menos de 5 ha;18;85;2;16;0;0;9;9;2;0;7;9;0;0;0;6;;
São Tomé;De 5 a menos de 10 ha;40;316;6;34;49;266;27;13;3;3;24;10;0;3;0;6;;
São Tomé;De 10 a menos de 20 ha;81;1099;14;67;201;898;54;27;7;7;47;20;0;5;0;15;;
São Tomé;De 20 a menos de 50 ha;55;1630;9;46;243;1387;42;13;7;2;35;11;0;1;0;8;;
São Tomé;De 50 a menos de 100 ha;15;1169;7;8;592;576;12;3;4;3;8;0;0;3;0;0;;
São Tomé;De 100 a menos de 200 ha;4;0;4;0;0;0;2;2;2;2;0;0;0;1;0;0;;
São Tomé;De 200 a menos de 500 ha;5;1229;5;0;1229;0;3;2;3;2;0;0;0;0;0;0;;
São Tomé;De 500 a menos de 1.000 ha;0;0;0;0;0;0;0;0;0;0;0;0;0;0;0;0;;
São Tomé;De 1.000 a menos de 2.500 ha;0;0;0;0;0;0;0;0;0;0;0;0;0;0;0;0;;
São Tomé;De 2.500 a menos de 10.000 ha;1;0;1;0;0;0;1;0;1;0;0;0;0;0;0;0;;
São Tomé;De 10.000 ha e mais;1;0;1;0;0;0;1;0;1;0;0;0;0;0;0;0;;
São Tomé;Produtor sem área;0;0;0;0;0;0;0;0;0;0;0;0;0;0;0;0;;
Sapopema;Mais de 0 a menos de 0,1 ha;0;0;0;0;0;0;0;0;0;0;0;0;0;0;0;0;;
Sapopema;De 0,1 a menos de 0,2 ha;0;0;0;0;0;0;0;0;0;0;0;0;0;0;0;0;;
Sapopema;De 0,2 a menos de 0,5 ha;4;0;0;4;0;0;1;3;0;0;1;3;0;0;0;2;;
Sapopema;De 0,5 a menos de 1 ha;26;14;12;14;6;8;8;18;3;9;5;9;0;4;1;4;;
Sapopema;De 1 a menos de 2 ha;12;15;3;9;4;11;1;11;0;3;1;8;0;3;0;7;;
Sapopema;De 2 a menos de 3 ha;16;38;6;10;14;25;1;15;0;6;1;9;0;6;0;6;;
Sapopema;De 3 a menos de 4 ha;15;52;2;13;0;0;4;11;1;1;3;10;0;1;0;9;;
Sapopema;De 4 a menos de 5 ha;24;116;7;17;34;82;6;18;1;6;5;12;0;6;1;9;;
Sapopema;De 5 a menos de 10 ha;63;470;17;46;124;346;16;47;5;12;11;35;0;10;0;30;;
Sapopema;De 10 a menos de 20 ha;125;1905;21;104;322;1583;37;88;5;16;32;72;0;16;1;60;;
Sapopema;De 20 a menos de 50 ha;201;5797;22;179;600;5198;59;142;3;19;56;123;0;16;3;103;;
Sapopema;De 50 a menos de 100 ha;57;4517;38;19;3382;1134;22;35;13;25;9;10;0;21;0;10;;
Sapopema;De 100 a menos de 200 ha;38;4992;38;0;4992;0;17;21;17;21;0;0;0;20;0;0;;
Sapopema;De 200 a menos de 500 ha;47;14867;47;0;14867;0;21;26;21;26;0;0;0;20;0;0;;
Sapopema;De 500 a menos de 1.000 ha;18;13218;18;0;13218;0;6;12;6;12;0;0;0;10;0;0;;
Sapopema;De 1.000 a menos de 2.500 ha;6;8921;6;0;8921;0;2;4;2;4;0;0;0;3;0;0;;
Sapopema;De 2.500 a menos de 10.000 ha;1;0;1;0;0;0;1;0;1;0;0;0;0;0;0;0;;
Sapopema;De 10.000 ha e mais;0;0;0;0;0;0;0;0;0;0;0;0;0;0;0;0;;
Sapopema;Produtor sem área;0;0;0;0;0;0;0;0;0;0;0;0;0;0;0;0;;
Sarandi;Mais de 0 a menos de 0,1 ha;0;0;0;0;0;0;0;0;0;0;0;0;0;0;0;0;;
Sarandi;De 0,1 a menos de 0,2 ha;0;0;0;0;0;0;0;0;0;0;0;0;0;0;0;0;;
Sarandi;De 0,2 a menos de 0,5 ha;6;2;1;5;0;0;2;4;0;1;2;3;0;0;0;2;;
Sarandi;De 0,5 a menos de 1 ha;10;8;2;8;0;0;7;3;2;0;5;3;0;0;0;1;;
Sarandi;De 1 a menos de 2 ha;16;19;3;13;4;15;8;8;0;3;8;5;2;1;0;3;;
Sarandi;De 2 a menos de 3 ha;11;24;0;11;0;24;8;3;0;0;8;3;0;0;0;3;;
Sarandi;De 3 a menos de 4 ha;3;0;0;3;0;0;3;0;0;0;3;0;0;0;0;0;;
Sarandi;De 4 a menos de 5 ha;6;26;0;6;0;26;3;3;0;0;3;3;0;0;1;0;;
Sarandi;De 5 a menos de 10 ha;11;83;2;9;0;0;11;0;2;0;9;0;0;0;0;0;;
Sarandi;De 10 a menos de 20 ha;16;240;3;13;39;202;15;1;2;1;13;0;0;1;0;0;;
Sarandi;De 20 a menos de 50 ha;29;935;6;23;0;0;25;4;2;4;23;0;0;3;0;0;;
Sarandi;De 50 a menos de 100 ha;13;919;11;2;0;0;13;0;11;0;2;0;0;0;0;0;;
Sarandi;De 100 a menos de 200 ha;18;2869;18;0;2869;0;18;0;18;0;0;0;0;0;0;0;;
Sarandi;De 200 a menos de 500 ha;5;0;5;0;0;0;5;0;5;0;0;0;0;0;0;0;;
Sarandi;De 500 a menos de 1.000 ha;0;0;0;0;0;0;0;0;0;0;0;0;0;0;0;0;;
Sarandi;De 1.000 a menos de 2.500 ha;0;0;0;0;0;0;0;0;0;0;0;0;0;0;0;0;;
Sarandi;De 2.500 a menos de 10.000 ha;0;0;0;0;0;0;0;0;0;0;0;0;0;0;0;0;;
Sarandi;De 10.000 ha e mais;0;0;0;0;0;0;0;0;0;0;0;0;0;0;0;0;;
Sarandi;Produtor sem área;0;0;0;0;0;0;0;0;0;0;0;0;0;0;0;0;;
Saudade do Iguaçu;Mais de 0 a menos de 0,1 ha;2;0;0;2;0;0;0;2;0;0;0;2;0;0;1;1;;
Saudade do Iguaçu;De 0,1 a menos de 0,2 ha;1;0;0;1;0;0;0;1;0;0;0;1;0;0;0;1;;
Saudade do Iguaçu;De 0,2 a menos de 0,5 ha;2;0;1;1;0;0;1;1;0;1;1;0;0;1;0;0;;
Saudade do Iguaçu;De 0,5 a menos de 1 ha;2;0;1;1;0;0;0;2;0;1;0;1;0;1;0;0;;
Saudade do Iguaçu;De 1 a menos de 2 ha;9;12;3;6;0;0;6;3;1;2;5;1;1;1;0;1;;
Saudade do Iguaçu;De 2 a menos de 3 ha;15;37;5;10;13;24;12;3;3;2;9;1;0;2;1;0;;
Saudade do Iguaçu;De 3 a menos de 4 ha;21;72;0;21;0;72;17;4;0;0;17;4;0;0;1;1;;
Saudade do Iguaçu;De 4 a menos de 5 ha;25;116;5;20;23;93;24;1;5;0;19;1;0;0;0;1;;
Saudade do Iguaçu;De 5 a menos de 10 ha;103;766;12;91;97;669;94;9;11;1;83;8;0;1;1;7;;
Saudade do Iguaçu;De 10 a menos de 20 ha;203;3175;9;194;130;3045;195;8;7;2;188;6;0;1;1;4;;
Saudade do Iguaçu;De 20 a menos de 50 ha;115;3323;4;111;140;3184;113;2;3;1;110;1;0;1;0;1;;
Saudade do Iguaçu;De 50 a menos de 100 ha;23;1518;5;18;376;1142;22;1;4;1;18;0;0;1;0;0;;
Saudade do Iguaçu;De 100 a menos de 200 ha;8;1156;8;0;1156;0;6;2;6;2;0;0;1;1;0;0;;
Saudade do Iguaçu;De 200 a menos de 500 ha;6;1768;6;0;1768;0;6;0;6;0;0;0;0;0;0;0;;
Saudade do Iguaçu;De 500 a menos de 1.000 ha;0;0;0;0;0;0;0;0;0;0;0;0;0;0;0;0;;
Saudade do Iguaçu;De 1.000 a menos de 2.500 ha;0;0;0;0;0;0;0;0;0;0;0;0;0;0;0;0;;
Saudade do Iguaçu;De 2.500 a menos de 10.000 ha;0;0;0;0;0;0;0;0;0;0;0;0;0;0;0;0;;
Saudade do Iguaçu;De 10.000 ha e mais;0;0;0;0;0;0;0;0;0;0;0;0;0;0;0;0;;
Saudade do Iguaçu;Produtor sem área;0;0;0;0;0;0;0;0;0;0;0;0;0;0;0;0;;
Sengés;Mais de 0 a menos de 0,1 ha;7;0;4;3;0;0;0;7;0;4;0;3;0;4;0;2;;
Sengés;De 0,1 a menos de 0,2 ha;4;1;1;3;0;0;0;4;0;1;0;3;0;1;0;3;;
Sengés;De 0,2 a menos de 0,5 ha;0;0;0;0;0;0;0;0;0;0;0;0;0;0;0;0;;
Sengés;De 0,5 a menos de 1 ha;14;9;7;7;4;4;3;11;1;6;2;5;0;6;0;5;;
Sengés;De 1 a menos de 2 ha;34;47;16;18;22;25;2;32;1;15;1;17;0;10;0;15;;
Sengés;De 2 a menos de 3 ha;64;156;23;41;56;100;11;53;3;20;8;33;2;18;1;29;;
Sengés;De 3 a menos de 4 ha;32;115;11;21;39;76;3;29;0;11;3;18;1;7;0;15;;
Sengés;De 4 a menos de 5 ha;47;226;16;31;77;148;4;43;1;15;3;28;0;11;1;20;;
Sengés;De 5 a menos de 10 ha;103;796;28;75;212;585;16;87;3;25;13;62;2;19;2;53;;
Sengés;De 10 a menos de 20 ha;156;2240;28;128;378;1861;23;133;3;25;20;108;0;20;0;99;;
Sengés;De 20 a menos de 50 ha;145;4489;26;119;710;3780;47;98;3;23;44;75;1;20;0;63;;
Sengés;De 50 a menos de 100 ha;55;3897;19;36;1576;2321;21;34;5;14;16;20;0;14;0;17;;
Sengés;De 100 a menos de 200 ha;36;4905;36;0;4905;0;18;18;18;18;0;0;0;12;0;0;;
Sengés;De 200 a menos de 500 ha;27;9269;27;0;9269;0;9;18;9;18;0;0;0;15;0;0;;
Sengés;De 500 a menos de 1.000 ha;10;6741;10;0;6741;0;5;5;5;5;0;0;0;5;0;0;;
Sengés;De 1.000 a menos de 2.500 ha;8;12791;8;0;12791;0;5;3;5;3;0;0;0;3;0;0;;
Sengés;De 2.500 a menos de 10.000 ha;4;0;4;0;0;0;2;2;2;2;0;0;0;2;0;0;;
Sengés;De 10.000 ha e mais;1;0;1;0;0;0;1;0;1;0;0;0;0;0;0;0;;
Sengés;Produtor sem área;36;0;22;14;0;0;0;1;0;0;0;1;0;0;0;1;;
Serranópolis do Iguaçu;Mais de 0 a menos de 0,1 ha;0;0;0;0;0;0;0;0;0;0;0;0;0;0;0;0;;
Serranópolis do Iguaçu;De 0,1 a menos de 0,2 ha;2;0;0;2;0;0;1;1;0;0;1;1;0;0;0;1;;
Serranópolis do Iguaçu;De 0,2 a menos de 0,5 ha;11;4;7;4;2;1;3;8;3;4;0;4;1;2;1;3;;
Serranópolis do Iguaçu;De 0,5 a menos de 1 ha;31;19;18;13;11;8;6;25;3;15;3;10;0;7;0;3;;
Serranópolis do Iguaçu;De 1 a menos de 2 ha;17;26;1;16;0;0;6;11;1;0;5;11;0;0;1;7;;
Serranópolis do Iguaçu;De 2 a menos de 3 ha;35;85;7;28;18;68;10;25;2;5;8;20;0;3;1;12;;
Serranópolis do Iguaçu;De 3 a menos de 4 ha;24;85;6;18;21;64;11;13;4;2;7;11;0;2;0;3;;
Serranópolis do Iguaçu;De 4 a menos de 5 ha;39;184;6;33;29;156;33;6;4;2;29;4;0;1;0;2;;
Serranópolis do Iguaçu;De 5 a menos de 10 ha;123;922;17;106;125;796;110;13;13;4;97;9;0;2;0;5;;
Serranópolis do Iguaçu;De 10 a menos de 20 ha;190;2794;10;180;143;2651;183;7;8;2;175;5;0;1;0;4;;
Serranópolis do Iguaçu;De 20 a menos de 50 ha;167;5276;9;158;290;4986;163;4;6;3;157;1;0;1;0;0;;
Serranópolis do Iguaçu;De 50 a menos de 100 ha;50;3362;19;31;1547;1814;50;0;19;0;31;0;0;0;0;0;;
Serranópolis do Iguaçu;De 100 a menos de 200 ha;13;1767;13;0;1767;0;13;0;13;0;0;0;0;0;0;0;;
Serranópolis do Iguaçu;De 200 a menos de 500 ha;3;0;3;0;0;0;3;0;3;0;0;0;0;0;0;0;;
Serranópolis do Iguaçu;De 500 a menos de 1.000 ha;1;0;1;0;0;0;1;0;1;0;0;0;0;0;0;0;;
Serranópolis do Iguaçu;De 1.000 a menos de 2.500 ha;0;0;0;0;0;0;0;0;0;0;0;0;0;0;0;0;;
Serranópolis do Iguaçu;De 2.500 a menos de 10.000 ha;0;0;0;0;0;0;0;0;0;0;0;0;0;0;0;0;;
Serranópolis do Iguaçu;De 10.000 ha e mais;0;0;0;0;0;0;0;0;0;0;0;0;0;0;0;0;;
Serranópolis do Iguaçu;Produtor sem área;6;0;3;3;0;0;0;0;0;0;0;0;0;0;0;0;;
Sertaneja;Mais de 0 a menos de 0,1 ha;0;0;0;0;0;0;0;0;0;0;0;0;0;0;0;0;;
Sertaneja;De 0,1 a menos de 0,2 ha;0;0;0;0;0;0;0;0;0;0;0;0;0;0;0;0;;
Sertaneja;De 0,2 a menos de 0,5 ha;1;0;1;0;0;0;0;1;0;1;0;0;0;1;0;0;;
Sertaneja;De 0,5 a menos de 1 ha;1;0;0;1;0;0;0;1;0;0;0;1;0;0;1;0;;
Sertaneja;De 1 a menos de 2 ha;4;5;2;2;0;0;1;3;1;1;0;2;0;1;0;1;;
Sertaneja;De 2 a menos de 3 ha;2;0;0;2;0;0;2;0;0;0;2;0;0;0;0;0;;
Sertaneja;De 3 a menos de 4 ha;1;0;0;1;0;0;1;0;0;0;1;0;0;0;0;0;;
Sertaneja;De 4 a menos de 5 ha;9;44;3;6;15;29;4;5;2;1;2;4;0;1;1;1;;
Sertaneja;De 5 a menos de 10 ha;20;147;2;18;0;0;14;6;0;2;14;4;0;1;1;2;;
Sertaneja;De 10 a menos de 20 ha;21;286;3;18;46;240;17;4;2;1;15;3;0;1;0;0;;
Sertaneja;De 20 a menos de 50 ha;33;1125;2;31;0;0;32;1;2;0;30;1;0;0;0;0;;
Sertaneja;De 50 a menos de 100 ha;23;1764;19;4;0;0;23;0;19;0;4;0;0;0;0;0;;
Sertaneja;De 100 a menos de 200 ha;13;1758;13;0;1758;0;13;0;13;0;0;0;0;0;0;0;;
Sertaneja;De 200 a menos de 500 ha;20;6385;20;0;6385;0;20;0;20;0;0;0;0;0;0;0;;
Sertaneja;De 500 a menos de 1.000 ha;12;8363;12;0;8363;0;12;0;12;0;0;0;0;0;0;0;;
Sertaneja;De 1.000 a menos de 2.500 ha;8;11738;8;0;11738;0;8;0;8;0;0;0;0;0;0;0;;
Sertaneja;De 2.500 a menos de 10.000 ha;1;0;1;0;0;0;1;0;1;0;0;0;0;0;0;0;;
Sertaneja;De 10.000 ha e mais;0;0;0;0;0;0;0;0;0;0;0;0;0;0;0;0;;
Sertaneja;Produtor sem área;0;0;0;0;0;0;0;0;0;0;0;0;0;0;0;0;;
Sertanópolis;Mais de 0 a menos de 0,1 ha;1;0;0;1;0;0;0;1;0;0;0;1;0;0;0;0;;
Sertanópolis;De 0,1 a menos de 0,2 ha;0;0;0;0;0;0;0;0;0;0;0;0;0;0;0;0;;
Sertanópolis;De 0,2 a menos de 0,5 ha;0;0;0;0;0;0;0;0;0;0;0;0;0;0;0;0;;
Sertanópolis;De 0,5 a menos de 1 ha;1;0;0;1;0;0;0;1;0;0;0;1;0;0;1;0;;
Sertanópolis;De 1 a menos de 2 ha;3;4;1;2;0;0;1;2;0;1;1;1;0;1;0;1;;
Sertanópolis;De 2 a menos de 3 ha;5;12;0;5;0;12;2;3;0;0;2;3;0;0;0;2;;
Sertanópolis;De 3 a menos de 4 ha;12;39;1;11;0;0;7;5;1;0;6;5;0;0;0;1;;
Sertanópolis;De 4 a menos de 5 ha;14;66;0;14;0;66;9;5;0;0;9;5;0;0;0;3;;
Sertanópolis;De 5 a menos de 10 ha;46;344;5;41;37;306;29;17;3;2;26;15;0;1;0;13;;
Sertanópolis;De 10 a menos de 20 ha;64;959;4;60;64;894;57;7;4;0;53;7;0;0;0;6;;
Sertanópolis;De 20 a menos de 50 ha;88;2868;14;74;446;2423;72;16;8;6;64;10;0;5;0;7;;
Sertanópolis;De 50 a menos de 100 ha;55;3927;38;17;2962;966;47;8;30;8;17;0;0;6;0;0;;
Sertanópolis;De 100 a menos de 200 ha;57;8201;57;0;8201;0;53;4;53;4;0;0;0;3;0;0;;
Sertanópolis;De 200 a menos de 500 ha;32;9164;32;0;9164;0;32;0;32;0;0;0;0;0;0;0;;
Sertanópolis;De 500 a menos de 1.000 ha;13;8567;13;0;8567;0;13;0;13;0;0;0;0;0;0;0;;
Sertanópolis;De 1.000 a menos de 2.500 ha;1;0;1;0;0;0;1;0;1;0;0;0;0;0;0;0;;
Sertanópolis;De 2.500 a menos de 10.000 ha;1;0;1;0;0;0;1;0;1;0;0;0;0;0;0;0;;
Sertanópolis;De 10.000 ha e mais;0;0;0;0;0;0;0;0;0;0;0;0;0;0;0;0;;
Sertanópolis;Produtor sem área;0;0;0;0;0;0;0;0;0;0;0;0;0;0;0;0;;
Siqueira Campos;Mais de 0 a menos de 0,1 ha;6;0;2;4;0;0;0;6;0;2;0;4;0;2;0;3;;
Siqueira Campos;De 0,1 a menos de 0,2 ha;5;0;1;4;0;0;0;5;0;1;0;4;0;1;0;4;;
Siqueira Campos;De 0,2 a menos de 0,5 ha;18;6;5;13;2;4;1;17;0;5;1;12;0;4;1;10;;
Siqueira Campos;De 0,5 a menos de 1 ha;143;92;44;99;29;63;12;131;9;35;3;96;0;24;0;74;;
Siqueira Campos;De 1 a menos de 2 ha;88;124;25;63;33;91;9;79;3;22;6;57;0;20;2;50;;
Siqueira Campos;De 2 a menos de 3 ha;81;196;15;66;37;158;6;75;2;13;4;62;0;8;0;55;;
Siqueira Campos;De 3 a menos de 4 ha;83;280;27;56;90;191;13;70;4;23;9;47;0;20;0;37;;
Siqueira Campos;De 4 a menos de 5 ha;79;371;15;64;69;302;13;66;5;10;8;56;1;8;0;45;;
Siqueira Campos;De 5 a menos de 10 ha;206;1550;39;167;294;1256;42;164;10;29;32;135;0;26;0;115;;
Siqueira Campos;De 10 a menos de 20 ha;149;2076;18;131;235;1841;18;131;0;18;18;113;0;17;2;84;;
Siqueira Campos;De 20 a menos de 50 ha;128;4090;22;106;702;3387;23;105;4;18;19;87;0;17;0;77;;
Siqueira Campos;De 50 a menos de 100 ha;46;3156;26;20;1964;1192;10;36;6;20;4;16;0;18;0;11;;
Siqueira Campos;De 100 a menos de 200 ha;24;3372;24;0;3372;0;4;20;4;20;0;0;0;16;0;0;;
Siqueira Campos;De 200 a menos de 500 ha;14;3868;14;0;3868;0;3;11;3;11;0;0;0;11;0;0;;
Siqueira Campos;De 500 a menos de 1.000 ha;0;0;0;0;0;0;0;0;0;0;0;0;0;0;0;0;;
Siqueira Campos;De 1.000 a menos de 2.500 ha;0;0;0;0;0;0;0;0;0;0;0;0;0;0;0;0;;
Siqueira Campos;De 2.500 a menos de 10.000 ha;0;0;0;0;0;0;0;0;0;0;0;0;0;0;0;0;;
Siqueira Campos;De 10.000 ha e mais;0;0;0;0;0;0;0;0;0;0;0;0;0;0;0;0;;
Siqueira Campos;Produtor sem área;1;0;0;1;0;0;0;0;0;0;0;0;0;0;0;0;;
Sulina;Mais de 0 a menos de 0,1 ha;1;0;0;1;0;0;1;0;0;0;1;0;0;0;0;0;;
Sulina;De 0,1 a menos de 0,2 ha;1;0;0;1;0;0;0;1;0;0;0;1;0;0;0;1;;
Sulina;De 0,2 a menos de 0,5 ha;2;0;0;2;0;0;0;2;0;0;0;2;0;0;0;2;;
Sulina;De 0,5 a menos de 1 ha;7;5;0;7;0;5;5;2;0;0;5;2;0;0;0;2;;
Sulina;De 1 a menos de 2 ha;9;10;1;8;0;0;6;3;1;0;5;3;0;0;2;1;;
Sulina;De 2 a menos de 3 ha;15;35;1;14;0;0;12;3;1;0;11;3;0;0;0;2;;
Sulina;De 3 a menos de 4 ha;16;54;1;15;0;0;12;4;0;1;12;3;0;1;1;1;;
Sulina;De 4 a menos de 5 ha;26;124;1;25;0;0;22;4;1;0;21;4;0;0;0;4;;
Sulina;De 5 a menos de 10 ha;114;888;2;112;0;0;102;12;2;0;100;12;0;0;1;10;;
Sulina;De 10 a menos de 20 ha;144;2039;7;137;112;1927;134;10;5;2;129;8;0;0;0;6;;
Sulina;De 20 a menos de 50 ha;108;3216;1;107;0;0;103;5;1;0;102;5;0;0;0;4;;
Sulina;De 50 a menos de 100 ha;31;2056;8;23;638;1419;30;1;8;0;22;1;0;0;0;0;;
Sulina;De 100 a menos de 200 ha;15;2217;15;0;2217;0;15;0;15;0;0;0;0;0;0;0;;
Sulina;De 200 a menos de 500 ha;7;2329;7;0;2329;0;5;2;5;2;0;0;0;2;0;0;;
Sulina;De 500 a menos de 1.000 ha;1;0;1;0;0;0;1;0;1;0;0;0;0;0;0;0;;
Sulina;De 1.000 a menos de 2.500 ha;1;0;1;0;0;0;0;1;0;1;0;0;0;1;0;0;;
Sulina;De 2.500 a menos de 10.000 ha;0;0;0;0;0;0;0;0;0;0;0;0;0;0;0;0;;
Sulina;De 10.000 ha e mais;0;0;0;0;0;0;0;0;0;0;0;0;0;0;0;0;;
Sulina;Produtor sem área;1;0;0;1;0;0;0;0;0;0;0;0;0;0;0;0;;
Tamarana;Mais de 0 a menos de 0,1 ha;1;0;0;1;0;0;0;1;0;0;0;1;0;0;0;1;;
Tamarana;De 0,1 a menos de 0,2 ha;1;0;0;1;0;0;0;1;0;0;0;1;0;0;0;1;;
Tamarana;De 0,2 a menos de 0,5 ha;2;0;0;2;0;0;0;2;0;0;0;2;0;0;0;1;;
Tamarana;De 0,5 a menos de 1 ha;51;28;22;29;12;16;23;28;11;11;12;17;1;7;0;12;;
Tamarana;De 1 a menos de 2 ha;19;25;9;10;12;13;10;9;5;4;5;5;0;1;0;3;;
Tamarana;De 2 a menos de 3 ha;45;108;15;30;36;73;27;18;7;8;20;10;0;6;0;5;;
Tamarana;De 3 a menos de 4 ha;31;110;2;29;0;0;24;7;2;0;22;7;0;0;2;4;;
Tamarana;De 4 a menos de 5 ha;30;142;8;22;39;103;16;14;5;3;11;11;0;3;0;9;;
Tamarana;De 5 a menos de 10 ha;76;583;10;66;73;510;41;35;6;4;35;31;0;4;0;27;;
Tamarana;De 10 a menos de 20 ha;189;2667;33;156;463;2204;104;85;16;17;88;68;1;13;1;58;;
Tamarana;De 20 a menos de 50 ha;69;1964;16;53;498;1465;47;22;9;7;38;15;0;5;0;13;;
Tamarana;De 50 a menos de 100 ha;24;1758;24;0;1758;0;15;9;15;9;0;0;0;8;0;0;;
Tamarana;De 100 a menos de 200 ha;29;4235;29;0;4235;0;20;9;20;9;0;0;1;7;0;0;;
Tamarana;De 200 a menos de 500 ha;17;5409;17;0;5409;0;11;6;11;6;0;0;0;3;0;0;;
Tamarana;De 500 a menos de 1.000 ha;7;4733;7;0;4733;0;6;1;6;1;0;0;0;1;0;0;;
Tamarana;De 1.000 a menos de 2.500 ha;4;5281;4;0;5281;0;4;0;4;0;0;0;0;0;0;0;;
Tamarana;De 2.500 a menos de 10.000 ha;2;0;2;0;0;0;2;0;2;0;0;0;0;0;0;0;;
Tamarana;De 10.000 ha e mais;0;0;0;0;0;0;0;0;0;0;0;0;0;0;0;0;;
Tamarana;Produtor sem área;0;0;0;0;0;0;0;0;0;0;0;0;0;0;0;0;;
Tamboara;Mais de 0 a menos de 0,1 ha;7;0;6;1;0;0;0;7;0;6;0;1;0;5;0;1;;
Tamboara;De 0,1 a menos de 0,2 ha;5;1;4;1;0;0;2;3;2;2;0;1;0;2;0;1;;
Tamboara;De 0,2 a menos de 0,5 ha;3;1;2;1;0;0;2;1;1;1;1;0;0;1;0;0;;
Tamboara;De 0,5 a menos de 1 ha;3;2;3;0;2;0;0;3;0;3;0;0;0;2;0;0;;
Tamboara;De 1 a menos de 2 ha;7;10;1;6;0;0;3;4;0;1;3;3;0;1;0;3;;
Tamboara;De 2 a menos de 3 ha;16;39;9;7;22;18;6;10;2;7;4;3;0;6;0;2;;
Tamboara;De 3 a menos de 4 ha;11;35;4;7;12;23;2;9;1;3;1;6;0;2;0;5;;
Tamboara;De 4 a menos de 5 ha;15;69;5;10;23;46;2;13;2;3;0;10;0;2;0;7;;
Tamboara;De 5 a menos de 10 ha;51;371;13;38;87;284;14;37;2;11;12;26;0;6;0;19;;
Tamboara;De 10 a menos de 20 ha;50;715;13;37;169;545;13;37;2;11;11;26;0;5;0;13;;
Tamboara;De 20 a menos de 50 ha;61;1959;15;46;454;1505;26;35;3;12;23;23;0;8;0;7;;
Tamboara;De 50 a menos de 100 ha;33;2223;9;24;643;1580;14;19;3;6;11;13;0;2;0;6;;
Tamboara;De 100 a menos de 200 ha;15;1963;15;0;1963;0;11;4;11;4;0;0;0;0;0;0;;
Tamboara;De 200 a menos de 500 ha;6;1723;6;0;1723;0;4;2;4;2;0;0;0;1;0;0;;
Tamboara;De 500 a menos de 1.000 ha;1;0;1;0;0;0;1;0;1;0;0;0;0;0;0;0;;
Tamboara;De 1.000 a menos de 2.500 ha;1;0;1;0;0;0;1;0;1;0;0;0;0;0;0;0;;
Tamboara;De 2.500 a menos de 10.000 ha;1;0;1;0;0;0;1;0;1;0;0;0;0;0;0;0;;
Tamboara;De 10.000 ha e mais;0;0;0;0;0;0;0;0;0;0;0;0;0;0;0;0;;
Tamboara;Produtor sem área;0;0;0;0;0;0;0;0;0;0;0;0;0;0;0;0;;
Tapejara;Mais de 0 a menos de 0,1 ha;0;0;0;0;0;0;0;0;0;0;0;0;0;0;0;0;;
Tapejara;De 0,1 a menos de 0,2 ha;0;0;0;0;0;0;0;0;0;0;0;0;0;0;0;0;;
Tapejara;De 0,2 a menos de 0,5 ha;5;1;1;4;0;0;3;2;1;0;2;2;0;0;0;1;;
Tapejara;De 0,5 a menos de 1 ha;37;19;24;13;12;7;12;25;8;16;4;9;6;6;3;4;;
Tapejara;De 1 a menos de 2 ha;4;0;3;1;4;0;0;4;0;3;0;1;0;3;0;1;;
Tapejara;De 2 a menos de 3 ha;7;17;3;4;0;0;0;7;0;3;0;4;1;2;1;3;;
Tapejara;De 3 a menos de 4 ha;12;41;2;10;0;0;2;10;0;2;2;8;0;1;2;3;;
Tapejara;De 4 a menos de 5 ha;12;57;2;10;0;0;1;11;0;2;1;9;0;2;1;5;;
Tapejara;De 5 a menos de 10 ha;43;324;14;29;97;227;4;39;0;14;4;25;2;6;1;17;;
Tapejara;De 10 a menos de 20 ha;38;541;6;32;79;463;7;31;2;4;5;27;1;2;1;10;;
Tapejara;De 20 a menos de 50 ha;49;1654;5;44;145;1509;17;32;2;3;15;29;0;2;2;13;;
Tapejara;De 50 a menos de 100 ha;25;1716;4;21;328;1388;10;15;0;4;10;11;0;3;2;4;;
Tapejara;De 100 a menos de 200 ha;19;2657;19;0;2657;0;8;11;8;11;0;0;1;5;0;0;;
Tapejara;De 200 a menos de 500 ha;22;6868;22;0;6868;0;7;15;7;15;0;0;1;8;0;0;;
Tapejara;De 500 a menos de 1.000 ha;8;5755;8;0;5755;0;1;7;1;7;0;0;0;4;0;0;;
Tapejara;De 1.000 a menos de 2.500 ha;6;8412;6;0;8412;0;4;2;4;2;0;0;0;0;0;0;;
Tapejara;De 2.500 a menos de 10.000 ha;1;0;1;0;0;0;1;0;1;0;0;0;0;0;0;0;;
Tapejara;De 10.000 ha e mais;1;0;1;0;0;0;1;0;1;0;0;0;0;0;0;0;;
Tapejara;Produtor sem área;0;0;0;0;0;0;0;0;0;0;0;0;0;0;0;0;;
Tapira;Mais de 0 a menos de 0,1 ha;0;0;0;0;0;0;0;0;0;0;0;0;0;0;0;0;;
Tapira;De 0,1 a menos de 0,2 ha;1;0;0;1;0;0;0;1;0;0;0;1;0;0;0;1;;
Tapira;De 0,2 a menos de 0,5 ha;6;2;2;4;0;0;2;4;0;2;2;2;0;2;0;2;;
Tapira;De 0,5 a menos de 1 ha;19;10;9;10;5;6;5;14;0;9;5;5;0;4;0;4;;
Tapira;De 1 a menos de 2 ha;8;11;5;3;7;4;2;6;0;5;2;1;0;4;0;0;;
Tapira;De 2 a menos de 3 ha;18;44;5;13;13;31;5;13;2;3;3;10;0;1;0;6;;
Tapira;De 3 a menos de 4 ha;37;126;16;21;52;74;8;29;4;12;4;17;0;9;0;12;;
Tapira;De 4 a menos de 5 ha;30;141;9;21;42;99;5;25;0;9;5;16;0;7;0;11;;
Tapira;De 5 a menos de 10 ha;117;863;37;80;272;591;30;87;10;27;20;60;0;23;0;41;;
Tapira;De 10 a menos de 20 ha;113;1682;24;89;349;1332;44;69;11;13;33;56;0;10;0;37;;
Tapira;De 20 a menos de 50 ha;126;4035;16;110;555;3479;50;76;3;13;47;63;0;9;0;41;;
Tapira;De 50 a menos de 100 ha;70;4800;16;54;1186;3614;36;34;7;9;29;25;0;4;0;12;;
Tapira;De 100 a menos de 200 ha;36;5110;36;0;5110;0;19;17;19;17;0;0;0;10;0;0;;
Tapira;De 200 a menos de 500 ha;26;8305;26;0;8305;0;13;13;13;13;0;0;0;7;0;0;;
Tapira;De 500 a menos de 1.000 ha;8;5670;8;0;5670;0;4;4;4;4;0;0;0;1;0;0;;
Tapira;De 1.000 a menos de 2.500 ha;5;7414;5;0;7414;0;5;0;5;0;0;0;0;0;0;0;;
Tapira;De 2.500 a menos de 10.000 ha;1;0;1;0;0;0;1;0;1;0;0;0;0;0;0;0;;
Tapira;De 10.000 ha e mais;0;0;0;0;0;0;0;0;0;0;0;0;0;0;0;0;;
Tapira;Produtor sem área;4;0;1;3;0;0;0;0;0;0;0;0;0;0;0;0;;
Teixeira Soares;Mais de 0 a menos de 0,1 ha;1;0;0;1;0;0;1;0;0;0;1;0;0;0;0;0;;
Teixeira Soares;De 0,1 a menos de 0,2 ha;2;0;0;2;0;0;0;2;0;0;0;2;0;0;0;2;;
Teixeira Soares;De 0,2 a menos de 0,5 ha;9;3;3;6;0;0;2;7;0;3;2;4;1;2;1;0;;
Teixeira Soares;De 0,5 a menos de 1 ha;2;0;0;2;0;0;1;1;0;0;1;1;0;0;0;1;;
Teixeira Soares;De 1 a menos de 2 ha;19;27;8;11;11;17;6;13;2;6;4;7;1;2;1;1;;
Teixeira Soares;De 2 a menos de 3 ha;16;40;5;11;13;27;10;6;2;3;8;3;0;2;0;2;;
Teixeira Soares;De 3 a menos de 4 ha;30;105;5;25;18;87;23;7;4;1;19;6;0;0;2;1;;
Teixeira Soares;De 4 a menos de 5 ha;38;176;8;30;39;137;22;16;3;5;19;11;1;2;5;2;;
Teixeira Soares;De 5 a menos de 10 ha;130;1021;19;111;149;872;91;39;6;13;85;26;4;6;9;11;;
Teixeira Soares;De 10 a menos de 20 ha;229;3309;14;215;201;3108;200;29;6;8;194;21;1;5;4;7;;
Teixeira Soares;De 20 a menos de 50 ha;140;3925;10;130;267;3658;133;7;7;3;126;4;0;1;0;3;;
Teixeira Soares;De 50 a menos de 100 ha;41;2834;23;18;1816;1018;39;2;21;2;18;0;0;1;0;0;;
Teixeira Soares;De 100 a menos de 200 ha;35;5096;34;1;0;0;34;1;33;1;1;0;0;0;0;0;;
Teixeira Soares;De 200 a menos de 500 ha;16;5321;16;0;5321;0;16;0;16;0;0;0;0;0;0;0;;
Teixeira Soares;De 500 a menos de 1.000 ha;22;15126;22;0;15126;0;20;2;20;2;0;0;0;1;0;0;;
Teixeira Soares;De 1.000 a menos de 2.500 ha;11;16044;11;0;16044;0;9;2;9;2;0;0;0;2;0;0;;
Teixeira Soares;De 2.500 a menos de 10.000 ha;2;0;2;0;0;0;2;0;2;0;0;0;0;0;0;0;;
Teixeira Soares;De 10.000 ha e mais;0;0;0;0;0;0;0;0;0;0;0;0;0;0;0;0;;
Teixeira Soares;Produtor sem área;0;0;0;0;0;0;0;0;0;0;0;0;0;0;0;0;;
Telêmaco Borba;Mais de 0 a menos de 0,1 ha;1;0;1;0;0;0;0;1;0;1;0;0;0;0;0;0;;
Telêmaco Borba;De 0,1 a menos de 0,2 ha;5;1;1;4;0;0;0;5;0;1;0;4;0;1;0;4;;
Telêmaco Borba;De 0,2 a menos de 0,5 ha;19;7;5;14;2;5;0;19;0;5;0;14;0;5;0;14;;
Telêmaco Borba;De 0,5 a menos de 1 ha;31;16;7;24;4;12;0;31;0;7;0;24;0;5;1;22;;
Telêmaco Borba;De 1 a menos de 2 ha;4;5;0;4;0;5;0;4;0;0;0;4;0;0;1;2;;
Telêmaco Borba;De 2 a menos de 3 ha;5;12;2;3;0;0;0;5;0;2;0;3;0;1;0;2;;
Telêmaco Borba;De 3 a menos de 4 ha;2;0;1;1;0;0;0;2;0;1;0;1;0;1;0;1;;
Telêmaco Borba;De 4 a menos de 5 ha;2;0;0;2;0;0;1;1;0;0;1;1;0;0;0;1;;
Telêmaco Borba;De 5 a menos de 10 ha;7;51;1;6;0;0;0;7;0;1;0;6;0;1;0;5;;
Telêmaco Borba;De 10 a menos de 20 ha;5;73;2;3;0;0;2;3;0;2;2;1;0;2;0;1;;
Telêmaco Borba;De 20 a menos de 50 ha;4;116;0;4;0;116;0;4;0;0;0;4;0;0;0;3;;
Telêmaco Borba;De 50 a menos de 100 ha;4;234;0;4;0;234;1;3;0;0;1;3;0;0;0;3;;
Telêmaco Borba;De 100 a menos de 200 ha;3;434;3;0;434;0;3;0;3;0;0;0;0;0;0;0;;
Telêmaco Borba;De 200 a menos de 500 ha;2;0;2;0;0;0;0;2;0;2;0;0;0;2;0;0;;
Telêmaco Borba;De 500 a menos de 1.000 ha;0;0;0;0;0;0;0;0;0;0;0;0;0;0;0;0;;
Telêmaco Borba;De 1.000 a menos de 2.500 ha;0;0;0;0;0;0;0;0;0;0;0;0;0;0;0;0;;
Telêmaco Borba;De 2.500 a menos de 10.000 ha;0;0;0;0;0;0;0;0;0;0;0;0;0;0;0;0;;
Telêmaco Borba;De 10.000 ha e mais;1;0;1;0;0;0;1;0;1;0;0;0;0;0;0;0;;
Telêmaco Borba;Produtor sem área;1;0;0;1;0;0;0;1;0;0;0;1;0;0;0;1;;
Terra Boa;Mais de 0 a menos de 0,1 ha;0;0;0;0;0;0;0;0;0;0;0;0;0;0;0;0;;
Terra Boa;De 0,1 a menos de 0,2 ha;1;0;0;1;0;0;0;1;0;0;0;1;0;0;0;1;;
Terra Boa;De 0,2 a menos de 0,5 ha;2;0;1;1;0;0;1;1;1;0;0;1;0;0;0;0;;
Terra Boa;De 0,5 a menos de 1 ha;59;31;29;30;15;15;19;40;7;22;12;18;7;9;4;7;;
Terra Boa;De 1 a menos de 2 ha;8;11;3;5;0;0;4;4;2;1;2;3;0;1;0;2;;
Terra Boa;De 2 a menos de 3 ha;37;89;10;27;24;65;4;33;1;9;3;24;0;7;0;20;;
Terra Boa;De 3 a menos de 4 ha;33;119;6;27;22;97;6;27;1;5;5;22;0;4;0;19;;
Terra Boa;De 4 a menos de 5 ha;40;192;15;25;72;120;13;27;2;13;11;14;0;11;0;12;;
Terra Boa;De 5 a menos de 10 ha;72;545;10;62;74;471;27;45;0;10;27;35;1;8;0;27;;
Terra Boa;De 10 a menos de 20 ha;72;997;11;61;149;848;47;25;7;4;40;21;0;3;1;17;;
Terra Boa;De 20 a menos de 50 ha;68;2381;11;57;418;1964;49;19;4;7;45;12;0;5;0;9;;
Terra Boa;De 50 a menos de 100 ha;21;1557;4;17;382;1175;19;2;3;1;16;1;0;0;0;1;;
Terra Boa;De 100 a menos de 200 ha;21;2972;21;0;2972;0;17;4;17;4;0;0;0;4;0;0;;
Terra Boa;De 200 a menos de 500 ha;12;3759;12;0;3759;0;12;0;12;0;0;0;0;0;0;0;;
Terra Boa;De 500 a menos de 1.000 ha;4;3175;4;0;3175;0;4;0;4;0;0;0;0;0;0;0;;
Terra Boa;De 1.000 a menos de 2.500 ha;0;0;0;0;0;0;0;0;0;0;0;0;0;0;0;0;;
Terra Boa;De 2.500 a menos de 10.000 ha;0;0;0;0;0;0;0;0;0;0;0;0;0;0;0;0;;
Terra Boa;De 10.000 ha e mais;1;0;1;0;0;0;1;0;1;0;0;0;0;0;0;0;;
Terra Boa;Produtor sem área;0;0;0;0;0;0;0;0;0;0;0;0;0;0;0;0;;
Terra Rica;Mais de 0 a menos de 0,1 ha;9;0;1;8;0;0;0;9;0;1;0;8;0;1;0;6;;
Terra Rica;De 0,1 a menos de 0,2 ha;1;0;1;0;0;0;0;1;0;1;0;0;0;0;0;0;;
Terra Rica;De 0,2 a menos de 0,5 ha;9;3;1;8;0;0;0;9;0;1;0;8;0;0;0;7;;
Terra Rica;De 0,5 a menos de 1 ha;97;50;30;67;16;35;6;91;2;28;4;63;1;25;0;54;;
Terra Rica;De 1 a menos de 2 ha;43;53;25;18;30;23;2;41;1;24;1;17;0;23;0;17;;
Terra Rica;De 2 a menos de 3 ha;44;106;17;27;41;65;5;39;3;14;2;25;0;13;0;23;;
Terra Rica;De 3 a menos de 4 ha;22;76;5;17;18;58;0;22;0;5;0;17;0;4;0;15;;
Terra Rica;De 4 a menos de 5 ha;55;264;6;49;29;235;4;51;2;4;2;47;0;3;1;43;;
Terra Rica;De 5 a menos de 10 ha;113;881;23;90;177;704;8;105;3;20;5;85;0;15;0;72;;
Terra Rica;De 10 a menos de 20 ha;265;4416;29;236;465;3950;61;204;10;19;51;185;0;15;0;146;;
Terra Rica;De 20 a menos de 50 ha;156;4815;23;133;782;4033;35;121;5;18;30;103;0;15;0;83;;
Terra Rica;De 50 a menos de 100 ha;69;5199;14;55;1276;3923;11;58;5;9;6;49;0;6;0;36;;
Terra Rica;De 100 a menos de 200 ha;47;6794;47;0;6794;0;7;40;7;40;0;0;0;32;0;0;;
Terra Rica;De 200 a menos de 500 ha;46;14127;46;0;14127;0;16;30;16;30;0;0;0;20;0;0;;
Terra Rica;De 500 a menos de 1.000 ha;8;6112;8;0;6112;0;1;7;1;7;0;0;0;1;0;0;;
Terra Rica;De 1.000 a menos de 2.500 ha;1;0;1;0;0;0;0;1;0;1;0;0;0;1;0;0;;
Terra Rica;De 2.500 a menos de 10.000 ha;1;0;1;0;0;0;1;0;1;0;0;0;0;0;0;0;;
Terra Rica;De 10.000 ha e mais;1;0;1;0;0;0;1;0;1;0;0;0;0;0;0;0;;
Terra Rica;Produtor sem área;2;0;2;0;0;0;0;1;0;1;0;0;0;1;0;0;;
Terra Roxa;Mais de 0 a menos de 0,1 ha;16;1;2;14;0;0;2;14;0;2;2;12;0;2;1;10;;
Terra Roxa;De 0,1 a menos de 0,2 ha;15;2;5;10;1;1;2;13;0;5;2;8;1;3;1;4;;
Terra Roxa;De 0,2 a menos de 0,5 ha;15;4;1;14;0;0;2;13;0;1;2;12;0;1;1;9;;
Terra Roxa;De 0,5 a menos de 1 ha;69;36;10;59;5;31;18;51;1;9;17;42;1;4;2;24;;
Terra Roxa;De 1 a menos de 2 ha;30;39;10;20;13;26;14;16;4;6;10;10;0;4;3;4;;
Terra Roxa;De 2 a menos de 3 ha;45;109;10;35;24;85;20;25;3;7;17;18;0;5;3;11;;
Terra Roxa;De 3 a menos de 4 ha;31;108;2;29;0;0;17;14;0;2;17;12;0;1;1;3;;
Terra Roxa;De 4 a menos de 5 ha;56;268;10;46;48;219;37;19;3;7;34;12;0;2;0;7;;
Terra Roxa;De 5 a menos de 10 ha;159;1231;13;146;94;1137;126;33;7;6;119;27;0;5;4;8;;
Terra Roxa;De 10 a menos de 20 ha;229;3211;12;217;165;3046;195;34;6;6;189;28;1;3;2;12;;
Terra Roxa;De 20 a menos de 50 ha;258;8182;11;247;354;7827;231;27;8;3;223;24;0;2;1;4;;
Terra Roxa;De 50 a menos de 100 ha;98;7401;64;34;5350;2050;88;10;55;9;33;1;2;2;0;1;;
Terra Roxa;De 100 a menos de 200 ha;86;12025;86;0;12025;0;83;3;83;3;0;0;0;0;0;0;;
Terra Roxa;De 200 a menos de 500 ha;61;19096;61;0;19096;0;59;2;59;2;0;0;0;0;0;0;;
Terra Roxa;De 500 a menos de 1.000 ha;19;13091;19;0;13091;0;18;1;18;1;0;0;0;0;0;0;;
Terra Roxa;De 1.000 a menos de 2.500 ha;9;11843;9;0;11843;0;8;1;8;1;0;0;0;0;0;0;;
Terra Roxa;De 2.500 a menos de 10.000 ha;0;0;0;0;0;0;0;0;0;0;0;0;0;0;0;0;;
Terra Roxa;De 10.000 ha e mais;0;0;0;0;0;0;0;0;0;0;0;0;0;0;0;0;;
Terra Roxa;Produtor sem área;13;0;5;8;0;0;1;5;0;2;1;3;0;2;0;3;;
Tibagi;Mais de 0 a menos de 0,1 ha;24;1;10;14;0;1;1;23;1;9;0;14;2;5;0;9;;
Tibagi;De 0,1 a menos de 0,2 ha;11;2;4;7;0;0;1;10;0;4;1;6;0;2;1;3;;
Tibagi;De 0,2 a menos de 0,5 ha;64;28;12;52;5;22;19;45;3;9;16;36;2;5;1;29;;
Tibagi;De 0,5 a menos de 1 ha;22;15;2;20;0;0;9;13;1;1;8;12;0;1;2;7;;
Tibagi;De 1 a menos de 2 ha;34;45;8;26;10;35;15;19;3;5;12;14;2;3;1;7;;
Tibagi;De 2 a menos de 3 ha;52;123;7;45;16;107;23;29;1;6;22;23;0;5;7;13;;
Tibagi;De 3 a menos de 4 ha;42;143;7;35;25;118;22;20;4;3;18;17;0;1;4;12;;
Tibagi;De 4 a menos de 5 ha;48;224;11;37;52;172;23;25;5;6;18;19;3;3;6;11;;
Tibagi;De 5 a menos de 10 ha;135;982;23;112;174;808;70;65;7;16;63;49;6;8;18;19;;
Tibagi;De 10 a menos de 20 ha;177;2615;23;154;333;2282;112;65;10;13;102;52;8;4;20;21;;
Tibagi;De 20 a menos de 50 ha;136;4074;13;123;371;3704;85;51;5;8;80;43;2;1;15;19;;
Tibagi;De 50 a menos de 100 ha;67;4656;29;38;2190;2465;44;23;16;13;28;10;4;6;3;6;;
Tibagi;De 100 a menos de 200 ha;54;7523;54;0;7523;0;43;11;43;11;0;0;3;6;0;0;;
Tibagi;De 200 a menos de 500 ha;71;22339;70;1;0;0;59;12;58;12;1;0;2;8;0;0;;
Tibagi;De 500 a menos de 1.000 ha;45;32357;45;0;32357;0;42;3;42;3;0;0;0;1;0;0;;
Tibagi;De 1.000 a menos de 2.500 ha;38;57127;38;0;57127;0;35;3;35;3;0;0;1;1;0;0;;
Tibagi;De 2.500 a menos de 10.000 ha;17;60498;17;0;60498;0;14;3;14;3;0;0;0;3;0;0;;
Tibagi;De 10.000 ha e mais;2;0;2;0;0;0;2;0;2;0;0;0;0;0;0;0;;
Tibagi;Produtor sem área;1;0;0;1;0;0;1;0;0;0;1;0;0;0;0;0;;
Tijucas do Sul;Mais de 0 a menos de 0,1 ha;4;0;2;2;0;0;1;3;1;1;0;2;0;1;0;1;;
Tijucas do Sul;De 0,1 a menos de 0,2 ha;10;2;4;6;1;1;4;6;2;2;2;4;2;0;0;3;;
Tijucas do Sul;De 0,2 a menos de 0,5 ha;26;10;11;15;5;6;7;19;3;8;4;11;2;3;1;8;;
Tijucas do Sul;De 0,5 a menos de 1 ha;27;18;14;13;9;9;7;20;4;10;3;10;1;7;0;5;;
Tijucas do Sul;De 1 a menos de 2 ha;61;83;9;52;13;71;15;46;2;7;13;39;2;3;4;19;;
Tijucas do Sul;De 2 a menos de 3 ha;62;150;15;47;36;113;20;42;6;9;14;33;2;7;5;15;;
Tijucas do Sul;De 3 a menos de 4 ha;58;200;9;49;31;169;25;33;2;7;23;26;1;3;3;9;;
Tijucas do Sul;De 4 a menos de 5 ha;68;325;16;52;76;249;30;38;12;4;18;34;0;2;2;20;;
Tijucas do Sul;De 5 a menos de 10 ha;123;912;25;98;178;735;64;59;12;13;52;46;0;8;5;18;;
Tijucas do Sul;De 10 a menos de 20 ha;109;1551;20;89;279;1271;58;51;9;11;49;40;2;7;9;13;;
Tijucas do Sul;De 20 a menos de 50 ha;72;2118;8;64;263;1855;40;32;3;5;37;27;2;1;6;13;;
Tijucas do Sul;De 50 a menos de 100 ha;32;2182;16;16;1196;987;16;16;8;8;8;8;0;7;2;2;;
Tijucas do Sul;De 100 a menos de 200 ha;16;2567;16;0;2567;0;10;6;10;6;0;0;1;2;0;0;;
Tijucas do Sul;De 200 a menos de 500 ha;13;3873;13;0;3873;0;8;5;8;5;0;0;0;4;0;0;;
Tijucas do Sul;De 500 a menos de 1.000 ha;4;2793;4;0;2793;0;2;2;2;2;0;0;0;1;0;0;;
Tijucas do Sul;De 1.000 a menos de 2.500 ha;3;3813;3;0;3813;0;0;3;0;3;0;0;0;3;0;0;;
Tijucas do Sul;De 2.500 a menos de 10.000 ha;0;0;0;0;0;0;0;0;0;0;0;0;0;0;0;0;;
Tijucas do Sul;De 10.000 ha e mais;0;0;0;0;0;0;0;0;0;0;0;0;0;0;0;0;;
Tijucas do Sul;Produtor sem área;3;0;1;2;0;0;0;0;0;0;0;0;0;0;0;0;;
Toledo;Mais de 0 a menos de 0,1 ha;2;0;0;2;0;0;0;2;0;0;0;2;0;0;0;1;;
Toledo;De 0,1 a menos de 0,2 ha;4;0;0;4;0;0;0;4;0;0;0;4;0;0;0;4;;
Toledo;De 0,2 a menos de 0,5 ha;7;2;1;6;0;0;1;6;0;1;1;5;0;1;1;3;;
Toledo;De 0,5 a menos de 1 ha;69;40;10;59;7;34;15;54;4;6;11;48;0;5;3;33;;
Toledo;De 1 a menos de 2 ha;71;94;20;51;28;66;23;48;5;15;18;33;1;13;5;25;;
Toledo;De 2 a menos de 3 ha;163;391;49;114;115;275;61;102;11;38;50;64;2;31;2;53;;
Toledo;De 3 a menos de 4 ha;136;468;34;102;114;354;60;76;10;24;50;52;0;23;6;37;;
Toledo;De 4 a menos de 5 ha;141;658;31;110;144;513;61;80;7;24;54;56;1;19;4;47;;
Toledo;De 5 a menos de 10 ha;425;3164;52;373;379;2785;274;151;16;36;258;115;3;31;15;88;;
Toledo;De 10 a menos de 20 ha;563;8045;59;504;849;7196;485;78;32;27;453;51;1;22;1;35;;
Toledo;De 20 a menos de 50 ha;603;19353;66;537;2048;17305;572;31;49;17;523;14;1;15;0;9;;
Toledo;De 50 a menos de 100 ha;246;17071;113;133;9128;7943;243;3;110;3;133;0;0;2;0;0;;
Toledo;De 100 a menos de 200 ha;104;14481;104;0;14481;0;104;0;104;0;0;0;0;0;0;0;;
Toledo;De 200 a menos de 500 ha;44;13237;44;0;13237;0;42;2;42;2;0;0;0;1;0;0;;
Toledo;De 500 a menos de 1.000 ha;12;7950;12;0;7950;0;12;0;12;0;0;0;0;0;0;0;;
Toledo;De 1.000 a menos de 2.500 ha;6;8844;6;0;8844;0;6;0;6;0;0;0;0;0;0;0;;
Toledo;De 2.500 a menos de 10.000 ha;1;0;1;0;0;0;1;0;1;0;0;0;0;0;0;0;;
Toledo;De 10.000 ha e mais;0;0;0;0;0;0;0;0;0;0;0;0;0;0;0;0;;
Toledo;Produtor sem área;11;0;5;6;0;0;0;0;0;0;0;0;0;0;0;0;;
Tomazina;Mais de 0 a menos de 0,1 ha;16;1;5;11;0;1;2;14;1;4;1;10;0;4;0;10;;
Tomazina;De 0,1 a menos de 0,2 ha;5;1;1;4;0;0;4;1;0;1;4;0;0;1;0;0;;
Tomazina;De 0,2 a menos de 0,5 ha;7;2;5;2;0;0;2;5;2;3;0;2;0;3;0;2;;
Tomazina;De 0,5 a menos de 1 ha;54;35;26;28;17;17;30;24;14;12;16;12;0;9;0;8;;
Tomazina;De 1 a menos de 2 ha;55;74;24;31;33;41;26;29;13;11;13;18;0;9;1;12;;
Tomazina;De 2 a menos de 3 ha;77;188;22;55;55;134;39;38;10;12;29;26;0;10;3;16;;
Tomazina;De 3 a menos de 4 ha;110;378;24;86;83;295;46;64;12;12;34;52;0;9;4;28;;
Tomazina;De 4 a menos de 5 ha;117;540;32;85;149;391;58;59;15;17;43;42;0;14;0;26;;
Tomazina;De 5 a menos de 10 ha;267;2014;64;203;469;1545;112;155;20;44;92;111;1;30;6;70;;
Tomazina;De 10 a menos de 20 ha;241;3434;72;169;1011;2422;115;126;33;39;82;87;1;29;1;60;;
Tomazina;De 20 a menos de 50 ha;181;5837;46;135;1414;4422;86;95;20;26;66;69;2;19;1;53;;
Tomazina;De 50 a menos de 100 ha;63;4354;32;31;2468;1885;24;39;14;18;10;21;0;13;0;17;;
Tomazina;De 100 a menos de 200 ha;49;6920;49;0;6920;0;23;26;23;26;0;0;0;18;0;0;;
Tomazina;De 200 a menos de 500 ha;29;8863;29;0;8863;0;19;10;19;10;0;0;0;7;0;0;;
Tomazina;De 500 a menos de 1.000 ha;11;8125;11;0;8125;0;7;4;7;4;0;0;0;3;0;0;;
Tomazina;De 1.000 a menos de 2.500 ha;5;0;5;0;0;0;4;1;4;1;0;0;0;1;0;0;;
Tomazina;De 2.500 a menos de 10.000 ha;0;0;0;0;0;0;0;0;0;0;0;0;0;0;0;0;;
Tomazina;De 10.000 ha e mais;0;0;0;0;0;0;0;0;0;0;0;0;0;0;0;0;;
Tomazina;Produtor sem área;3;0;0;3;0;0;1;2;0;0;1;2;0;0;0;2;;
Três Barras do Paraná;Mais de 0 a menos de 0,1 ha;0;0;0;0;0;0;0;0;0;0;0;0;0;0;0;0;;
Três Barras do Paraná;De 0,1 a menos de 0,2 ha;5;1;0;5;0;1;0;5;0;0;0;5;0;0;0;5;;
Três Barras do Paraná;De 0,2 a menos de 0,5 ha;6;2;2;4;0;0;1;5;1;1;0;4;0;1;0;3;;
Três Barras do Paraná;De 0,5 a menos de 1 ha;22;14;8;14;5;9;6;16;2;6;4;10;0;3;1;8;;
Três Barras do Paraná;De 1 a menos de 2 ha;33;45;10;23;12;33;17;16;5;5;12;11;0;5;1;9;;
Três Barras do Paraná;De 2 a menos de 3 ha;46;112;10;36;24;87;24;22;5;5;19;17;0;3;0;12;;
Três Barras do Paraná;De 3 a menos de 4 ha;49;169;8;41;28;141;23;26;5;3;18;23;0;3;1;18;;
Três Barras do Paraná;De 4 a menos de 5 ha;72;342;13;59;61;281;52;20;8;5;44;15;0;5;1;12;;
Três Barras do Paraná;De 5 a menos de 10 ha;227;1789;23;204;179;1610;180;47;14;9;166;38;0;8;0;27;;
Três Barras do Paraná;De 10 a menos de 20 ha;305;4450;26;279;378;4072;263;42;16;10;247;32;0;7;1;22;;
Três Barras do Paraná;De 20 a menos de 50 ha;252;7525;20;232;567;6959;239;13;16;4;223;9;0;3;0;5;;
Três Barras do Paraná;De 50 a menos de 100 ha;89;6011;38;51;3010;3001;84;5;33;5;51;0;0;2;0;0;;
Três Barras do Paraná;De 100 a menos de 200 ha;36;5010;36;0;5010;0;34;2;34;2;0;0;0;2;0;0;;
Três Barras do Paraná;De 200 a menos de 500 ha;14;4744;14;0;4744;0;13;1;13;1;0;0;0;0;0;0;;
Três Barras do Paraná;De 500 a menos de 1.000 ha;6;3551;6;0;3551;0;6;0;6;0;0;0;0;0;0;0;;
Três Barras do Paraná;De 1.000 a menos de 2.500 ha;4;0;4;0;0;0;4;0;4;0;0;0;0;0;0;0;;
Três Barras do Paraná;De 2.500 a menos de 10.000 ha;0;0;0;0;0;0;0;0;0;0;0;0;0;0;0;0;;
Três Barras do Paraná;De 10.000 ha e mais;0;0;0;0;0;0;0;0;0;0;0;0;0;0;0;0;;
Três Barras do Paraná;Produtor sem área;1;0;0;1;0;0;0;1;0;0;0;1;0;0;0;1;;
Tunas do Paraná;Mais de 0 a menos de 0,1 ha;13;1;4;9;0;0;0;13;0;4;0;9;1;2;1;7;;
Tunas do Paraná;De 0,1 a menos de 0,2 ha;0;0;0;0;0;0;0;0;0;0;0;0;0;0;0;0;;
Tunas do Paraná;De 0,2 a menos de 0,5 ha;2;0;1;1;0;0;0;2;0;1;0;1;0;1;0;0;;
Tunas do Paraná;De 0,5 a menos de 1 ha;6;4;3;3;2;2;1;5;1;2;0;3;0;2;0;3;;
Tunas do Paraná;De 1 a menos de 2 ha;9;10;5;4;6;5;0;9;0;5;0;4;0;4;0;3;;
Tunas do Paraná;De 2 a menos de 3 ha;9;21;4;5;10;12;0;9;0;4;0;5;0;3;0;5;;
Tunas do Paraná;De 3 a menos de 4 ha;5;18;4;1;0;0;0;5;0;4;0;1;1;3;0;1;;
Tunas do Paraná;De 4 a menos de 5 ha;10;48;4;6;19;29;0;10;0;4;0;6;2;2;0;5;;
Tunas do Paraná;De 5 a menos de 10 ha;9;71;3;6;0;0;0;9;0;3;0;6;1;1;0;6;;
Tunas do Paraná;De 10 a menos de 20 ha;17;256;10;7;147;110;3;14;2;8;1;6;0;6;1;4;;
Tunas do Paraná;De 20 a menos de 50 ha;25;822;12;13;407;416;1;24;0;12;1;12;1;10;0;8;;
Tunas do Paraná;De 50 a menos de 100 ha;16;1171;11;5;851;319;0;16;0;11;0;5;0;10;0;4;;
Tunas do Paraná;De 100 a menos de 200 ha;17;2427;17;0;2427;0;3;14;3;14;0;0;0;10;0;0;;
Tunas do Paraná;De 200 a menos de 500 ha;8;2585;8;0;2585;0;0;8;0;8;0;0;0;8;0;0;;
Tunas do Paraná;De 500 a menos de 1.000 ha;5;3062;5;0;3062;0;2;3;2;3;0;0;0;2;0;0;;
Tunas do Paraná;De 1.000 a menos de 2.500 ha;4;6600;4;0;6600;0;0;4;0;4;0;0;0;3;0;0;;
Tunas do Paraná;De 2.500 a menos de 10.000 ha;6;30551;6;0;30551;0;4;2;4;2;0;0;0;2;0;0;;
Tunas do Paraná;De 10.000 ha e mais;0;0;0;0;0;0;0;0;0;0;0;0;0;0;0;0;;
Tunas do Paraná;Produtor sem área;2;0;1;1;0;0;0;0;0;0;0;0;0;0;0;0;;
Tuneiras do Oeste;Mais de 0 a menos de 0,1 ha;0;0;0;0;0;0;0;0;0;0;0;0;0;0;0;0;;
Tuneiras do Oeste;De 0,1 a menos de 0,2 ha;3;0;2;1;0;0;2;1;1;1;1;0;0;1;0;0;;
Tuneiras do Oeste;De 0,2 a menos de 0,5 ha;4;1;3;1;0;0;2;2;2;1;0;1;0;1;0;0;;
Tuneiras do Oeste;De 0,5 a menos de 1 ha;27;14;12;15;6;8;1;26;1;11;0;15;0;7;3;10;;
Tuneiras do Oeste;De 1 a menos de 2 ha;15;22;6;9;0;0;3;12;2;4;1;8;0;4;1;4;;
Tuneiras do Oeste;De 2 a menos de 3 ha;36;88;13;23;31;57;12;24;7;6;5;18;0;3;2;13;;
Tuneiras do Oeste;De 3 a menos de 4 ha;28;99;8;20;29;70;12;16;4;4;8;12;0;3;0;4;;
Tuneiras do Oeste;De 4 a menos de 5 ha;58;279;18;40;87;192;19;39;7;11;12;28;0;8;2;17;;
Tuneiras do Oeste;De 5 a menos de 10 ha;135;1049;33;102;247;802;40;95;6;27;34;68;0;24;1;40;;
Tuneiras do Oeste;De 10 a menos de 20 ha;142;2068;25;117;339;1730;53;89;10;15;43;74;2;8;5;35;;
Tuneiras do Oeste;De 20 a menos de 50 ha;143;4530;21;122;706;3824;61;82;8;13;53;69;0;7;3;30;;
Tuneiras do Oeste;De 50 a menos de 100 ha;53;3801;17;36;1418;2383;29;24;8;9;21;15;2;5;0;10;;
Tuneiras do Oeste;De 100 a menos de 200 ha;39;5782;39;0;5782;0;26;13;26;13;0;0;0;5;0;0;;
Tuneiras do Oeste;De 200 a menos de 500 ha;20;6174;20;0;6174;0;18;2;18;2;0;0;0;1;0;0;;
Tuneiras do Oeste;De 500 a menos de 1.000 ha;9;6125;9;0;6125;0;8;1;8;1;0;0;0;0;0;0;;
Tuneiras do Oeste;De 1.000 a menos de 2.500 ha;5;7396;5;0;7396;0;4;1;4;1;0;0;0;1;0;0;;
Tuneiras do Oeste;De 2.500 a menos de 10.000 ha;1;0;1;0;0;0;0;1;0;1;0;0;0;1;0;0;;
Tuneiras do Oeste;De 10.000 ha e mais;1;0;1;0;0;0;1;0;1;0;0;0;0;0;0;0;;
Tuneiras do Oeste;Produtor sem área;1;0;1;0;0;0;0;0;0;0;0;0;0;0;0;0;;
Tupãssi;Mais de 0 a menos de 0,1 ha;1;0;0;1;0;0;0;1;0;0;0;1;0;0;0;1;;
Tupãssi;De 0,1 a menos de 0,2 ha;2;0;0;2;0;0;0;2;0;0;0;2;0;0;0;2;;
Tupãssi;De 0,2 a menos de 0,5 ha;10;3;4;6;1;2;8;2;3;1;5;1;0;1;0;1;;
Tupãssi;De 0,5 a menos de 1 ha;31;16;11;20;6;10;29;2;11;0;18;2;0;0;0;1;;
Tupãssi;De 1 a menos de 2 ha;10;16;5;5;7;9;1;9;1;4;0;5;0;3;0;5;;
Tupãssi;De 2 a menos de 3 ha;25;61;8;17;19;42;11;14;4;4;7;10;0;4;1;9;;
Tupãssi;De 3 a menos de 4 ha;21;70;0;21;0;70;19;2;0;0;19;2;0;0;0;2;;
Tupãssi;De 4 a menos de 5 ha;33;155;2;31;0;0;29;4;1;1;28;3;0;1;1;2;;
Tupãssi;De 5 a menos de 10 ha;109;818;9;100;66;752;97;12;4;5;93;7;0;4;0;5;;
Tupãssi;De 10 a menos de 20 ha;123;1784;7;116;104;1680;119;4;4;3;115;1;1;1;0;0;;
Tupãssi;De 20 a menos de 50 ha;114;3632;5;109;160;3472;111;3;5;0;106;3;0;0;0;1;;
Tupãssi;De 50 a menos de 100 ha;73;5076;30;43;2498;2578;73;0;30;0;43;0;0;0;0;0;;
Tupãssi;De 100 a menos de 200 ha;34;4878;34;0;4878;0;33;1;33;1;0;0;0;0;0;0;;
Tupãssi;De 200 a menos de 500 ha;24;7493;24;0;7493;0;24;0;24;0;0;0;0;0;0;0;;
Tupãssi;De 500 a menos de 1.000 ha;2;0;2;0;0;0;2;0;2;0;0;0;0;0;0;0;;
Tupãssi;De 1.000 a menos de 2.500 ha;1;0;1;0;0;0;1;0;1;0;0;0;0;0;0;0;;
Tupãssi;De 2.500 a menos de 10.000 ha;0;0;0;0;0;0;0;0;0;0;0;0;0;0;0;0;;
Tupãssi;De 10.000 ha e mais;0;0;0;0;0;0;0;0;0;0;0;0;0;0;0;0;;
Tupãssi;Produtor sem área;0;0;0;0;0;0;0;0;0;0;0;0;0;0;0;0;;
Turvo;Mais de 0 a menos de 0,1 ha;9;1;1;8;0;0;0;9;0;1;0;8;0;1;2;6;;
Turvo;De 0,1 a menos de 0,2 ha;8;1;3;5;0;0;0;8;0;3;0;5;0;3;0;3;;
Turvo;De 0,2 a menos de 0,5 ha;49;17;18;31;6;11;4;45;2;16;2;29;0;11;1;17;;
Turvo;De 0,5 a menos de 1 ha;82;61;33;49;23;38;18;64;6;27;12;37;0;19;1;27;;
Turvo;De 1 a menos de 2 ha;77;109;26;51;35;74;19;58;7;19;12;39;1;14;1;24;;
Turvo;De 2 a menos de 3 ha;91;227;21;70;52;175;24;67;4;17;20;50;0;11;1;29;;
Turvo;De 3 a menos de 4 ha;68;242;15;53;54;188;24;44;7;8;17;36;0;5;1;24;;
Turvo;De 4 a menos de 5 ha;71;340;16;55;77;264;30;41;5;11;25;30;0;10;1;20;;
Turvo;De 5 a menos de 10 ha;173;1337;30;143;231;1106;73;100;14;16;59;84;1;12;2;48;;
Turvo;De 10 a menos de 20 ha;247;3631;25;222;343;3288;130;117;6;19;124;98;0;13;5;64;;
Turvo;De 20 a menos de 50 ha;154;4861;15;139;461;4400;91;63;7;8;84;55;0;4;0;39;;
Turvo;De 50 a menos de 100 ha;90;6615;57;33;4526;2089;58;32;34;23;24;9;2;13;0;6;;
Turvo;De 100 a menos de 200 ha;50;6839;50;0;6839;0;31;19;31;19;0;0;0;11;0;0;;
Turvo;De 200 a menos de 500 ha;42;12348;42;0;12348;0;27;15;27;15;0;0;0;10;0;0;;
Turvo;De 500 a menos de 1.000 ha;6;0;6;0;0;0;5;1;5;1;0;0;0;1;0;0;;
Turvo;De 1.000 a menos de 2.500 ha;0;0;0;0;0;0;0;0;0;0;0;0;0;0;0;0;;
Turvo;De 2.500 a menos de 10.000 ha;2;0;2;0;0;0;2;0;2;0;0;0;0;0;0;0;;
Turvo;De 10.000 ha e mais;0;0;0;0;0;0;0;0;0;0;0;0;0;0;0;0;;
Turvo;Produtor sem área;0;0;0;0;0;0;0;0;0;0;0;0;0;0;0;0;;
Ubiratã;Mais de 0 a menos de 0,1 ha;1;0;0;1;0;0;0;1;0;0;0;1;0;0;0;1;;
Ubiratã;De 0,1 a menos de 0,2 ha;2;0;1;1;0;0;0;2;0;1;0;1;0;1;0;1;;
Ubiratã;De 0,2 a menos de 0,5 ha;4;1;2;2;0;0;2;2;1;1;1;1;0;0;0;1;;
Ubiratã;De 0,5 a menos de 1 ha;41;21;8;33;4;17;19;22;1;7;18;15;0;6;2;11;;
Ubiratã;De 1 a menos de 2 ha;12;18;1;11;0;0;7;5;0;1;7;4;0;1;0;3;;
Ubiratã;De 2 a menos de 3 ha;21;51;6;15;14;37;7;14;2;4;5;10;1;3;0;9;;
Ubiratã;De 3 a menos de 4 ha;17;61;2;15;0;0;11;6;2;0;9;6;0;0;0;4;;
Ubiratã;De 4 a menos de 5 ha;31;150;3;28;15;136;22;9;2;1;20;8;0;1;0;7;;
Ubiratã;De 5 a menos de 10 ha;109;837;8;101;55;782;85;24;2;6;83;18;0;6;0;13;;
Ubiratã;De 10 a menos de 20 ha;173;2506;9;164;134;2372;147;26;2;7;145;19;0;5;0;15;;
Ubiratã;De 20 a menos de 50 ha;179;5750;8;171;333;5417;173;6;7;1;166;5;0;1;0;5;;
Ubiratã;De 50 a menos de 100 ha;99;7165;32;67;2809;4356;96;3;31;1;65;2;0;1;0;1;;
Ubiratã;De 100 a menos de 200 ha;65;8615;65;0;8615;0;62;3;62;3;0;0;0;3;0;0;;
Ubiratã;De 200 a menos de 500 ha;41;13683;41;0;13683;0;40;1;40;1;0;0;0;1;0;0;;
Ubiratã;De 500 a menos de 1.000 ha;12;8160;12;0;8160;0;12;0;12;0;0;0;0;0;0;0;;
Ubiratã;De 1.000 a menos de 2.500 ha;2;0;2;0;0;0;2;0;2;0;0;0;0;0;0;0;;
Ubiratã;De 2.500 a menos de 10.000 ha;2;0;2;0;0;0;2;0;2;0;0;0;0;0;0;0;;
Ubiratã;De 10.000 ha e mais;0;0;0;0;0;0;0;0;0;0;0;0;0;0;0;0;;
Ubiratã;Produtor sem área;0;0;0;0;0;0;0;0;0;0;0;0;0;0;0;0;;
Umuarama;Mais de 0 a menos de 0,1 ha;31;1;13;18;1;1;4;27;0;13;4;14;1;11;1;8;;
Umuarama;De 0,1 a menos de 0,2 ha;14;2;2;12;0;0;8;6;1;1;7;5;0;0;0;3;;
Umuarama;De 0,2 a menos de 0,5 ha;18;5;4;14;1;3;7;11;1;3;6;8;1;1;1;6;;
Umuarama;De 0,5 a menos de 1 ha;139;73;50;89;26;48;47;92;9;41;38;51;0;29;7;31;;
Umuarama;De 1 a menos de 2 ha;72;91;12;60;15;75;27;45;2;10;25;35;0;7;4;23;;
Umuarama;De 2 a menos de 3 ha;217;530;54;163;130;400;104;113;15;39;89;74;2;29;8;47;;
Umuarama;De 3 a menos de 4 ha;80;286;18;62;64;221;28;52;4;14;24;38;0;9;3;26;;
Umuarama;De 4 a menos de 5 ha;149;709;41;108;198;511;53;96;12;29;41;67;1;25;2;45;;
Umuarama;De 5 a menos de 10 ha;247;1875;46;201;342;1534;99;148;11;35;88;113;1;24;7;71;;
Umuarama;De 10 a menos de 20 ha;261;3795;47;214;732;3063;107;154;10;37;97;117;3;23;5;66;;
Umuarama;De 20 a menos de 50 ha;286;9425;44;242;1474;7951;105;181;16;28;89;153;4;18;2;86;;
Umuarama;De 50 a menos de 100 ha;109;7930;46;63;3823;4106;52;57;25;21;27;36;2;13;0;21;;
Umuarama;De 100 a menos de 200 ha;83;11422;83;0;11422;0;35;48;35;48;0;0;3;18;0;0;;
Umuarama;De 200 a menos de 500 ha;82;25135;82;0;25135;0;48;34;48;34;0;0;1;21;0;0;;
Umuarama;De 500 a menos de 1.000 ha;18;13929;18;0;13929;0;6;12;6;12;0;0;0;8;0;0;;
Umuarama;De 1.000 a menos de 2.500 ha;7;11684;7;0;11684;0;6;1;6;1;0;0;0;1;0;0;;
Umuarama;De 2.500 a menos de 10.000 ha;1;0;1;0;0;0;1;0;1;0;0;0;0;0;0;0;;
Umuarama;De 10.000 ha e mais;1;0;1;0;0;0;1;0;1;0;0;0;0;0;0;0;;
Umuarama;Produtor sem área;3;0;2;1;0;0;0;3;0;2;0;1;0;2;0;1;;
União da Vitória;Mais de 0 a menos de 0,1 ha;13;1;3;10;0;1;2;11;1;2;1;9;0;2;0;9;;
União da Vitória;De 0,1 a menos de 0,2 ha;3;0;2;1;0;0;0;3;0;2;0;1;2;0;1;0;;
União da Vitória;De 0,2 a menos de 0,5 ha;13;4;6;7;2;2;2;11;0;6;2;5;2;3;4;1;;
União da Vitória;De 0,5 a menos de 1 ha;7;4;1;6;0;0;2;5;1;0;1;5;0;0;2;3;;
União da Vitória;De 1 a menos de 2 ha;24;30;9;15;10;20;3;21;1;8;2;13;5;3;4;9;;
União da Vitória;De 2 a menos de 3 ha;38;92;15;23;36;57;4;34;2;13;2;21;8;3;9;10;;
União da Vitória;De 3 a menos de 4 ha;45;160;19;26;67;93;9;36;3;16;6;20;6;8;7;12;;
União da Vitória;De 4 a menos de 5 ha;60;286;23;37;111;174;13;47;4;19;9;28;8;10;13;12;;
União da Vitória;De 5 a menos de 10 ha;127;980;40;87;311;668;27;100;8;32;19;68;8;22;31;23;;
União da Vitória;De 10 a menos de 20 ha;187;2709;38;149;549;2160;65;122;11;27;54;95;9;15;50;30;;
União da Vitória;De 20 a menos de 50 ha;169;5172;27;142;842;4330;78;91;6;21;72;70;4;15;31;21;;
União da Vitória;De 50 a menos de 100 ha;49;3410;13;36;993;2417;30;19;6;7;24;12;1;4;0;11;;
União da Vitória;De 100 a menos de 200 ha;16;2296;13;3;0;0;7;9;6;7;1;2;2;4;0;2;;
União da Vitória;De 200 a menos de 500 ha;23;6857;22;1;0;0;7;16;7;15;0;1;1;10;0;1;;
União da Vitória;De 500 a menos de 1.000 ha;7;5536;6;1;0;0;0;7;0;6;0;1;0;5;1;0;;
União da Vitória;De 1.000 a menos de 2.500 ha;6;9604;5;1;0;0;3;3;2;3;1;0;0;2;0;0;;
União da Vitória;De 2.500 a menos de 10.000 ha;1;0;1;0;0;0;0;1;0;1;0;0;0;1;0;0;;
União da Vitória;De 10.000 ha e mais;0;0;0;0;0;0;0;0;0;0;0;0;0;0;0;0;;
União da Vitória;Produtor sem área;11;0;6;5;0;0;0;0;0;0;0;0;0;0;0;0;;
Uniflor;Mais de 0 a menos de 0,1 ha;4;0;2;2;0;0;1;3;1;1;0;2;0;1;0;2;;
Uniflor;De 0,1 a menos de 0,2 ha;2;0;0;2;0;0;0;2;0;0;0;2;0;0;0;1;;
Uniflor;De 0,2 a menos de 0,5 ha;3;1;2;1;0;0;0;3;0;2;0;1;0;2;0;0;;
Uniflor;De 0,5 a menos de 1 ha;47;24;20;27;10;14;2;45;0;20;2;25;1;17;0;24;;
Uniflor;De 1 a menos de 2 ha;9;11;3;6;4;7;3;6;1;2;2;4;0;1;0;3;;
Uniflor;De 2 a menos de 3 ha;17;39;10;7;23;16;7;10;5;5;2;5;0;5;0;5;;
Uniflor;De 3 a menos de 4 ha;6;21;1;5;0;0;1;5;1;0;0;5;0;0;0;3;;
Uniflor;De 4 a menos de 5 ha;21;98;6;15;28;71;5;16;1;5;4;11;0;4;0;6;;
Uniflor;De 5 a menos de 10 ha;27;210;7;20;56;154;11;16;4;3;7;13;0;3;0;10;;
Uniflor;De 10 a menos de 20 ha;24;337;10;14;143;194;9;15;4;6;5;9;0;6;0;7;;
Uniflor;De 20 a menos de 50 ha;33;1032;5;28;146;885;16;17;1;4;15;13;0;2;0;11;;
Uniflor;De 50 a menos de 100 ha;12;830;7;5;552;278;9;3;5;2;4;1;0;2;0;1;;
Uniflor;De 100 a menos de 200 ha;12;1595;12;0;1595;0;10;2;10;2;0;0;0;2;0;0;;
Uniflor;De 200 a menos de 500 ha;6;1317;6;0;1317;0;6;0;6;0;0;0;0;0;0;0;;
Uniflor;De 500 a menos de 1.000 ha;2;0;2;0;0;0;2;0;2;0;0;0;0;0;0;0;;
Uniflor;De 1.000 a menos de 2.500 ha;1;0;1;0;0;0;1;0;1;0;0;0;0;0;0;0;;
Uniflor;De 2.500 a menos de 10.000 ha;0;0;0;0;0;0;0;0;0;0;0;0;0;0;0;0;;
Uniflor;De 10.000 ha e mais;0;0;0;0;0;0;0;0;0;0;0;0;0;0;0;0;;
Uniflor;Produtor sem área;0;0;0;0;0;0;0;0;0;0;0;0;0;0;0;0;;
Uraí;Mais de 0 a menos de 0,1 ha;2;0;0;2;0;0;0;2;0;0;0;2;0;0;1;1;;
Uraí;De 0,1 a menos de 0,2 ha;0;0;0;0;0;0;0;0;0;0;0;0;0;0;0;0;;
Uraí;De 0,2 a menos de 0,5 ha;1;0;1;0;0;0;0;1;0;1;0;0;0;1;0;0;;
Uraí;De 0,5 a menos de 1 ha;0;0;0;0;0;0;0;0;0;0;0;0;0;0;0;0;;
Uraí;De 1 a menos de 2 ha;12;18;0;12;0;18;8;4;0;0;8;4;0;0;1;2;;
Uraí;De 2 a menos de 3 ha;13;31;2;11;0;0;11;2;2;0;9;2;0;0;0;2;;
Uraí;De 3 a menos de 4 ha;33;115;2;31;0;0;23;10;1;1;22;9;0;1;2;5;;
Uraí;De 4 a menos de 5 ha;27;129;1;26;0;0;21;6;1;0;20;6;0;0;3;3;;
Uraí;De 5 a menos de 10 ha;96;690;6;90;51;639;74;22;5;1;69;21;0;1;2;16;;
Uraí;De 10 a menos de 20 ha;141;2030;9;132;134;1896;109;32;6;3;103;29;1;2;5;20;;
Uraí;De 20 a menos de 50 ha;163;5175;16;147;511;4664;140;23;10;6;130;17;2;3;5;11;;
Uraí;De 50 a menos de 100 ha;64;4457;32;32;2550;1908;55;9;27;5;28;4;1;3;0;4;;
Uraí;De 100 a menos de 200 ha;29;3919;29;0;3919;0;26;3;26;3;0;0;0;2;0;0;;
Uraí;De 200 a menos de 500 ha;18;5187;18;0;5187;0;14;4;14;4;0;0;1;3;0;0;;
Uraí;De 500 a menos de 1.000 ha;1;0;1;0;0;0;0;1;0;1;0;0;0;1;0;0;;
Uraí;De 1.000 a menos de 2.500 ha;0;0;0;0;0;0;0;0;0;0;0;0;0;0;0;0;;
Uraí;De 2.500 a menos de 10.000 ha;0;0;0;0;0;0;0;0;0;0;0;0;0;0;0;0;;
Uraí;De 10.000 ha e mais;0;0;0;0;0;0;0;0;0;0;0;0;0;0;0;0;;
Uraí;Produtor sem área;0;0;0;0;0;0;0;0;0;0;0;0;0;0;0;0;;
Wenceslau Braz;Mais de 0 a menos de 0,1 ha;4;0;2;2;0;0;0;4;0;2;0;2;0;2;2;0;;
Wenceslau Braz;De 0,1 a menos de 0,2 ha;7;1;2;5;0;0;1;6;1;1;0;5;0;1;1;2;;
Wenceslau Braz;De 0,2 a menos de 0,5 ha;16;5;5;11;1;4;1;15;1;4;0;11;0;3;1;7;;
Wenceslau Braz;De 0,5 a menos de 1 ha;82;46;19;63;11;35;28;54;10;9;18;45;0;7;8;16;;
Wenceslau Braz;De 1 a menos de 2 ha;72;99;12;60;16;83;21;51;2;10;19;41;1;9;1;34;;
Wenceslau Braz;De 2 a menos de 3 ha;86;210;17;69;41;170;27;59;7;10;20;49;0;7;4;36;;
Wenceslau Braz;De 3 a menos de 4 ha;63;224;12;51;43;181;12;51;2;10;10;41;1;9;1;30;;
Wenceslau Braz;De 4 a menos de 5 ha;81;385;6;75;28;358;18;63;1;5;17;58;1;3;2;48;;
Wenceslau Braz;De 5 a menos de 10 ha;212;1601;29;183;214;1386;57;155;5;24;52;131;2;18;5;104;;
Wenceslau Braz;De 10 a menos de 20 ha;213;3130;21;192;306;2825;79;134;4;17;75;117;2;13;6;95;;
Wenceslau Braz;De 20 a menos de 50 ha;167;5226;18;149;557;4669;74;93;4;14;70;79;2;11;1;64;;
Wenceslau Braz;De 50 a menos de 100 ha;77;5398;42;35;3330;2068;43;34;20;22;23;12;0;21;0;11;;
Wenceslau Braz;De 100 a menos de 200 ha;41;5747;41;0;5747;0;29;12;29;12;0;0;0;10;0;0;;
Wenceslau Braz;De 200 a menos de 500 ha;27;7689;27;0;7689;0;21;6;21;6;0;0;0;5;0;0;;
Wenceslau Braz;De 500 a menos de 1.000 ha;8;5101;8;0;5101;0;6;2;6;2;0;0;0;2;0;0;;
Wenceslau Braz;De 1.000 a menos de 2.500 ha;0;0;0;0;0;0;0;0;0;0;0;0;0;0;0;0;;
Wenceslau Braz;De 2.500 a menos de 10.000 ha;0;0;0;0;0;0;0;0;0;0;0;0;0;0;0;0;;
Wenceslau Braz;De 10.000 ha e mais;0;0;0;0;0;0;0;0;0;0;0;0;0;0;0;0;;
Wenceslau Braz;Produtor sem área;10;0;1;9;0;0;1;1;1;0;0;1;0;0;0;1;;
Ventania;Mais de 0 a menos de 0,1 ha;10;0;3;7;0;0;3;7;1;2;2;5;0;1;0;5;;
Ventania;De 0,1 a menos de 0,2 ha;11;2;5;6;1;1;5;6;3;2;2;4;0;2;0;3;;
Ventania;De 0,2 a menos de 0,5 ha;29;12;8;21;3;8;13;16;5;3;8;13;0;2;1;7;;
Ventania;De 0,5 a menos de 1 ha;15;9;6;9;4;5;7;8;3;3;4;5;0;2;3;1;;
Ventania;De 1 a menos de 2 ha;14;16;7;7;7;9;2;12;1;6;1;6;0;4;1;5;;
Ventania;De 2 a menos de 3 ha;27;66;11;16;27;39;14;13;4;7;10;6;0;6;0;6;;
Ventania;De 3 a menos de 4 ha;11;38;1;10;0;0;3;8;0;1;3;7;0;1;0;6;;
Ventania;De 4 a menos de 5 ha;23;109;2;21;0;0;13;10;2;0;11;10;0;0;0;9;;
Ventania;De 5 a menos de 10 ha;37;264;7;30;48;216;20;17;5;2;15;15;0;2;1;12;;
Ventania;De 10 a menos de 20 ha;89;1357;12;77;173;1184;51;38;4;8;47;30;0;8;0;21;;
Ventania;De 20 a menos de 50 ha;65;2124;8;57;246;1878;33;32;2;6;31;26;0;6;0;23;;
Ventania;De 50 a menos de 100 ha;30;2241;12;18;1022;1219;21;9;9;3;12;6;0;3;1;5;;
Ventania;De 100 a menos de 200 ha;20;2720;20;0;2720;0;14;6;14;6;0;0;0;3;0;0;;
Ventania;De 200 a menos de 500 ha;20;6056;20;0;6056;0;14;6;14;6;0;0;0;5;0;0;;
Ventania;De 500 a menos de 1.000 ha;12;8594;12;0;8594;0;11;1;11;1;0;0;0;1;0;0;;
Ventania;De 1.000 a menos de 2.500 ha;11;16696;11;0;16696;0;9;2;9;2;0;0;0;1;0;0;;
Ventania;De 2.500 a menos de 10.000 ha;2;0;2;0;0;0;2;0;2;0;0;0;0;0;0;0;;
Ventania;De 10.000 ha e mais;0;0;0;0;0;0;0;0;0;0;0;0;0;0;0;0;;
Ventania;Produtor sem área;0;0;0;0;0;0;0;0;0;0;0;0;0;0;0;0;;
Vera Cruz do Oeste;Mais de 0 a menos de 0,1 ha;17;1;7;10;0;0;3;14;1;6;2;8;0;6;0;8;;
Vera Cruz do Oeste;De 0,1 a menos de 0,2 ha;2;0;1;1;0;0;0;2;0;1;0;1;0;1;0;1;;
Vera Cruz do Oeste;De 0,2 a menos de 0,5 ha;12;3;3;9;1;3;3;9;1;2;2;7;0;2;0;7;;
Vera Cruz do Oeste;De 0,5 a menos de 1 ha;58;33;12;46;6;27;17;41;1;11;16;30;1;9;0;27;;
Vera Cruz do Oeste;De 1 a menos de 2 ha;29;39;6;23;8;31;5;24;2;4;3;20;1;3;0;20;;
Vera Cruz do Oeste;De 2 a menos de 3 ha;52;127;9;43;22;106;26;26;5;4;21;22;0;1;2;17;;
Vera Cruz do Oeste;De 3 a menos de 4 ha;37;131;2;35;0;0;17;20;1;1;16;19;0;1;1;17;;
Vera Cruz do Oeste;De 4 a menos de 5 ha;47;224;6;41;29;196;32;15;3;3;29;12;0;3;1;7;;
Vera Cruz do Oeste;De 5 a menos de 10 ha;112;858;8;104;62;796;86;26;5;3;81;23;0;2;2;16;;
Vera Cruz do Oeste;De 10 a menos de 20 ha;144;2184;4;140;62;2122;122;22;1;3;121;19;0;3;0;18;;
Vera Cruz do Oeste;De 20 a menos de 50 ha;147;4809;10;137;335;4474;134;13;9;1;125;12;0;1;0;9;;
Vera Cruz do Oeste;De 50 a menos de 100 ha;63;4554;31;32;2571;1983;58;5;29;2;29;3;0;2;0;2;;
Vera Cruz do Oeste;De 100 a menos de 200 ha;40;5794;40;0;5794;0;38;2;38;2;0;0;0;2;0;0;;
Vera Cruz do Oeste;De 200 a menos de 500 ha;27;8205;27;0;8205;0;25;2;25;2;0;0;0;2;0;0;;
Vera Cruz do Oeste;De 500 a menos de 1.000 ha;6;4257;6;0;4257;0;6;0;6;0;0;0;0;0;0;0;;
Vera Cruz do Oeste;De 1.000 a menos de 2.500 ha;0;0;0;0;0;0;0;0;0;0;0;0;0;0;0;0;;
Vera Cruz do Oeste;De 2.500 a menos de 10.000 ha;1;0;1;0;0;0;1;0;1;0;0;0;0;0;0;0;;
Vera Cruz do Oeste;De 10.000 ha e mais;0;0;0;0;0;0;0;0;0;0;0;0;0;0;0;0;;
Vera Cruz do Oeste;Produtor sem área;2;0;0;2;0;0;0;0;0;0;0;0;0;0;0;0;;
Verê;Mais de 0 a menos de 0,1 ha;2;0;2;0;0;0;0;2;0;2;0;0;0;1;0;0;;
Verê;De 0,1 a menos de 0,2 ha;0;0;0;0;0;0;0;0;0;0;0;0;0;0;0;0;;
Verê;De 0,2 a menos de 0,5 ha;5;2;1;4;0;0;1;4;1;0;0;4;0;0;1;2;;
Verê;De 0,5 a menos de 1 ha;26;16;12;14;7;9;8;18;5;7;3;11;2;5;3;6;;
Verê;De 1 a menos de 2 ha;18;25;8;10;0;0;6;12;1;7;5;5;2;3;3;0;;
Verê;De 2 a menos de 3 ha;35;86;9;26;23;63;12;23;2;7;10;16;2;5;4;9;;
Verê;De 3 a menos de 4 ha;48;166;10;38;33;134;26;22;5;5;21;17;1;4;3;14;;
Verê;De 4 a menos de 5 ha;58;275;7;51;33;242;44;14;4;3;40;11;0;3;3;6;;
Verê;De 5 a menos de 10 ha;172;1356;11;161;90;1267;146;26;8;3;138;23;0;2;4;14;;
Verê;De 10 a menos de 20 ha;303;4500;7;296;108;4392;280;23;6;1;274;22;0;1;2;16;;
Verê;De 20 a menos de 50 ha;230;7064;5;225;167;6896;222;8;4;1;218;7;0;1;1;5;;
Verê;De 50 a menos de 100 ha;77;5213;16;61;1398;3815;77;0;16;0;61;0;0;0;0;0;;
Verê;De 100 a menos de 200 ha;21;2942;21;0;2942;0;19;2;19;2;0;0;0;2;0;0;;
Verê;De 200 a menos de 500 ha;15;5152;15;0;5152;0;15;0;15;0;0;0;0;0;0;0;;
Verê;De 500 a menos de 1.000 ha;0;0;0;0;0;0;0;0;0;0;0;0;0;0;0;0;;
Verê;De 1.000 a menos de 2.500 ha;1;0;1;0;0;0;1;0;1;0;0;0;0;0;0;0;;
Verê;De 2.500 a menos de 10.000 ha;0;0;0;0;0;0;0;0;0;0;0;0;0;0;0;0;;
Verê;De 10.000 ha e mais;0;0;0;0;0;0;0;0;0;0;0;0;0;0;0;0;;
Verê;Produtor sem área;0;0;0;0;0;0;0;0;0;0;0;0;0;0;0;0;;
Alto Paraíso;Mais de 0 a menos de 0,1 ha;0;0;0;0;0;0;0;0;0;0;0;0;0;0;0;0;;
Alto Paraíso;De 0,1 a menos de 0,2 ha;0;0;0;0;0;0;0;0;0;0;0;0;0;0;0;0;;
Alto Paraíso;De 0,2 a menos de 0,5 ha;0;0;0;0;0;0;0;0;0;0;0;0;0;0;0;0;;
Alto Paraíso;De 0,5 a menos de 1 ha;80;40;41;39;21;20;0;80;0;41;0;39;0;41;0;36;;
Alto Paraíso;De 1 a menos de 2 ha;0;0;0;0;0;0;0;0;0;0;0;0;0;0;0;0;;
Alto Paraíso;De 2 a menos de 3 ha;8;19;1;7;0;0;0;8;0;1;0;7;0;1;0;6;;
Alto Paraíso;De 3 a menos de 4 ha;3;0;0;3;0;0;0;3;0;0;0;3;0;0;0;2;;
Alto Paraíso;De 4 a menos de 5 ha;5;24;0;5;0;24;0;5;0;0;0;5;0;0;1;2;;
Alto Paraíso;De 5 a menos de 10 ha;23;194;3;20;25;169;1;22;1;2;0;20;0;1;0;14;;
Alto Paraíso;De 10 a menos de 20 ha;36;522;5;31;81;440;1;35;1;4;0;31;0;3;0;21;;
Alto Paraíso;De 20 a menos de 50 ha;24;713;0;24;0;713;1;23;0;0;1;23;0;0;0;16;;
Alto Paraíso;De 50 a menos de 100 ha;22;1632;11;11;921;711;5;17;3;8;2;9;0;8;0;6;;
Alto Paraíso;De 100 a menos de 200 ha;13;1990;13;0;1990;0;3;10;3;10;0;0;0;7;0;0;;
Alto Paraíso;De 200 a menos de 500 ha;39;13408;39;0;13408;0;6;33;6;33;0;0;0;23;0;0;;
Alto Paraíso;De 500 a menos de 1.000 ha;20;15080;20;0;15080;0;3;17;3;17;0;0;0;11;0;0;;
Alto Paraíso;De 1.000 a menos de 2.500 ha;20;30813;20;0;30813;0;7;13;7;13;0;0;0;6;0;0;;
Alto Paraíso;De 2.500 a menos de 10.000 ha;2;0;2;0;0;0;2;0;2;0;0;0;0;0;0;0;;
Alto Paraíso;De 10.000 ha e mais;0;0;0;0;0;0;0;0;0;0;0;0;0;0;0;0;;
Alto Paraíso;Produtor sem área;6;0;3;3;0;0;0;0;0;0;0;0;0;0;0;0;;
Doutor Ulysses;Mais de 0 a menos de 0,1 ha;8;1;5;3;0;0;3;5;3;2;0;3;0;2;0;1;;
Doutor Ulysses;De 0,1 a menos de 0,2 ha;0;0;0;0;0;0;0;0;0;0;0;0;0;0;0;0;;
Doutor Ulysses;De 0,2 a menos de 0,5 ha;10;3;5;5;1;1;5;5;3;2;2;3;0;1;0;3;;
Doutor Ulysses;De 0,5 a menos de 1 ha;48;33;23;25;16;17;36;12;19;4;17;8;0;4;0;5;;
Doutor Ulysses;De 1 a menos de 2 ha;100;138;37;63;51;87;81;19;28;9;53;10;0;7;1;9;;
Doutor Ulysses;De 2 a menos de 3 ha;110;270;43;67;105;165;67;43;22;21;45;22;0;19;0;17;;
Doutor Ulysses;De 3 a menos de 4 ha;71;252;20;51;71;180;50;21;12;8;38;13;0;7;0;11;;
Doutor Ulysses;De 4 a menos de 5 ha;84;399;21;63;101;299;58;26;9;12;49;14;1;11;0;11;;
Doutor Ulysses;De 5 a menos de 10 ha;162;1198;29;133;216;982;134;28;20;9;114;19;0;9;1;11;;
Doutor Ulysses;De 10 a menos de 20 ha;175;2587;37;138;564;2024;129;46;20;17;109;29;0;15;2;20;;
Doutor Ulysses;De 20 a menos de 50 ha;188;6028;26;162;826;5202;136;52;14;12;122;40;0;12;0;37;;
Doutor Ulysses;De 50 a menos de 100 ha;67;4709;6;61;466;4243;48;19;2;4;46;15;0;4;0;14;;
Doutor Ulysses;De 100 a menos de 200 ha;35;4594;24;11;3333;1261;23;12;15;9;8;3;0;9;0;3;;
Doutor Ulysses;De 200 a menos de 500 ha;18;5858;18;0;5858;0;4;14;4;14;0;0;0;12;0;0;;
Doutor Ulysses;De 500 a menos de 1.000 ha;5;3848;5;0;3848;0;0;5;0;5;0;0;0;5;0;0;;
Doutor Ulysses;De 1.000 a menos de 2.500 ha;5;8984;5;0;8984;0;3;2;3;2;0;0;0;1;0;0;;
Doutor Ulysses;De 2.500 a menos de 10.000 ha;4;0;4;0;0;0;0;4;0;4;0;0;0;3;0;0;;
Doutor Ulysses;De 10.000 ha e mais;0;0;0;0;0;0;0;0;0;0;0;0;0;0;0;0;;
Doutor Ulysses;Produtor sem área;3;0;2;1;0;0;0;0;0;0;0;0;0;0;0;0;;
Virmond;Mais de 0 a menos de 0,1 ha;1;0;0;1;0;0;0;1;0;0;0;1;0;0;0;1;;
Virmond;De 0,1 a menos de 0,2 ha;0;0;0;0;0;0;0;0;0;0;0;0;0;0;0;0;;
Virmond;De 0,2 a menos de 0,5 ha;0;0;0;0;0;0;0;0;0;0;0;0;0;0;0;0;;
Virmond;De 0,5 a menos de 1 ha;1;0;0;1;0;0;1;0;0;0;1;0;0;0;0;0;;
Virmond;De 1 a menos de 2 ha;3;0;0;3;0;0;2;1;0;0;2;1;0;0;0;0;;
Virmond;De 2 a menos de 3 ha;27;66;0;27;0;66;21;6;0;0;21;6;0;0;0;5;;
Virmond;De 3 a menos de 4 ha;19;67;3;16;11;56;17;2;2;1;15;1;0;0;0;0;;
Virmond;De 4 a menos de 5 ha;31;149;2;29;0;0;30;1;2;0;28;1;0;0;0;1;;
Virmond;De 5 a menos de 10 ha;77;595;3;74;23;571;74;3;3;0;71;3;0;0;0;2;;
Virmond;De 10 a menos de 20 ha;113;1669;5;108;69;1600;113;0;5;0;108;0;0;0;0;0;;
Virmond;De 20 a menos de 50 ha;145;4511;3;142;105;4406;143;2;3;0;140;2;0;0;0;1;;
Virmond;De 50 a menos de 100 ha;58;3943;25;33;1994;1948;57;1;24;1;33;0;0;1;0;0;;
Virmond;De 100 a menos de 200 ha;21;2739;21;0;2739;0;17;4;17;4;0;0;0;4;0;0;;
Virmond;De 200 a menos de 500 ha;6;1961;6;0;1961;0;5;1;5;1;0;0;0;0;0;0;;
Virmond;De 500 a menos de 1.000 ha;3;0;3;0;0;0;3;0;3;0;0;0;0;0;0;0;;
Virmond;De 1.000 a menos de 2.500 ha;1;0;1;0;0;0;1;0;1;0;0;0;0;0;0;0;;
Virmond;De 2.500 a menos de 10.000 ha;0;0;0;0;0;0;0;0;0;0;0;0;0;0;0;0;;
Virmond;De 10.000 ha e mais;0;0;0;0;0;0;0;0;0;0;0;0;0;0;0;0;;
Virmond;Produtor sem área;1;0;1;0;0;0;0;0;0;0;0;0;0;0;0;0;;
Vitorino;Mais de 0 a menos de 0,1 ha;3;0;3;0;0;0;0;3;0;3;0;0;1;1;0;0;;
Vitorino;De 0,1 a menos de 0,2 ha;2;0;1;1;0;0;1;1;0;1;1;0;0;0;0;0;;
Vitorino;De 0,2 a menos de 0,5 ha;6;2;3;3;0;0;0;6;0;3;0;3;2;0;1;0;;
Vitorino;De 0,5 a menos de 1 ha;15;9;7;8;4;5;7;8;3;4;4;4;1;1;0;2;;
Vitorino;De 1 a menos de 2 ha;15;21;8;7;11;10;6;9;4;4;2;5;3;1;1;2;;
Vitorino;De 2 a menos de 3 ha;15;35;3;12;0;0;8;7;0;3;8;4;1;2;0;3;;
Vitorino;De 3 a menos de 4 ha;27;95;14;13;48;47;16;11;7;7;9;4;0;6;0;3;;
Vitorino;De 4 a menos de 5 ha;24;112;9;15;43;70;12;12;5;4;7;8;2;2;0;2;;
Vitorino;De 5 a menos de 10 ha;56;432;12;44;87;345;39;17;6;6;33;11;1;5;1;7;;
Vitorino;De 10 a menos de 20 ha;91;1366;15;76;207;1159;77;14;9;6;68;8;1;5;0;8;;
Vitorino;De 20 a menos de 50 ha;105;3500;9;96;302;3198;98;7;5;4;93;3;0;4;0;3;;
Vitorino;De 50 a menos de 100 ha;53;3735;28;25;2221;1514;51;2;26;2;25;0;1;1;0;0;;
Vitorino;De 100 a menos de 200 ha;28;3934;28;0;3934;0;27;1;27;1;0;0;1;0;0;0;;
Vitorino;De 200 a menos de 500 ha;18;4866;18;0;4866;0;18;0;18;0;0;0;0;0;0;0;;
Vitorino;De 500 a menos de 1.000 ha;8;5162;8;0;5162;0;8;0;8;0;0;0;0;0;0;0;;
Vitorino;De 1.000 a menos de 2.500 ha;1;0;1;0;0;0;1;0;1;0;0;0;0;0;0;0;;
Vitorino;De 2.500 a menos de 10.000 ha;0;0;0;0;0;0;0;0;0;0;0;0;0;0;0;0;;
Vitorino;De 10.000 ha e mais;0;0;0;0;0;0;0;0;0;0;0;0;0;0;0;0;;
Vitorino;Produtor sem área;5;0;0;5;0;0;4;0;0;0;4;0;0;0;0;0;;
Xambrê;Mais de 0 a menos de 0,1 ha;6;0;1;5;0;0;1;5;0;1;1;4;0;1;0;4;;
Xambrê;De 0,1 a menos de 0,2 ha;1;0;0;1;0;0;0;1;0;0;0;1;0;0;0;0;;
Xambrê;De 0,2 a menos de 0,5 ha;2;0;0;2;0;0;0;2;0;0;0;2;0;0;0;1;;
Xambrê;De 0,5 a menos de 1 ha;59;45;20;39;16;29;12;47;1;19;11;28;1;18;1;16;;
Xambrê;De 1 a menos de 2 ha;19;24;4;15;5;19;3;16;0;4;3;12;0;3;1;6;;
Xambrê;De 2 a menos de 3 ha;47;115;12;35;30;85;7;40;0;12;7;28;0;9;1;19;;
Xambrê;De 3 a menos de 4 ha;26;93;3;23;11;82;3;23;0;3;3;20;0;2;0;11;;
Xambrê;De 4 a menos de 5 ha;44;209;9;35;43;166;8;36;1;8;7;28;0;5;0;17;;
Xambrê;De 5 a menos de 10 ha;83;607;17;66;127;480;8;75;2;15;6;60;1;12;3;29;;
Xambrê;De 10 a menos de 20 ha;111;1552;22;89;296;1256;27;84;4;18;23;66;0;11;0;38;;
Xambrê;De 20 a menos de 50 ha;96;2987;13;83;407;2580;25;71;6;7;19;64;0;4;1;23;;
Xambrê;De 50 a menos de 100 ha;41;3053;21;20;1756;1297;10;31;7;14;3;17;0;5;0;7;;
Xambrê;De 100 a menos de 200 ha;37;4982;37;0;4982;0;11;26;11;26;0;0;0;18;0;0;;
Xambrê;De 200 a menos de 500 ha;25;7432;25;0;7432;0;9;16;9;16;0;0;1;7;0;0;;
Xambrê;De 500 a menos de 1.000 ha;10;7006;10;0;7006;0;7;3;7;3;0;0;0;0;0;0;;
Xambrê;De 1.000 a menos de 2.500 ha;1;0;1;0;0;0;1;0;1;0;0;0;0;0;0;0;;
Xambrê;De 2.500 a menos de 10.000 ha;1;0;1;0;0;0;1;0;1;0;0;0;0;0;0;0;;
Xambrê;De 10.000 ha e mais;0;0;0;0;0;0;0;0;0;0;0;0;0;0;0;0;;
Xambrê;Produtor sem área;3;0;0;3;0;0;0;0;0;0;0;0;0;0;0;0;;